Gen,Resource,Stamp,TimeStamp_Start,TimeStamp_End,Duration,Indiv_id
0,1,TransfertToDevice,827925048700,828314847900,389799200,-1
0,1,STEP,828463592800,828496420000,32827200,-1
1,1,STEP,828496487100,828528185200,31698100,-1
2,1,STEP,828528242400,828559348500,31106100,-1
3,1,STEP,828559399900,828590500800,31100900,-1
4,1,STEP,828590553400,828617626600,27073200,-1
5,1,STEP,828617689700,828644614400,26924700,-1
6,1,STEP,828644672400,828671640700,26968300,-1
7,1,STEP,828671691000,828698297000,26606000,-1
8,1,STEP,828698356100,828724717000,26360900,-1
9,1,STEP,828724788400,828751794800,27006400,-1
10,1,STEP,828751847900,828778919200,27071300,-1
11,1,STEP,828778974900,828805694700,26719800,-1
12,1,STEP,828805739700,828832571900,26832200,-1
13,1,STEP,828832650400,828859442900,26792500,-1
14,1,STEP,828859501900,828886209400,26707500,-1
15,1,STEP,828886271000,828915489100,29218100,-1
16,1,STEP,828915549400,828947097100,31547700,-1
17,1,STEP,828947166300,828977084300,29918000,-1
18,1,STEP,828977141100,829006804000,29662900,-1
19,1,STEP,829006861400,829036681700,29820300,-1
20,1,STEP,829036739200,829068773200,32034000,-1
21,1,STEP,829068830600,829100585500,31754900,-1
22,1,STEP,829100649800,829132476100,31826300,-1
23,1,STEP,829132543600,829165065700,32522100,-1
24,1,STEP,829165131500,829197397700,32266200,-1
25,1,STEP,829197459600,829230065600,32606000,-1
26,1,STEP,829230123600,829262576900,32453300,-1
27,1,STEP,829262630500,829295334600,32704100,-1
28,1,STEP,829295390200,829328181100,32790900,-1
29,1,STEP,829328237500,829361499000,33261500,-1
30,1,STEP,829361556200,829395025100,33468900,-1
31,1,STEP,829395076200,829427757500,32681300,-1
32,1,STEP,829427818200,829460745000,32926800,-1
33,1,STEP,829460805600,829494029100,33223500,-1
34,1,STEP,829494081700,829527472600,33390900,-1
35,1,STEP,829527524800,829561236600,33711800,-1
36,1,STEP,829561304400,829594755800,33451400,-1
37,1,STEP,829594815900,829627628100,32812200,-1
38,1,STEP,829627692300,829660905200,33212900,-1
39,1,STEP,829660989900,829694786600,33796700,-1
40,1,STEP,829694849900,829728255500,33405600,-1
41,1,STEP,829728311200,829762118200,33807000,-1
42,1,STEP,829762188900,829795658100,33469200,-1
43,1,STEP,829795713500,829829028600,33315100,-1
44,1,STEP,829829077000,829863082800,34005800,-1
45,1,STEP,829863158200,829897621700,34463500,-1
46,1,STEP,829897675900,829930814000,33138100,-1
47,1,STEP,829930869900,829964762900,33893000,-1
48,1,STEP,829964822200,829999279800,34457600,-1
49,1,STEP,829999335500,830033229300,33893800,-1
50,1,STEP,830033288300,830067152200,33863900,-1
51,1,STEP,830067206100,830101317500,34111400,-1
52,1,STEP,830101371900,830134289700,32917800,-1
53,1,STEP,830134349500,830168529200,34179700,-1
54,1,STEP,830168588500,830202868600,34280100,-1
55,1,STEP,830202923400,830237144900,34221500,-1
56,1,STEP,830237198900,830271479400,34280500,-1
57,1,STEP,830271535500,830306681600,35146100,-1
58,1,STEP,830306728900,830340800600,34071700,-1
59,1,STEP,830340855400,830374961800,34106400,-1
60,1,STEP,830375010800,830409250300,34239500,-1
61,1,STEP,830409302200,830444076300,34774100,-1
62,1,STEP,830444127700,830478723800,34596100,-1
63,1,STEP,830478776000,830513054600,34278600,-1
64,1,STEP,830513102400,830548094700,34992300,-1
65,1,STEP,830548139100,830582151700,34012600,-1
66,1,STEP,830582211700,830615777200,33565500,-1
67,1,STEP,830615847200,830649363800,33516600,-1
68,1,STEP,830649415200,830683082900,33667700,-1
69,1,STEP,830683129800,830717384800,34255000,-1
70,1,STEP,830717437600,830751417600,33980000,-1
71,1,STEP,830751466500,830785840600,34374100,-1
72,1,STEP,830785886900,830820780100,34893200,-1
73,1,STEP,830820897700,830855508600,34610900,-1
74,1,STEP,830855549300,830889821500,34272200,-1
75,1,STEP,830889869900,830924055100,34185200,-1
76,1,STEP,830924098800,830958148000,34049200,-1
77,1,STEP,830958207000,830992264600,34057600,-1
78,1,STEP,830992327500,831026621600,34294100,-1
79,1,STEP,831026683100,831060788900,34105800,-1
80,1,STEP,831060836600,831095481000,34644400,-1
81,1,STEP,831095528500,831130041700,34513200,-1
82,1,STEP,831130088900,831164377700,34288800,-1
83,1,STEP,831164432500,831198692400,34259900,-1
84,1,STEP,831198753600,831233367500,34613900,-1
85,1,STEP,831233431500,831267709200,34277700,-1
86,1,STEP,831267762900,831302230900,34468000,-1
87,1,STEP,831302280500,831336965500,34685000,-1
88,1,STEP,831337011200,831371456200,34445000,-1
89,1,STEP,831371516800,831405454100,33937300,-1
90,1,STEP,831405506800,831439920200,34413400,-1
91,1,STEP,831439988800,831473804500,33815700,-1
92,1,STEP,831473853300,831508119200,34265900,-1
93,1,STEP,831508221600,831543175900,34954300,-1
94,1,STEP,831543225100,831577320300,34095200,-1
95,1,STEP,831577374100,831611055200,33681100,-1
96,1,STEP,831611106300,831644627800,33521500,-1
97,1,STEP,831644682200,831680016600,35334400,-1
98,1,STEP,831680074200,831714309000,34234800,-1
99,1,STEP,831714366900,831748520300,34153400,-1
100,1,STEP,831748574600,831783758800,35184200,-1
101,1,STEP,831783888700,831819905000,36016300,-1
102,1,STEP,831819955000,831854265000,34310000,-1
103,1,STEP,831854318200,831888709500,34391300,-1
104,1,STEP,831888758400,831923153100,34394700,-1
105,1,STEP,831923203300,831957519700,34316400,-1
106,1,STEP,831957574000,831991734400,34160400,-1
107,1,STEP,831991785200,832026484800,34699600,-1
108,1,STEP,832026539800,832060201700,33661900,-1
109,1,STEP,832060262200,832093629200,33367000,-1
110,1,STEP,832093700900,832128382300,34681400,-1
111,1,STEP,832128463200,832161980200,33517000,-1
112,1,STEP,832162054700,832195554100,33499400,-1
113,1,STEP,832195611400,832229736500,34125100,-1
114,1,STEP,832229792600,832264116300,34323700,-1
115,1,STEP,832264175600,832298280600,34105000,-1
116,1,STEP,832298345100,832333649900,35304800,-1
117,1,STEP,832333709000,832368085200,34376200,-1
118,1,STEP,832368142800,832402349400,34206600,-1
119,1,STEP,832402403700,832436625000,34221300,-1
120,1,STEP,832436682800,832471338500,34655700,-1
121,1,STEP,832471387800,832506223800,34836000,-1
122,1,STEP,832506276400,832540335000,34058600,-1
123,1,STEP,832540385500,832574517500,34132000,-1
124,1,STEP,832574569000,832609863200,35294200,-1
125,1,STEP,832609920100,832643739200,33819100,-1
126,1,STEP,832643791800,832677791400,33999600,-1
127,1,STEP,832677845700,832712817400,34971700,-1
128,1,STEP,832712873500,832746649000,33775500,-1
129,1,STEP,832746705100,832780913600,34208500,-1
130,1,STEP,832780970000,832815210800,34240800,-1
131,1,STEP,832815277400,832850132700,34855300,-1
132,1,STEP,832850190500,832884361200,34170700,-1
133,1,STEP,832884422200,832918741300,34319100,-1
134,1,STEP,832918799900,832954098200,35298300,-1
135,1,STEP,832954165200,832988836100,34670900,-1
136,1,STEP,832988887800,833023257900,34370100,-1
137,1,STEP,833023311100,833058436500,35125400,-1
138,1,STEP,833058489700,833092649100,34159400,-1
139,1,STEP,833092694900,833127985100,35290200,-1
140,1,STEP,833128047500,833162599800,34552300,-1
141,1,STEP,833162661000,833197956400,35295400,-1
142,1,STEP,833198013600,833233505300,35491700,-1
143,1,STEP,833233562600,833268293500,34730900,-1
144,1,STEP,833268341700,833302759700,34418000,-1
145,1,STEP,833302810100,833337266800,34456700,-1
146,1,STEP,833337314300,833372225200,34910900,-1
147,1,STEP,833372284300,833406949700,34665400,-1
148,1,STEP,833407014200,833441441500,34427300,-1
149,1,STEP,833441491200,833476725700,35234500,-1
150,1,STEP,833476776800,833512709100,35932300,-1
151,1,STEP,833512757700,833558382000,45624300,-1
152,1,STEP,833558560700,833592293900,33733200,-1
153,1,STEP,833592371500,833627423100,35051600,-1
154,1,STEP,833627508100,833662526100,35018000,-1
155,1,STEP,833662612100,833697482200,34870100,-1
156,1,STEP,833697585300,833733411800,35826500,-1
157,1,STEP,833733477100,833768636000,35158900,-1
158,1,STEP,833768706400,833804110700,35404300,-1
159,1,STEP,833804163900,833838472100,34308200,-1
160,1,STEP,833838543600,833872555800,34012200,-1
161,1,STEP,833872639400,833907497500,34858100,-1
162,1,STEP,833907556000,833942429900,34873900,-1
163,1,STEP,833942481600,833977861100,35379500,-1
164,1,STEP,833977908300,834013461100,35552800,-1
165,1,STEP,834013513600,834049177400,35663800,-1
166,1,STEP,834049228000,834085126800,35898800,-1
167,1,STEP,834085187700,834121208000,36020300,-1
168,1,STEP,834121257700,834157190600,35932900,-1
169,1,STEP,834157251200,834193176100,35924900,-1
170,1,STEP,834193228600,834228116300,34887700,-1
171,1,STEP,834228169100,834263439400,35270300,-1
172,1,STEP,834263489600,834297859300,34369700,-1
173,1,STEP,834297910400,834333555400,35645000,-1
174,1,STEP,834333603900,834368116100,34512200,-1
175,1,STEP,834368162800,834403031100,34868300,-1
176,1,STEP,834403078900,834439104300,36025400,-1
177,1,STEP,834439153800,834474666000,35512200,-1
178,1,STEP,834474720700,834510172900,35452200,-1
179,1,STEP,834510224600,834545853200,35628600,-1
180,1,STEP,834545917400,834579994500,34077100,-1
181,1,STEP,834580073800,834615864900,35791100,-1
182,1,STEP,834615933300,834651367200,35433900,-1
183,1,STEP,834651424100,834687018700,35594600,-1
184,1,STEP,834687075000,834722364000,35289000,-1
185,1,STEP,834722422800,834758209000,35786200,-1
186,1,STEP,834758269900,834793910900,35641000,-1
187,1,STEP,834793980200,834829165200,35185000,-1
188,1,STEP,834829225600,834864596800,35371200,-1
189,1,STEP,834864660700,834900722500,36061800,-1
190,1,STEP,834900777800,834936191200,35413400,-1
191,1,STEP,834936256300,834971508700,35252400,-1
192,1,STEP,834971577200,835008133000,36555800,-1
193,1,STEP,835008206000,835043397700,35191700,-1
194,1,STEP,835043482200,835079075300,35593100,-1
195,1,STEP,835079147100,835113935600,34788500,-1
196,1,STEP,835114047400,835149253200,35205800,-1
197,1,STEP,835149321100,835185199900,35878800,-1
198,1,STEP,835185261300,835221369500,36108200,-1
199,1,STEP,835221434600,835256375700,34941100,-1
200,1,STEP,835256442800,835291523600,35080800,-1
201,1,STEP,835291583600,835326507300,34923700,-1
202,1,STEP,835326560500,835362121400,35560900,-1
203,1,STEP,835362172000,835397558700,35386700,-1
204,1,STEP,835397610100,835433031300,35421200,-1
205,1,STEP,835433089600,835468277400,35187800,-1
206,1,STEP,835468327000,835503054000,34727000,-1
207,1,STEP,835503110900,835538754500,35643600,-1
208,1,STEP,835538810500,835579451600,40641100,-1
209,1,STEP,835579509500,835614057000,34547500,-1
210,1,STEP,835614122600,835649306100,35183500,-1
211,1,STEP,835649361700,835684940100,35578400,-1
212,1,STEP,835684995900,835720513100,35517200,-1
213,1,STEP,835720571300,835755831300,35260000,-1
214,1,STEP,835755916100,835791414100,35498000,-1
215,1,STEP,835791468200,835826382000,34913800,-1
216,1,STEP,835826441300,835861071800,34630500,-1
217,1,STEP,835861127400,835895554600,34427200,-1
218,1,STEP,835895602400,835931112000,35509600,-1
219,1,STEP,835931164700,835965952200,34787500,-1
220,1,STEP,835966001900,836001352200,35350300,-1
221,1,STEP,836001408900,836036485000,35076100,-1
222,1,STEP,836036538700,836071671200,35132500,-1
223,1,STEP,836071738000,836107875200,36137200,-1
224,1,STEP,836107933500,836142492300,34558800,-1
225,1,STEP,836142560700,836177737600,35176900,-1
226,1,STEP,836177811200,836213597400,35786200,-1
227,1,STEP,836213663300,836249028200,35364900,-1
228,1,STEP,836249086300,836284023700,34937400,-1
229,1,STEP,836284079000,836320413300,36334300,-1
230,1,STEP,836320482700,836356443900,35961200,-1
231,1,STEP,836356514800,836393096600,36581800,-1
232,1,STEP,836393157100,836430470600,37313500,-1
233,1,STEP,836430530800,836467642400,37111600,-1
234,1,STEP,836467720300,836504961500,37241200,-1
235,1,STEP,836505028600,836541169700,36141100,-1
236,1,STEP,836541235700,836578069400,36833700,-1
237,1,STEP,836578134200,836615618800,37484600,-1
238,1,STEP,836615689400,836653628600,37939200,-1
239,1,STEP,836653687000,836691722600,38035600,-1
240,1,STEP,836691787300,836731846800,40059500,-1
241,1,STEP,836731902600,836769634600,37732000,-1
242,1,STEP,836769700800,836807788600,38087800,-1
243,1,STEP,836807843200,836847517300,39674100,-1
244,1,STEP,836847608700,836886984500,39375800,-1
245,1,STEP,836887061000,836925689100,38628100,-1
246,1,STEP,836925759400,836965463900,39704500,-1
247,1,STEP,836965521600,837005196000,39674400,-1
248,1,STEP,837005253700,837044163600,38909900,-1
249,1,STEP,837044229800,837083764200,39534400,-1
250,1,STEP,837083821400,837123350900,39529500,-1
251,1,STEP,837123419000,837163156000,39737000,-1
252,1,STEP,837163217400,837201877800,38660400,-1
253,1,STEP,837201930800,837242303500,40372700,-1
254,1,STEP,837242357100,837282322500,39965400,-1
255,1,STEP,837282372400,837322759900,40387500,-1
256,1,STEP,837322827000,837361977000,39150000,-1
257,1,STEP,837362031300,837402569200,40537900,-1
258,1,STEP,837402622000,837442782600,40160600,-1
259,1,STEP,837442846100,837482843300,39997200,-1
260,1,STEP,837482900300,837522824600,39924300,-1
261,1,STEP,837522876700,837563198400,40321700,-1
262,1,STEP,837563252700,837602389700,39137000,-1
263,1,STEP,837602447500,837642884300,40436800,-1
264,1,STEP,837642945800,837683288100,40342300,-1
265,1,STEP,837683340500,837722537800,39197300,-1
266,1,STEP,837722591100,837762062200,39471100,-1
267,1,STEP,837762125900,837802017500,39891600,-1
268,1,STEP,837802088600,837841474200,39385600,-1
269,1,STEP,837841526200,837881893500,40367300,-1
270,1,STEP,837881957800,837922392800,40435000,-1
271,1,STEP,837922443800,837963746800,41303000,-1
272,1,STEP,837963820800,838003946300,40125500,-1
273,1,STEP,838004011300,838044285300,40274000,-1
274,1,STEP,838044391700,838085627400,41235700,-1
275,1,STEP,838085679100,838125117300,39438200,-1
276,1,STEP,838125170700,838165315600,40144900,-1
277,1,STEP,838165434100,838207216700,41782600,-1
278,1,STEP,838207278500,838247291100,40012600,-1
279,1,STEP,838247354700,838287983900,40629200,-1
280,1,STEP,838288062700,838328441300,40378600,-1
281,1,STEP,838328536900,838370012500,41475600,-1
282,1,STEP,838370063400,838409920700,39857300,-1
283,1,STEP,838409983700,838449807000,39823300,-1
284,1,STEP,838449866000,838491160200,41294200,-1
285,1,STEP,838491213600,838531974600,40761000,-1
286,1,STEP,838532027800,838573352800,41325000,-1
287,1,STEP,838573415700,838613645500,40229800,-1
288,1,STEP,838613699900,838652902000,39202100,-1
289,1,STEP,838652957100,838694033200,41076100,-1
290,1,STEP,838694085600,838734252900,40167300,-1
291,1,STEP,838734308100,838773116300,38808200,-1
292,1,STEP,838773174200,838813564000,40389800,-1
293,1,STEP,838813618200,838853641000,40022800,-1
294,1,STEP,838853693800,838895109500,41415700,-1
295,1,STEP,838895175300,838935072100,39896800,-1
296,1,STEP,838935128700,838975405100,40276400,-1
297,1,STEP,838975453200,839015084700,39631500,-1
298,1,STEP,839015131400,839055417900,40286500,-1
299,1,STEP,839055476100,839095136100,39660000,-1
300,1,STEP,839095185700,839134686700,39501000,-1
301,1,STEP,839134750400,839174180400,39430000,-1
302,1,STEP,839174227600,839214087300,39859700,-1
303,1,STEP,839214134600,839254134200,39999600,-1
304,1,STEP,839254189500,839293987400,39797900,-1
305,1,STEP,839294040000,839332734000,38694000,-1
306,1,STEP,839332795300,839372230300,39435000,-1
307,1,STEP,839372291200,839410962100,38670900,-1
308,1,STEP,839411016000,839450070300,39054300,-1
309,1,STEP,839450135000,839489696900,39561900,-1
310,1,STEP,839489769600,839530126800,40357200,-1
311,1,STEP,839530185900,839569999900,39814000,-1
312,1,STEP,839570082700,839609747100,39664400,-1
313,1,STEP,839609812900,839649533700,39720800,-1
314,1,STEP,839649584100,839689433300,39849200,-1
315,1,STEP,839689483700,839730152200,40668500,-1
316,1,STEP,839730202900,839770316500,40113600,-1
317,1,STEP,839770368200,839810454500,40086300,-1
318,1,STEP,839810499500,839850326500,39827000,-1
319,1,STEP,839850380100,839890516400,40136300,-1
320,1,STEP,839890574600,839930581800,40007200,-1
321,1,STEP,839930634700,839970511100,39876400,-1
322,1,STEP,839970564500,840009986300,39421800,-1
323,1,STEP,840010035700,840049842900,39807200,-1
324,1,STEP,840049893700,840090214200,40320500,-1
325,1,STEP,840090270200,840130817200,40547000,-1
326,1,STEP,840130864600,840171159900,40295300,-1
327,1,STEP,840171210000,840212032300,40822300,-1
328,1,STEP,840212082800,840252294700,40211900,-1
329,1,STEP,840252349600,840293075800,40726200,-1
330,1,STEP,840293125600,840333874900,40749300,-1
331,1,STEP,840333927100,840375561200,41634100,-1
332,1,STEP,840375609200,840416848600,41239400,-1
333,1,STEP,840416917500,840457043400,40125900,-1
334,1,STEP,840457105700,840497848900,40743200,-1
335,1,STEP,840497909600,840538565000,40655400,-1
336,1,STEP,840538622200,840579548200,40926000,-1
337,1,STEP,840579612000,840619825100,40213100,-1
338,1,STEP,840619881300,840661061700,41180400,-1
339,1,STEP,840661126100,840701126700,40000600,-1
340,1,STEP,840701177900,840741608300,40430400,-1
341,1,STEP,840741661800,840781833200,40171400,-1
342,1,STEP,840781889500,840821836900,39947400,-1
343,1,STEP,840821903400,840862696200,40792800,-1
344,1,STEP,840862759500,840901986500,39227000,-1
345,1,STEP,840902039700,840942392300,40352600,-1
346,1,STEP,840942447600,840982498300,40050700,-1
347,1,STEP,840982546400,841022802000,40255600,-1
348,1,STEP,841022859900,841062954900,40095000,-1
349,1,STEP,841063040200,841102975400,39935200,-1
350,1,STEP,841103030600,841143356200,40325600,-1
351,1,STEP,841143410500,841184557200,41146700,-1
352,1,STEP,841184622100,841224496700,39874600,-1
353,1,STEP,841224562900,841265556700,40993800,-1
354,1,STEP,841265640700,841305086400,39445700,-1
355,1,STEP,841305144100,841344752400,39608300,-1
356,1,STEP,841344807100,841385654500,40847400,-1
357,1,STEP,841385726800,841425419500,39692700,-1
358,1,STEP,841425496900,841466160100,40663200,-1
359,1,STEP,841466251100,841505798700,39547600,-1
360,1,STEP,841505895300,841545420300,39525000,-1
361,1,STEP,841545495400,841586504400,41009000,-1
362,1,STEP,841586589700,841626466800,39877100,-1
363,1,STEP,841626536100,841666704900,40168800,-1
364,1,STEP,841666768500,841706952100,40183600,-1
365,1,STEP,841707021500,841748265800,41244300,-1
366,1,STEP,841748324800,841788099100,39774300,-1
367,1,STEP,841788167400,841827679900,39512500,-1
368,1,STEP,841827744300,841866645400,38901100,-1
369,1,STEP,841866734600,841907304300,40569700,-1
370,1,STEP,841907366300,841946444500,39078200,-1
371,1,STEP,841946516100,841985731500,39215400,-1
372,1,STEP,841985799400,842024316600,38517200,-1
373,1,STEP,842024389900,842064349800,39959900,-1
374,1,STEP,842064411000,842103762800,39351800,-1
375,1,STEP,842103820800,842143319200,39498400,-1
376,1,STEP,842143381500,842182795500,39414000,-1
377,1,STEP,842182873800,842223986100,41112300,-1
378,1,STEP,842224051400,842263420000,39368600,-1
379,1,STEP,842263487800,842304581700,41093900,-1
380,1,STEP,842304655400,842344507100,39851700,-1
381,1,STEP,842344566100,842385760800,41194700,-1
382,1,STEP,842385818900,842425204100,39385200,-1
383,1,STEP,842425257200,842464539500,39282300,-1
384,1,STEP,842464591500,842504044700,39453200,-1
385,1,STEP,842504104400,842544115500,40011100,-1
386,1,STEP,842544189500,842584489100,40299600,-1
387,1,STEP,842584545100,842624651000,40105900,-1
388,1,STEP,842624710800,842664419000,39708200,-1
389,1,STEP,842664480300,842703524100,39043800,-1
390,1,STEP,842703576000,842743656400,40080400,-1
391,1,STEP,842743712700,842784067600,40354900,-1
392,1,STEP,842784122500,842823339300,39216800,-1
393,1,STEP,842823400900,842862892300,39491400,-1
394,1,STEP,842862956900,842901985000,39028100,-1
395,1,STEP,842902044200,842940828800,38784600,-1
396,1,STEP,842940893100,842981425300,40532200,-1
397,1,STEP,842981482500,843020852200,39369700,-1
398,1,STEP,843020910800,843060045000,39134200,-1
399,1,STEP,843060108300,843099586200,39477900,-1
400,1,STEP,843099651200,843138022700,38371500,-1
401,1,STEP,843138077100,843177048400,38971300,-1
402,1,STEP,843177114400,843216316200,39201800,-1
403,1,STEP,843216369400,843255086600,38717200,-1
404,1,STEP,843255140000,843293203400,38063400,-1
405,1,STEP,843293254300,843331452600,38198300,-1
406,1,STEP,843331508300,843370481900,38973600,-1
407,1,STEP,843370538800,843409700000,39161200,-1
408,1,STEP,843409810100,843447922500,38112400,-1
409,1,STEP,843448004600,843486883600,38879000,-1
410,1,STEP,843486936900,843526048400,39111500,-1
411,1,STEP,843526104300,843563606000,37501700,-1
412,1,STEP,843563657500,843600505800,36848300,-1
413,1,STEP,843600564400,843636301700,35737300,-1
414,1,STEP,843636358000,843672071800,35713800,-1
415,1,STEP,843672133000,843709815800,37682800,-1
416,1,STEP,843709878100,843747569900,37691800,-1
417,1,STEP,843747626300,843785456900,37830600,-1
418,1,STEP,843785519900,843823049900,37530000,-1
419,1,STEP,843823108000,843859907300,36799300,-1
420,1,STEP,843859960500,843897074800,37114300,-1
421,1,STEP,843897141300,843934135500,36994200,-1
422,1,STEP,843934201000,843972483100,38282100,-1
423,1,STEP,843972551400,844011032000,38480600,-1
424,1,STEP,844011085600,844049394700,38309100,-1
425,1,STEP,844049445700,844087308800,37863100,-1
426,1,STEP,844087385500,844125781800,38396300,-1
427,1,STEP,844125839700,844165195200,39355500,-1
428,1,STEP,844165251800,844204318100,39066300,-1
429,1,STEP,844204390100,844242812200,38422100,-1
430,1,STEP,844242871600,844281700100,38828500,-1
431,1,STEP,844281767500,844320187500,38420000,-1
432,1,STEP,844320245700,844357823500,37577800,-1
433,1,STEP,844357903000,844395572600,37669600,-1
434,1,STEP,844395631300,844433429200,37797900,-1
435,1,STEP,844433490100,844471564800,38074700,-1
436,1,STEP,844471684300,844509296100,37611800,-1
437,1,STEP,844509355200,844544238200,34883000,-1
438,1,STEP,844544303700,844581725100,37421400,-1
439,1,STEP,844581780900,844618788000,37007100,-1
440,1,STEP,844618841000,844654438800,35597800,-1
441,1,STEP,844654494600,844692078600,37584000,-1
442,1,STEP,844692136400,844730055300,37918900,-1
443,1,STEP,844730111100,844766753300,36642200,-1
444,1,STEP,844766821200,844804410300,37589100,-1
445,1,STEP,844804462300,844841671700,37209400,-1
446,1,STEP,844841723100,844879419500,37696400,-1
447,1,STEP,844879471200,844915486000,36014800,-1
448,1,STEP,844915541500,844952853600,37312100,-1
449,1,STEP,844952908300,844988129200,35220900,-1
450,1,STEP,844988185300,845024544800,36359500,-1
451,1,STEP,845024601300,845060676500,36075200,-1
452,1,STEP,845060727500,845098250300,37522800,-1
453,1,STEP,845098310900,845134875500,36564600,-1
454,1,STEP,845134945200,845171003800,36058600,-1
455,1,STEP,845171065300,845207202900,36137600,-1
456,1,STEP,845207256200,845243401900,36145700,-1
457,1,STEP,845243451600,845279472900,36021300,-1
458,1,STEP,845279526500,845314762600,35236100,-1
459,1,STEP,845314813200,845350824100,36010900,-1
460,1,STEP,845350885600,845386261600,35376000,-1
461,1,STEP,845386316800,845424785700,38468900,-1
462,1,STEP,845424855700,845461613100,36757400,-1
463,1,STEP,845461669200,845497577300,35908100,-1
464,1,STEP,845497630400,845532377900,34747500,-1
465,1,STEP,845532432400,845567927800,35495400,-1
466,1,STEP,845567987900,845605899000,37911100,-1
467,1,STEP,845605953800,845640569100,34615300,-1
468,1,STEP,845640619900,845675050400,34430500,-1
469,1,STEP,845675103900,845710326000,35222100,-1
470,1,STEP,845710381900,845747812900,37431000,-1
471,1,STEP,845747873900,845785507300,37633400,-1
472,1,STEP,845785574000,845822554300,36980300,-1
473,1,STEP,845822912300,845857754300,34842000,-1
474,1,STEP,845857907900,845893373900,35466000,-1
475,1,STEP,845893462600,845929777800,36315200,-1
476,1,STEP,845929840400,845965943900,36103500,-1
477,1,STEP,845966021600,846001692900,35671300,-1
478,1,STEP,846001764600,846037179700,35415100,-1
479,1,STEP,846037261900,846072726300,35464400,-1
480,1,STEP,846072814400,846108261600,35447200,-1
481,1,STEP,846108326000,846144645700,36319700,-1
482,1,STEP,846144706800,846180729300,36022500,-1
483,1,STEP,846180786400,846216257500,35471100,-1
484,1,STEP,846216310200,846251071000,34760800,-1
485,1,STEP,846251123700,846288468100,37344400,-1
486,1,STEP,846288543600,846324943900,36400300,-1
487,1,STEP,846325001800,846361914100,36912300,-1
488,1,STEP,846361967000,846399702600,37735600,-1
489,1,STEP,846399762200,846435169000,35406800,-1
490,1,STEP,846435249600,846472584400,37334800,-1
491,1,STEP,846472645600,846510481400,37835800,-1
492,1,STEP,846510539200,846549246500,38707300,-1
493,1,STEP,846549312700,846587836100,38523400,-1
494,1,STEP,846587893300,846625804300,37911000,-1
495,1,STEP,846625862000,846664210300,38348300,-1
496,1,STEP,846664273800,846701889900,37616100,-1
497,1,STEP,846701949100,846739596300,37647200,-1
498,1,STEP,846739653700,846777091800,37438100,-1
499,1,STEP,846777159900,846814876800,37716900,-1
500,1,STEP,846815031400,846852701500,37670100,-1
501,1,STEP,846852773100,846892506000,39732900,-1
502,1,STEP,846892577700,846931379800,38802100,-1
503,1,STEP,846931434500,846969934700,38500200,-1
504,1,STEP,846969991100,847009444700,39453600,-1
505,1,STEP,847009503600,847048517300,39013700,-1
506,1,STEP,847048572700,847088164500,39591800,-1
507,1,STEP,847088227100,847127356700,39129600,-1
508,1,STEP,847127433900,847167972800,40538900,-1
509,1,STEP,847168035600,847207921400,39885800,-1
510,1,STEP,847207978500,847248455800,40477300,-1
511,1,STEP,847248533000,847288515900,39982900,-1
512,1,STEP,847288581100,847327858400,39277300,-1
513,1,STEP,847327917300,847368372100,40454800,-1
514,1,STEP,847368444700,847407608000,39163300,-1
515,1,STEP,847407681900,847448247700,40565800,-1
516,1,STEP,847448356800,847486985600,38628800,-1
517,1,STEP,847487047300,847526493600,39446300,-1
518,1,STEP,847526555000,847566661400,40106400,-1
519,1,STEP,847566724200,847606494500,39770300,-1
520,1,STEP,847606559600,847647084300,40524700,-1
521,1,STEP,847647143200,847687089500,39946300,-1
522,1,STEP,847687151200,847726790600,39639400,-1
523,1,STEP,847726851100,847766386400,39535300,-1
524,1,STEP,847766461100,847805185000,38723900,-1
525,1,STEP,847805242100,847844200700,38958600,-1
526,1,STEP,847844258900,847883562900,39304000,-1
527,1,STEP,847883617000,847923783100,40166100,-1
528,1,STEP,847923850200,847964081700,40231500,-1
529,1,STEP,847964142500,848004089900,39947400,-1
530,1,STEP,848004148400,848043898300,39749900,-1
531,1,STEP,848043989700,848084884700,40895000,-1
532,1,STEP,848084941300,848123945100,39003800,-1
533,1,STEP,848124008700,848164622000,40613300,-1
534,1,STEP,848164684000,848204515600,39831600,-1
535,1,STEP,848204601000,848244304800,39703800,-1
536,1,STEP,848244365500,848285265500,40900000,-1
537,1,STEP,848285327700,848325869100,40541400,-1
538,1,STEP,848325930000,848365651800,39721800,-1
539,1,STEP,848365721400,848405722200,40000800,-1
540,1,STEP,848405784800,848446021700,40236900,-1
541,1,STEP,848446080300,848487342000,41261700,-1
542,1,STEP,848487393400,848528824800,41431400,-1
543,1,STEP,848528923100,848568654700,39731600,-1
544,1,STEP,848568701000,848609109300,40408300,-1
545,1,STEP,848609164200,848650478000,41313800,-1
546,1,STEP,848650534100,848691953100,41419000,-1
547,1,STEP,848692014600,848732390500,40375900,-1
548,1,STEP,848732451100,848773314500,40863400,-1
549,1,STEP,848773376300,848814091700,40715400,-1
550,1,STEP,848814144800,848856736600,42591800,-1
551,1,STEP,848856797400,848897725600,40928200,-1
552,1,STEP,848897781000,848937378700,39597700,-1
553,1,STEP,848937436100,848977656800,40220700,-1
554,1,STEP,848977719900,849018884300,41164400,-1
555,1,STEP,849018939100,849060900300,41961200,-1
556,1,STEP,849060957700,849100738100,39780400,-1
557,1,STEP,849100813600,849141790100,40976500,-1
558,1,STEP,849141850600,849181631100,39780500,-1
559,1,STEP,849181683500,849223419400,41735900,-1
560,1,STEP,849223471900,849263387100,39915200,-1
561,1,STEP,849263450900,849304949100,41498200,-1
562,1,STEP,849305061700,849346434500,41372800,-1
563,1,STEP,849346481700,849386801600,40319900,-1
564,1,STEP,849386876200,849427678900,40802700,-1
565,1,STEP,849427732100,849468969200,41237100,-1
566,1,STEP,849469029100,849510342500,41313400,-1
567,1,STEP,849510405000,849551465200,41060200,-1
568,1,STEP,849551542800,849593642200,42099400,-1
569,1,STEP,849593716700,849635699000,41982300,-1
570,1,STEP,849635760200,849678817500,43057300,-1
571,1,STEP,849678869900,849719560600,40690700,-1
572,1,STEP,849719616400,849761631700,42015300,-1
573,1,STEP,849761688300,849803428800,41740500,-1
574,1,STEP,849803488700,849844900300,41411600,-1
575,1,STEP,849844956300,849885843300,40887000,-1
576,1,STEP,849885901200,849927261000,41359800,-1
577,1,STEP,849927329500,849968824700,41495200,-1
578,1,STEP,849968912000,850010563100,41651100,-1
579,1,STEP,850010631500,850052568400,41936900,-1
580,1,STEP,850052646200,850094636300,41990100,-1
581,1,STEP,850094697600,850136294700,41597100,-1
582,1,STEP,850136355900,850178320700,41964800,-1
583,1,STEP,850178386000,850220451300,42065300,-1
584,1,STEP,850220508800,850263850700,43341900,-1
585,1,STEP,850263917400,850306853400,42936000,-1
586,1,STEP,850306905800,850348639700,41733900,-1
587,1,STEP,850348695800,850391012700,42316900,-1
588,1,STEP,850391062500,850433007000,41944500,-1
589,1,STEP,850433073800,850474470200,41396400,-1
590,1,STEP,850474543400,850516091000,41547600,-1
591,1,STEP,850516149200,850557793400,41644200,-1
592,1,STEP,850557870300,850599623700,41753400,-1
593,1,STEP,850599687100,850641592400,41905300,-1
594,1,STEP,850641653000,850683206100,41553100,-1
595,1,STEP,850683266700,850724992700,41726000,-1
596,1,STEP,850725060900,850767244300,42183400,-1
597,1,STEP,850767305300,850809986500,42681200,-1
598,1,STEP,850810040500,850851991700,41951200,-1
599,1,STEP,850852050900,850894790800,42739900,-1
600,1,STEP,850894848100,850937996900,43148800,-1
601,1,STEP,850938054400,850980748500,42694100,-1
602,1,STEP,850980800700,851022773800,41973100,-1
603,1,STEP,851022827500,851063736700,40909200,-1
604,1,STEP,851063799600,851105634000,41834400,-1
605,1,STEP,851105702800,851148251500,42548700,-1
606,1,STEP,851148324600,851189633100,41308500,-1
607,1,STEP,851189691400,851231888700,42197300,-1
608,1,STEP,851231951200,851274734400,42783200,-1
609,1,STEP,851274794100,851317900000,43105900,-1
610,1,STEP,851317964400,851360811900,42847500,-1
611,1,STEP,851360878800,851403740900,42862100,-1
612,1,STEP,851403798800,851446712300,42913500,-1
613,1,STEP,851446783600,851488892400,42108800,-1
614,1,STEP,851488971800,851530231000,41259200,-1
615,1,STEP,851530289100,851573557300,43268200,-1
616,1,STEP,851573616400,851616590000,42973600,-1
617,1,STEP,851616653000,851659146200,42493200,-1
618,1,STEP,851659200300,851702390300,43190000,-1
619,1,STEP,851702447800,851746196700,43748900,-1
620,1,STEP,851746259000,851788412200,42153200,-1
621,1,STEP,851788473400,851831348400,42875000,-1
622,1,STEP,851831409900,851873849900,42440000,-1
623,1,STEP,851873904500,851916485400,42580900,-1
624,1,STEP,851916563000,851959240300,42677300,-1
625,1,STEP,851959290200,852001003600,41713400,-1
626,1,STEP,852001065900,852044867200,43801300,-1
627,1,STEP,852044931100,852089049200,44118100,-1
628,1,STEP,852089105200,852132809600,43704400,-1
629,1,STEP,852132861100,852176653300,43792200,-1
630,1,STEP,852176717700,852220245600,43527900,-1
631,1,STEP,852220346300,852263494700,43148400,-1
632,1,STEP,852263601700,852307478400,43876700,-1
633,1,STEP,852307533900,852349836500,42302600,-1
634,1,STEP,852349925400,852391961700,42036300,-1
635,1,STEP,852392040000,852435820200,43780200,-1
636,1,STEP,852435874300,852477620700,41746400,-1
637,1,STEP,852477678600,852520804300,43125700,-1
638,1,STEP,852520853900,852562674800,41820900,-1
639,1,STEP,852562728700,852605646900,42918200,-1
640,1,STEP,852605703800,852648481700,42777900,-1
641,1,STEP,852648594300,852690844800,42250500,-1
642,1,STEP,852690906900,852734298300,43391400,-1
643,1,STEP,852734357600,852778444300,44086700,-1
644,1,STEP,852778552000,852821726600,43174600,-1
645,1,STEP,852822769900,852865783600,43013700,-1
646,1,STEP,852865907400,852908069500,42162100,-1
647,1,STEP,852908122200,852951068000,42945800,-1
648,1,STEP,852951121700,852994219700,43098000,-1
649,1,STEP,852994272500,853037172000,42899500,-1
650,1,STEP,853037228300,853081376800,44148500,-1
651,1,STEP,853081432200,853124596400,43164200,-1
652,1,STEP,853124654200,853167707600,43053400,-1
653,1,STEP,853167798100,853211019400,43221300,-1
654,1,STEP,853211092800,853253578000,42485200,-1
655,1,STEP,853253652600,853296393700,42741100,-1
656,1,STEP,853296453800,853338669200,42215400,-1
657,1,STEP,853338728000,853381996900,43268900,-1
658,1,STEP,853382048400,853426118300,44069900,-1
659,1,STEP,853426202600,853469342700,43140100,-1
660,1,STEP,853469403700,853512491400,43087700,-1
661,1,STEP,853512545100,853556643700,44098600,-1
662,1,STEP,853556701200,853600271600,43570400,-1
663,1,STEP,853600346800,853644264400,43917600,-1
664,1,STEP,853644323000,853688426500,44103500,-1
665,1,STEP,853688484000,853732470300,43986300,-1
666,1,STEP,853732539500,853775621000,43081500,-1
667,1,STEP,853775685400,853818939000,43253600,-1
668,1,STEP,853818992000,853862815000,43823000,-1
669,1,STEP,853862885800,853906087200,43201400,-1
670,1,STEP,853906153200,853949421600,43268400,-1
671,1,STEP,853949479300,853993162300,43683000,-1
672,1,STEP,853993232600,854039095800,45863200,-1
673,1,STEP,854039173100,854082580500,43407400,-1
674,1,STEP,854082633700,854125172000,42538300,-1
675,1,STEP,854125236700,854168662300,43425600,-1
676,1,STEP,854168712300,854213058600,44346300,-1
677,1,STEP,854213120700,854257696100,44575400,-1
678,1,STEP,854257753000,854301042200,43289200,-1
679,1,STEP,854301112200,854343239000,42126800,-1
680,1,STEP,854343303500,854386821500,43518000,-1
681,1,STEP,854386884600,854429733900,42849300,-1
682,1,STEP,854429788100,854473434900,43646800,-1
683,1,STEP,854473494000,854517415600,43921600,-1
684,1,STEP,854517492900,854561015700,43522800,-1
685,1,STEP,854561078500,854604691300,43612800,-1
686,1,STEP,854604750900,854647892900,43142000,-1
687,1,STEP,854647952600,854691365900,43413300,-1
688,1,STEP,854691431900,854735241100,43809200,-1
689,1,STEP,854735299900,854780278900,44979000,-1
690,1,STEP,854780348600,854823913900,43565300,-1
691,1,STEP,854823972900,854866996900,43024000,-1
692,1,STEP,854867055100,854910450900,43395800,-1
693,1,STEP,854910504700,854952856900,42352200,-1
694,1,STEP,854952917900,854995517500,42599600,-1
695,1,STEP,854995582500,855037562500,41980000,-1
696,1,STEP,855037638100,855080454900,42816800,-1
697,1,STEP,855080518400,855125020900,44502500,-1
698,1,STEP,855125081400,855168730700,43649300,-1
699,1,STEP,855168784900,855212051600,43266700,-1
700,1,STEP,855212116400,855255498900,43382500,-1
701,1,STEP,855255554400,855298530600,42976200,-1
702,1,STEP,855298597800,855343431800,44834000,-1
703,1,STEP,855343509600,855388224500,44714900,-1
704,1,STEP,855388285000,855430594300,42309300,-1
705,1,STEP,855430651600,855474708900,44057300,-1
706,1,STEP,855474771200,855519017800,44246600,-1
707,1,STEP,855519077100,855563317900,44240800,-1
708,1,STEP,855563380900,855607767300,44386400,-1
709,1,STEP,855607845000,855653263200,45418200,-1
710,1,STEP,855653317700,855696894700,43577000,-1
711,1,STEP,855696963600,855739994100,43030500,-1
712,1,STEP,855740056700,855783476500,43419800,-1
713,1,STEP,855783537100,855828889700,45352600,-1
714,1,STEP,855828948200,855874532100,45583900,-1
715,1,STEP,855874589700,855916967600,42377900,-1
716,1,STEP,855917024700,855960935900,43911200,-1
717,1,STEP,855961014100,856004904900,43890800,-1
718,1,STEP,856004965300,856047998800,43033500,-1
719,1,STEP,856048052800,856092378600,44325800,-1
720,1,STEP,856092431900,856136496300,44064400,-1
721,1,STEP,856136564900,856181667100,45102200,-1
722,1,STEP,856181744100,856224842300,43098200,-1
723,1,STEP,856224913400,856267830000,42916600,-1
724,1,STEP,856267957200,856312102800,44145600,-1
725,1,STEP,856312154700,856357505200,45350500,-1
726,1,STEP,856357566500,856402077100,44510600,-1
727,1,STEP,856402149700,856445672500,43522800,-1
728,1,STEP,856445734100,856490549000,44814900,-1
729,1,STEP,856490621100,856534306300,43685200,-1
730,1,STEP,856534366800,856578910600,44543800,-1
731,1,STEP,856578980100,856622345300,43365200,-1
732,1,STEP,856622431600,856667728000,45296400,-1
733,1,STEP,856667783100,856711209700,43426600,-1
734,1,STEP,856711303500,856755659600,44356100,-1
735,1,STEP,856755727300,856799658700,43931400,-1
736,1,STEP,856799730300,856843183100,43452800,-1
737,1,STEP,856843264800,856887470200,44205400,-1
738,1,STEP,856887527000,856931232000,43705000,-1
739,1,STEP,856931283300,856974205100,42921800,-1
740,1,STEP,856974262200,857017774400,43512200,-1
741,1,STEP,857017853700,857061471400,43617700,-1
742,1,STEP,857061530600,857104730500,43199900,-1
743,1,STEP,857104795900,857149720500,44924600,-1
744,1,STEP,857149784900,857193069700,43284800,-1
745,1,STEP,857193125800,857237288200,44162400,-1
746,1,STEP,857237347900,857282004000,44656100,-1
747,1,STEP,857282058400,857325928500,43870100,-1
748,1,STEP,857325994000,857370691900,44697900,-1
749,1,STEP,857370761600,857414608600,43847000,-1
750,1,STEP,857414664600,857458217400,43552800,-1
751,1,STEP,857458284000,857501665000,43381000,-1
752,1,STEP,857501729800,857546632900,44903100,-1
753,1,STEP,857546695900,857591038600,44342700,-1
754,1,STEP,857591092100,857635403600,44311500,-1
755,1,STEP,857635474200,857677915800,42441600,-1
756,1,STEP,857677988500,857721716600,43728100,-1
757,1,STEP,857721775700,857766586900,44811200,-1
758,1,STEP,857766658100,857810420000,43761900,-1
759,1,STEP,857810474300,857854350900,43876600,-1
760,1,STEP,857854408600,857899290700,44882100,-1
761,1,STEP,857899351800,857942604500,43252700,-1
762,1,STEP,857942663100,857986557600,43894500,-1
763,1,STEP,857986618600,858031471100,44852500,-1
764,1,STEP,858031540200,858075821800,44281600,-1
765,1,STEP,858075888600,858120898600,45010000,-1
766,1,STEP,858120974100,858164112500,43138400,-1
767,1,STEP,858164178000,858206870000,42692000,-1
768,1,STEP,858206934400,858251109700,44175300,-1
769,1,STEP,858251172600,858295060200,43887600,-1
770,1,STEP,858295136500,858340023100,44886600,-1
771,1,STEP,858340084200,858383514500,43430300,-1
772,1,STEP,858383565700,858427423600,43857900,-1
773,1,STEP,858427481700,858471604700,44123000,-1
774,1,STEP,858471655200,858516199900,44544700,-1
775,1,STEP,858516266300,858560356200,44089900,-1
776,1,STEP,858560416400,858605751600,45335200,-1
777,1,STEP,858605810700,858650663300,44852600,-1
778,1,STEP,858650724100,858693893500,43169400,-1
779,1,STEP,858693947600,858739340200,45392600,-1
780,1,STEP,858739408300,858783382000,43973700,-1
781,1,STEP,858783439900,858826502900,43063000,-1
782,1,STEP,858826549900,858869443900,42894000,-1
783,1,STEP,858869495400,858913127100,43631700,-1
784,1,STEP,858913203400,858957516500,44313100,-1
785,1,STEP,858957646200,859001327500,43681300,-1
786,1,STEP,859001377800,859044713300,43335500,-1
787,1,STEP,859044774700,859087814800,43040100,-1
788,1,STEP,859087871000,859131860200,43989200,-1
789,1,STEP,859131922400,859175801900,43879500,-1
790,1,STEP,859175865700,859220086100,44220400,-1
791,1,STEP,859220141300,859263472500,43331200,-1
792,1,STEP,859263526200,859307582900,44056700,-1
793,1,STEP,859307642200,859352248500,44606300,-1
794,1,STEP,859352303200,859396571900,44268700,-1
795,1,STEP,859396631600,859440059700,43428100,-1
796,1,STEP,859440120000,859483787000,43667000,-1
797,1,STEP,859483850500,859527699000,43848500,-1
798,1,STEP,859527753600,859571035200,43281600,-1
799,1,STEP,859571097000,859615210900,44113900,-1
800,1,STEP,859615289800,859659891000,44601200,-1
801,1,STEP,859659947400,859704169600,44222200,-1
802,1,STEP,859704252700,859748262100,44009400,-1
803,1,STEP,859748323100,859791799300,43476200,-1
804,1,STEP,859791862100,859836559400,44697300,-1
805,1,STEP,859836646600,859879930800,43284200,-1
806,1,STEP,859879987100,859923868600,43881500,-1
807,1,STEP,859923944000,859967815000,43871000,-1
808,1,STEP,859967865900,860012932200,45066300,-1
809,1,STEP,860012989600,860056134200,43144600,-1
810,1,STEP,860056189000,860101577000,45388000,-1
811,1,STEP,860101657200,860144956400,43299200,-1
812,1,STEP,860145010300,860189120300,44110000,-1
813,1,STEP,860189175700,860231819300,42643600,-1
814,1,STEP,860231883100,860275912700,44029600,-1
815,1,STEP,860275970900,860319654200,43683300,-1
816,1,STEP,860319708400,860362893600,43185200,-1
817,1,STEP,860362947600,860407460100,44512500,-1
818,1,STEP,860407525000,860452021000,44496000,-1
819,1,STEP,860452078900,860494637300,42558400,-1
820,1,STEP,860494705700,860537498100,42792400,-1
821,1,STEP,860537579900,860581811400,44231500,-1
822,1,STEP,860581870500,860626081000,44210500,-1
823,1,STEP,860626137400,860670894400,44757000,-1
824,1,STEP,860670952200,860715332300,44380100,-1
825,1,STEP,860715392300,860758727600,43335300,-1
826,1,STEP,860758784400,860802244200,43459800,-1
827,1,STEP,860802296800,860847086600,44789800,-1
828,1,STEP,860847142700,860890988600,43845900,-1
829,1,STEP,860891041500,860933738900,42697400,-1
830,1,STEP,860933817900,860977754600,43936700,-1
831,1,STEP,860977830000,861020064000,42234000,-1
832,1,STEP,861020119600,861065044300,44924700,-1
833,1,STEP,861065112200,861109065900,43953700,-1
834,1,STEP,861109120800,861154279700,45158900,-1
835,1,STEP,861154350700,861198038500,43687800,-1
836,1,STEP,861198113500,861242392100,44278600,-1
837,1,STEP,861242450600,861286019400,43568800,-1
838,1,STEP,861286079800,861328958600,42878800,-1
839,1,STEP,861329012700,861373871800,44859100,-1
840,1,STEP,861373929200,861418459800,44530600,-1
841,1,STEP,861418533000,861462255800,43722800,-1
842,1,STEP,861462311800,861507351700,45039900,-1
843,1,STEP,861507410900,861550900800,43489900,-1
844,1,STEP,861550951300,861594748600,43797300,-1
845,1,STEP,861594828500,861638900300,44071800,-1
846,1,STEP,861638955300,861682841500,43886200,-1
847,1,STEP,861682906100,861726328400,43422300,-1
848,1,STEP,861726390700,861770348300,43957600,-1
849,1,STEP,861770408400,861814680800,44272400,-1
850,1,STEP,861814731900,861860115500,45383600,-1
851,1,STEP,861860180200,861904086500,43906300,-1
852,1,STEP,861904159000,861950418800,46259800,-1
853,1,STEP,861950478600,861993203200,42724600,-1
854,1,STEP,861993258300,862037014700,43756400,-1
855,1,STEP,862037069100,862081553100,44484000,-1
856,1,STEP,862081611000,862125357200,43746200,-1
857,1,STEP,862125412000,862169226300,43814300,-1
858,1,STEP,862169296300,862210955700,41659400,-1
859,1,STEP,862211032100,862253371100,42339000,-1
860,1,STEP,862253528100,862296539100,43011000,-1
861,1,STEP,862296606700,862340078400,43471700,-1
862,1,STEP,862340128300,862382968000,42839700,-1
863,1,STEP,862383019800,862426360300,43340500,-1
864,1,STEP,862426447300,862470141700,43694400,-1
865,1,STEP,862470197700,862513766100,43568400,-1
866,1,STEP,862513825700,862557420300,43594600,-1
867,1,STEP,862557476100,862601787300,44311200,-1
868,1,STEP,862601843000,862645396500,43553500,-1
869,1,STEP,862645452500,862689974500,44522000,-1
870,1,STEP,862690029200,862734470700,44441500,-1
871,1,STEP,862734526900,862777602800,43075900,-1
872,1,STEP,862777666800,862819909000,42242200,-1
873,1,STEP,862819979500,862864825900,44846400,-1
874,1,STEP,862864888100,862908864900,43976800,-1
875,1,STEP,862908927900,862953299800,44371900,-1
876,1,STEP,862953350900,862997296100,43945200,-1
877,1,STEP,862997357700,863039751400,42393700,-1
878,1,STEP,863039821200,863083399600,43578400,-1
879,1,STEP,863083455900,863127230600,43774700,-1
880,1,STEP,863127284800,863171320300,44035500,-1
881,1,STEP,863171377500,863215284600,43907100,-1
882,1,STEP,863215348300,863258790100,43441800,-1
883,1,STEP,863258848400,863301369400,42521000,-1
884,1,STEP,863301437400,863345101900,43664500,-1
885,1,STEP,863345200700,863389521700,44321000,-1
886,1,STEP,863389570900,863433102000,43531100,-1
887,1,STEP,863433170400,863477871300,44700900,-1
888,1,STEP,863477938800,863521101000,43162200,-1
889,1,STEP,863521153500,863564404900,43251400,-1
890,1,STEP,863564465200,863608075800,43610600,-1
891,1,STEP,863608149100,863651691600,43542500,-1
892,1,STEP,863651751700,863695068600,43316900,-1
893,1,STEP,863695128300,863738585700,43457400,-1
894,1,STEP,863738651300,863783103500,44452200,-1
895,1,STEP,863783162600,863826962500,43799900,-1
896,1,STEP,863827015700,863871829500,44813800,-1
897,1,STEP,863871889000,863915802600,43913600,-1
898,1,STEP,863915863300,863958287400,42424100,-1
899,1,STEP,863958351000,864003139600,44788600,-1
900,1,STEP,864003220800,864046336300,43115500,-1
901,1,STEP,864046439900,864088872500,42432600,-1
902,1,STEP,864088948200,864131632700,42684500,-1
903,1,STEP,864131708800,864174744900,43036100,-1
904,1,STEP,864174805900,864216590600,41784700,-1
905,1,STEP,864216653200,864260771400,44118200,-1
906,1,STEP,864260834100,864304728600,43894500,-1
907,1,STEP,864304808500,864351351800,46543300,-1
908,1,STEP,864351421200,864394503800,43082600,-1
909,1,STEP,864394559300,864437611200,43051900,-1
910,1,STEP,864437674900,864479226000,41551100,-1
911,1,STEP,864479282300,864521618000,42335700,-1
912,1,STEP,864521670400,864564714400,43044000,-1
913,1,STEP,864564769700,864608863500,44093800,-1
914,1,STEP,864608914100,864652886600,43972500,-1
915,1,STEP,864652943300,864696696700,43753400,-1
916,1,STEP,864696743600,864739774300,43030700,-1
917,1,STEP,864739825800,864783476000,43650200,-1
918,1,STEP,864783527300,864827985200,44457900,-1
919,1,STEP,864828026000,864872944300,44918300,-1
920,1,STEP,864873031200,864916888500,43857300,-1
921,1,STEP,864916945500,864959945900,43000400,-1
922,1,STEP,864960002900,865004104000,44101100,-1
923,1,STEP,865004158000,865046600100,42442100,-1
924,1,STEP,865046651600,865088974700,42323100,-1
925,1,STEP,865089024000,865132253500,43229500,-1
926,1,STEP,865132308700,865177007800,44699100,-1
927,1,STEP,865177065700,865221124500,44058800,-1
928,1,STEP,865221172600,865264937100,43764500,-1
929,1,STEP,865264989600,865308142600,43153000,-1
930,1,STEP,865308210700,865350775600,42564900,-1
931,1,STEP,865350835600,865394507700,43672100,-1
932,1,STEP,865394561900,865440189400,45627500,-1
933,1,STEP,865440243600,865484216600,43973000,-1
934,1,STEP,865484272600,865527892300,43619700,-1
935,1,STEP,865527951300,865571197300,43246000,-1
936,1,STEP,865571252700,865614451000,43198300,-1
937,1,STEP,865614513900,865658441200,43927300,-1
938,1,STEP,865658500600,865702460400,43959800,-1
939,1,STEP,865702511300,865747205500,44694200,-1
940,1,STEP,865747262900,865790839100,43576200,-1
941,1,STEP,865790885800,865834421500,43535700,-1
942,1,STEP,865834466800,865877476100,43009300,-1
943,1,STEP,865877529000,865921034500,43505500,-1
944,1,STEP,865921094400,865964546200,43451800,-1
945,1,STEP,865964604200,866008523700,43919500,-1
946,1,STEP,866008557700,866052112600,43554900,-1
947,1,STEP,866052170800,866096546800,44376000,-1
948,1,STEP,866096594300,866139737300,43143000,-1
949,1,STEP,866139812200,866184519400,44707200,-1
950,1,STEP,866184579200,866228911400,44332200,-1
951,1,STEP,866228958400,866271705900,42747500,-1
952,1,STEP,866271759200,866315394000,43634800,-1
953,1,STEP,866315453600,866358869900,43416300,-1
954,1,STEP,866358915900,866401973900,43058000,-1
955,1,STEP,866402016300,866445208000,43191700,-1
956,1,STEP,866445262700,866489568200,44305500,-1
957,1,STEP,866489619200,866533988600,44369400,-1
958,1,STEP,866534039400,866578225100,44185700,-1
959,1,STEP,866578281500,866621034400,42752900,-1
960,1,STEP,866621093600,866665243100,44149500,-1
961,1,STEP,866665297500,866708646500,43349000,-1
962,1,STEP,866708701100,866753289700,44588600,-1
963,1,STEP,866753341900,866797117600,43775700,-1
964,1,STEP,866797175100,866840539900,43364800,-1
965,1,STEP,866840596100,866883321200,42725100,-1
966,1,STEP,866883371900,866927708900,44337000,-1
967,1,STEP,866927760800,866971328000,43567200,-1
968,1,STEP,866971380800,867015397200,44016400,-1
969,1,STEP,867015452400,867059547900,44095500,-1
970,1,STEP,867059598400,867103996200,44397800,-1
971,1,STEP,867104046200,867147664900,43618700,-1
972,1,STEP,867147717700,867192044100,44326400,-1
973,1,STEP,867192096100,867236096700,44000600,-1
974,1,STEP,867236156100,867279342300,43186200,-1
975,1,STEP,867279397000,867323432500,44035500,-1
976,1,STEP,867323486900,867366769000,43282100,-1
977,1,STEP,867366819900,867410747300,43927400,-1
978,1,STEP,867410802300,867453380600,42578300,-1
979,1,STEP,867453451000,867495223600,41772600,-1
980,1,STEP,867495283900,867537050800,41766900,-1
981,1,STEP,867537105500,867581230000,44124500,-1
982,1,STEP,867581281100,867625671600,44390500,-1
983,1,STEP,867625721600,867668708900,42987300,-1
984,1,STEP,867668763800,867711845000,43081200,-1
985,1,STEP,867711930800,867755245200,43314400,-1
986,1,STEP,867755307400,867797557400,42250000,-1
987,1,STEP,867797616600,867840929500,43312900,-1
988,1,STEP,867840996100,867886467700,45471600,-1
989,1,STEP,867886526000,867930861200,44335200,-1
990,1,STEP,867930916900,867972401500,41484600,-1
991,1,STEP,867972459300,868016041800,43582500,-1
992,1,STEP,868016095800,868061169800,45074000,-1
993,1,STEP,868061221400,868103922300,42700900,-1
994,1,STEP,868103978400,868148209100,44230700,-1
995,1,STEP,868148259300,868191553800,43294500,-1
996,1,STEP,868191609200,868235611500,44002300,-1
997,1,STEP,868235664300,868279429000,43764700,-1
998,1,STEP,868279479100,868323178900,43699800,-1
999,1,STEP,868323236500,868366929200,43692700,-1
