Gen,Resource,Stamp,TimeStamp_Start,TimeStamp_End,Duration,Indiv_id
0,1,FirstEvaluation,770108046500,782688905400,12580858900,-1
0,1,STEP,782689034500,782748932500,59898000,-1
1,1,STEP,782749933800,782808090800,58157000,-1
2,1,STEP,782809515800,782858058600,48542800,-1
3,1,STEP,782859244200,782904137700,44893500,-1
4,1,STEP,782905445200,782951562800,46117600,-1
5,1,STEP,782952869000,782997526400,44657400,-1
6,1,STEP,782998705700,783043785300,45079600,-1
7,1,STEP,783044961500,783089467900,44506400,-1
8,1,STEP,783090612200,783140795500,50183300,-1
9,1,STEP,783142069600,783192838800,50769200,-1
10,1,STEP,783194106700,783240688800,46582100,-1
11,1,STEP,783241929500,783289015600,47086100,-1
12,1,STEP,783290510200,783336519600,46009400,-1
13,1,STEP,783337755000,783385553100,47798100,-1
14,1,STEP,783386835300,783435446200,48610900,-1
15,1,STEP,783436799700,783484056500,47256800,-1
16,1,STEP,783485467800,783536142500,50674700,-1
17,1,STEP,783537628600,783587736600,50108000,-1
18,1,STEP,783589290400,783640946700,51656300,-1
19,1,STEP,783642335200,783693090100,50754900,-1
20,1,STEP,783694602500,783746294700,51692200,-1
21,1,STEP,783747832400,783806166600,58334200,-1
22,1,STEP,783808614500,783863318600,54704100,-1
23,1,STEP,783865361700,783913411500,48049800,-1
24,1,STEP,783914630400,783961105800,46475400,-1
25,1,STEP,783962452700,784009703300,47250600,-1
26,1,STEP,784010925200,784056848800,45923600,-1
27,1,STEP,784058059500,784104713600,46654100,-1
28,1,STEP,784105943800,784155463200,49519400,-1
29,1,STEP,784156937400,784213805000,56867600,-1
30,1,STEP,784216055400,784271450600,55395200,-1
31,1,STEP,784273052600,784324768700,51716100,-1
32,1,STEP,784326329000,784374680900,48351900,-1
33,1,STEP,784376068700,784421650000,45581300,-1
34,1,STEP,784422874600,784468816000,45941400,-1
35,1,STEP,784470066700,784513619000,43552300,-1
36,1,STEP,784514871700,784558786500,43914800,-1
37,1,STEP,784560001400,784601529100,41527700,-1
38,1,STEP,784602753300,784646156600,43403300,-1
39,1,STEP,784647472800,784691213500,43740700,-1
40,1,STEP,784692755700,784736353300,43597600,-1
41,1,STEP,784737553800,784781292900,43739100,-1
42,1,STEP,784782462800,784825666500,43203700,-1
43,1,STEP,784826913000,784870123900,43210900,-1
44,1,STEP,784871368900,784915748300,44379400,-1
45,1,STEP,784916959700,784960482700,43523000,-1
46,1,STEP,784961677200,785005269500,43592300,-1
47,1,STEP,785006498300,785049995700,43497400,-1
48,1,STEP,785051343100,785095055700,43712600,-1
49,1,STEP,785096259000,785141373200,45114200,-1
50,1,STEP,785142547500,785186050100,43502600,-1
51,1,STEP,785187252600,785236056800,48804200,-1
52,1,STEP,785237565100,785282690000,45124900,-1
53,1,STEP,785283906900,785330041600,46134700,-1
54,1,STEP,785331427800,785381666500,50238700,-1
55,1,STEP,785383437300,785428225200,44787900,-1
56,1,STEP,785429685500,785478127900,48442400,-1
57,1,STEP,785479722200,785526002900,46280700,-1
58,1,STEP,785527288300,785572053800,44765500,-1
59,1,STEP,785573250500,785618159200,44908700,-1
60,1,STEP,785619422000,785663130400,43708400,-1
61,1,STEP,785664383100,785711454600,47071500,-1
62,1,STEP,785712659800,785758046000,45386200,-1
63,1,STEP,785759390200,785802599100,43208900,-1
64,1,STEP,785803933600,785850177200,46243600,-1
65,1,STEP,785851501800,785897222300,45720500,-1
66,1,STEP,785898383000,785940948200,42565200,-1
67,1,STEP,785942116000,785988667600,46551600,-1
68,1,STEP,785990453600,786035102000,44648400,-1
69,1,STEP,786036292300,786081140600,44848300,-1
70,1,STEP,786082333600,786128998600,46665000,-1
71,1,STEP,786130165000,786175023600,44858600,-1
72,1,STEP,786176251900,786220536200,44284300,-1
73,1,STEP,786221878200,786271334800,49456600,-1
74,1,STEP,786273357100,786323633900,50276800,-1
75,1,STEP,786325153800,786372942800,47789000,-1
76,1,STEP,786374172700,786421174800,47002100,-1
77,1,STEP,786422405100,786466658300,44253200,-1
78,1,STEP,786467838800,786513708800,45870000,-1
79,1,STEP,786514898500,786558591900,43693400,-1
80,1,STEP,786559772200,786604784200,45012000,-1
81,1,STEP,786606142900,786653069000,46926100,-1
82,1,STEP,786654570700,786701891600,47320900,-1
83,1,STEP,786703301600,786750772000,47470400,-1
84,1,STEP,786751957800,786799527900,47570100,-1
85,1,STEP,786800787100,786846528100,45741000,-1
86,1,STEP,786847714100,786892188600,44474500,-1
87,1,STEP,786893571700,786938649400,45077700,-1
88,1,STEP,786939859400,786986688200,46828800,-1
89,1,STEP,786987954700,787031608500,43653800,-1
90,1,STEP,787032777300,787074677600,41900300,-1
91,1,STEP,787075838900,787119411500,43572600,-1
92,1,STEP,787120599900,787164888400,44288500,-1
93,1,STEP,787166036500,787211526300,45489800,-1
94,1,STEP,787212869500,787257576700,44707200,-1
95,1,STEP,787258820800,787305688600,46867800,-1
96,1,STEP,787307209100,787355453600,48244500,-1
97,1,STEP,787356705300,787402507500,45802200,-1
98,1,STEP,787403715500,787447980900,44265400,-1
99,1,STEP,787449171500,787495424600,46253100,-1
100,1,STEP,787496718700,787541671100,44952400,-1
101,1,STEP,787542846100,787587755700,44909600,-1
102,1,STEP,787588930200,787635861600,46931400,-1
103,1,STEP,787637175600,787693868000,56692400,-1
104,1,STEP,787695834800,787743759500,47924700,-1
105,1,STEP,787745105200,787790606800,45501600,-1
106,1,STEP,787791887500,787841123600,49236100,-1
107,1,STEP,787842614000,787892353700,49739700,-1
108,1,STEP,787893645100,787941481100,47836000,-1
109,1,STEP,787942952100,787987315700,44363600,-1
110,1,STEP,787988507900,788033132000,44624100,-1
111,1,STEP,788034329100,788077306400,42977300,-1
112,1,STEP,788078464100,788121524500,43060400,-1
113,1,STEP,788122720900,788166835600,44114700,-1
114,1,STEP,788168245000,788209962800,41717800,-1
115,1,STEP,788211125400,788256577200,45451800,-1
116,1,STEP,788257768700,788301832100,44063400,-1
117,1,STEP,788302989300,788350598900,47609600,-1
118,1,STEP,788351847100,788396617200,44770100,-1
119,1,STEP,788397847200,788442908100,45060900,-1
120,1,STEP,788444112200,788489348400,45236200,-1
121,1,STEP,788490598900,788534779700,44180800,-1
122,1,STEP,788536048100,788580263800,44215700,-1
123,1,STEP,788581506900,788626072100,44565200,-1
124,1,STEP,788627568300,788673934800,46366500,-1
125,1,STEP,788675256400,788720695200,45438800,-1
126,1,STEP,788721897000,788765395300,43498300,-1
127,1,STEP,788766652400,788810296500,43644100,-1
128,1,STEP,788811744000,788855850700,44106700,-1
129,1,STEP,788857048200,788899345000,42296800,-1
130,1,STEP,788900703500,788946582300,45878800,-1
131,1,STEP,788947791400,788990596100,42804700,-1
132,1,STEP,788991785100,789036203300,44418200,-1
133,1,STEP,789037433700,789082833700,45400000,-1
134,1,STEP,789084056200,789128706100,44649900,-1
135,1,STEP,789129995500,789172887200,42891700,-1
136,1,STEP,789174251100,789220165000,45913900,-1
137,1,STEP,789221442100,789268427900,46985800,-1
138,1,STEP,789269762700,789313374800,43612100,-1
139,1,STEP,789314736200,789363839200,49103000,-1
140,1,STEP,789365422300,789415143800,49721500,-1
141,1,STEP,789416520500,789462799700,46279200,-1
142,1,STEP,789464081900,789509989700,45907800,-1
143,1,STEP,789511552600,789565311200,53758600,-1
144,1,STEP,789566898300,789613396100,46497800,-1
145,1,STEP,789614910500,789661492200,46581700,-1
146,1,STEP,789662900200,789707202200,44302000,-1
147,1,STEP,789708512500,789754759200,46246700,-1
148,1,STEP,789756055300,789802349900,46294600,-1
149,1,STEP,789803605300,789851090900,47485600,-1
150,1,STEP,789852386600,789898062700,45676100,-1
151,1,STEP,789899464300,789944245800,44781500,-1
152,1,STEP,789945614800,789992053200,46438400,-1
153,1,STEP,789993388600,790037317000,43928400,-1
154,1,STEP,790038639200,790083762000,45122800,-1
155,1,STEP,790085112200,790131560400,46448200,-1
156,1,STEP,790132880500,790181775200,48894700,-1
157,1,STEP,790184076100,790232459600,48383500,-1
158,1,STEP,790233787500,790284924800,51137300,-1
159,1,STEP,790286875100,790341398000,54522900,-1
160,1,STEP,790343249100,790402823100,59574000,-1
161,1,STEP,790406368500,790467909400,61540900,-1
162,1,STEP,790469811400,790523793000,53981600,-1
163,1,STEP,790525620200,790575626700,50006500,-1
164,1,STEP,790577231300,790632270900,55039600,-1
165,1,STEP,790634645400,790689119300,54473900,-1
166,1,STEP,790691038000,790741445800,50407800,-1
167,1,STEP,790743083700,790792587800,49504100,-1
168,1,STEP,790794176900,790844082100,49905200,-1
169,1,STEP,790845524300,790893107000,47582700,-1
170,1,STEP,790894543700,790942942500,48398800,-1
171,1,STEP,790944363000,790996229100,51866100,-1
172,1,STEP,790998154400,791048484400,50330000,-1
173,1,STEP,791050634400,791101551500,50917100,-1
174,1,STEP,791103134100,791153269700,50135600,-1
175,1,STEP,791155074800,791206756300,51681500,-1
176,1,STEP,791208332600,791273515200,65182600,-1
177,1,STEP,791275423400,791327753600,52330200,-1
178,1,STEP,791330033400,791388999200,58965800,-1
179,1,STEP,791392399000,791446653000,54254000,-1
180,1,STEP,791448719500,791506416200,57696700,-1
181,1,STEP,791508759300,791562346900,53587600,-1
182,1,STEP,791564012200,791615094900,51082700,-1
183,1,STEP,791616692300,791667972800,51280500,-1
184,1,STEP,791669773000,791723189400,53416400,-1
185,1,STEP,791726264500,791793759500,67495000,-1
186,1,STEP,791796040900,791852571700,56530800,-1
187,1,STEP,791854233300,791916768900,62535600,-1
188,1,STEP,791918872400,791993042600,74170200,-1
189,1,STEP,791995870400,792062724800,66854400,-1
190,1,STEP,792065007800,792151532900,86525100,-1
191,1,STEP,792156032500,792321263400,165230900,-1
192,1,STEP,792325211400,792520463300,195251900,-1
193,1,STEP,792524168700,792766402400,242233700,-1
194,1,STEP,792780642800,793015178600,234535800,-1
195,1,STEP,793030532500,793253528400,222995900,-1
196,1,STEP,793267512400,793385186400,117674000,-1
197,1,STEP,793387945600,793468822700,80877100,-1
198,1,STEP,793471787900,793531178500,59390600,-1
199,1,STEP,793532909300,793598435200,65525900,-1
200,1,STEP,793602061100,793664976900,62915800,-1
201,1,STEP,793666740700,793724154700,57414000,-1
202,1,STEP,793725704400,793777686300,51981900,-1
203,1,STEP,793779417400,793833911800,54494400,-1
204,1,STEP,793835689200,793888665000,52975800,-1
205,1,STEP,793890786500,793947976700,57190200,-1
206,1,STEP,793949721800,794016000000,66278200,-1
207,1,STEP,794020073100,794117875800,97802700,-1
208,1,STEP,794120454100,794206065300,85611200,-1
209,1,STEP,794208399900,794285705300,77305400,-1
210,1,STEP,794288289900,794362195200,73905300,-1
211,1,STEP,794364344700,794422086700,57742000,-1
212,1,STEP,794423934800,794484999700,61064900,-1
213,1,STEP,794486716200,794539412600,52696400,-1
214,1,STEP,794540994400,794594732600,53738200,-1
215,1,STEP,794596419400,794655989600,59570200,-1
216,1,STEP,794657565700,794717436900,59871200,-1
217,1,STEP,794719217400,794816709500,97492100,-1
218,1,STEP,794818440600,794905394000,86953400,-1
219,1,STEP,794907189600,795000509000,93319400,-1
220,1,STEP,795004251600,795101848200,97596600,-1
221,1,STEP,795109268800,795239566300,130297500,-1
222,1,STEP,795244542900,795350132100,105589200,-1
223,1,STEP,795353358300,795440570000,87211700,-1
224,1,STEP,795444233700,795516766100,72532400,-1
225,1,STEP,795518644600,795593305000,74660400,-1
226,1,STEP,795595153000,795680368900,85215900,-1
227,1,STEP,795682647100,795749289900,66642800,-1
228,1,STEP,795751040300,795831051300,80011000,-1
229,1,STEP,795832995500,795934674800,101679300,-1
230,1,STEP,795937100400,796015145900,78045500,-1
231,1,STEP,796017905600,796082311000,64405400,-1
232,1,STEP,796084513400,796166706100,82192700,-1
233,1,STEP,796168864500,796281123100,112258600,-1
234,1,STEP,796284366400,796371337000,86970600,-1
235,1,STEP,796374851300,796462414800,87563500,-1
236,1,STEP,796464429800,796558956700,94526900,-1
237,1,STEP,796561875800,796638602500,76726700,-1
238,1,STEP,796640313500,796707426900,67113400,-1
239,1,STEP,796709033700,796765362600,56328900,-1
240,1,STEP,796767039800,796820933000,53893200,-1
241,1,STEP,796822910300,796873116000,50205700,-1
242,1,STEP,796874621600,796931040400,56418800,-1
243,1,STEP,796932667900,797005749300,73081400,-1
244,1,STEP,797008718600,797076816500,68097900,-1
245,1,STEP,797079411500,797157437600,78026100,-1
246,1,STEP,797160177400,797243442300,83264900,-1
247,1,STEP,797245934300,797319960200,74025900,-1
248,1,STEP,797323064200,797395731900,72667700,-1
249,1,STEP,797398602700,797470300200,71697500,-1
250,1,STEP,797471846700,797533525700,61679000,-1
251,1,STEP,797535171000,797592933500,57762500,-1
252,1,STEP,797594988800,797654558700,59569900,-1
253,1,STEP,797656279700,797719792200,63512500,-1
254,1,STEP,797721389600,797775882500,54492900,-1
255,1,STEP,797777440900,797835129100,57688200,-1
256,1,STEP,797839269600,797903828600,64559000,-1
257,1,STEP,797905482100,797969592700,64110600,-1
258,1,STEP,797972651200,798051499700,78848500,-1
259,1,STEP,798054123900,798136159600,82035700,-1
260,1,STEP,798138958900,798215340500,76381600,-1
261,1,STEP,798217346200,798283936600,66590400,-1
262,1,STEP,798285889100,798339280600,53391500,-1
263,1,STEP,798340874300,798398994900,58120600,-1
264,1,STEP,798400568600,798452435600,51867000,-1
265,1,STEP,798454168000,798511288700,57120700,-1
266,1,STEP,798512777100,798589571800,76794700,-1
267,1,STEP,798591599600,798652607100,61007500,-1
268,1,STEP,798654276200,798714362600,60086400,-1
269,1,STEP,798715949600,798774487000,58537400,-1
270,1,STEP,798776718600,798835366000,58647400,-1
271,1,STEP,798837422900,798892084900,54662000,-1
272,1,STEP,798893681300,798953957900,60276600,-1
273,1,STEP,798955673500,799014055400,58381900,-1
274,1,STEP,799016234200,799071324700,55090500,-1
275,1,STEP,799073017400,799130235600,57218200,-1
276,1,STEP,799132023500,799189521300,57497800,-1
277,1,STEP,799191362100,799250549500,59187400,-1
278,1,STEP,799252413400,799313065900,60652500,-1
279,1,STEP,799314827200,799368610100,53782900,-1
280,1,STEP,799370336100,799423929000,53592900,-1
281,1,STEP,799425743400,799482966300,57222900,-1
282,1,STEP,799484510600,799541526600,57016000,-1
283,1,STEP,799543179800,799598070400,54890600,-1
284,1,STEP,799600023000,799653675100,53652100,-1
285,1,STEP,799655324100,799708801900,53477800,-1
286,1,STEP,799710491400,799763053300,52561900,-1
287,1,STEP,799764645800,799818704200,54058400,-1
288,1,STEP,799820483800,799873125600,52641800,-1
289,1,STEP,799874786600,799926911300,52124700,-1
290,1,STEP,799928861700,799987606400,58744700,-1
291,1,STEP,799989220900,800046954400,57733500,-1
292,1,STEP,800049298400,800150943600,101645200,-1
293,1,STEP,800152861700,800222682100,69820400,-1
294,1,STEP,800226801600,800298738900,71937300,-1
295,1,STEP,800300644100,800365859300,65215200,-1
296,1,STEP,800367439100,800426795700,59356600,-1
297,1,STEP,800428429100,800484431200,56002100,-1
298,1,STEP,800487202200,800543024700,55822500,-1
299,1,STEP,800544841700,800609557800,64716100,-1
300,1,STEP,800611693900,800678046200,66352300,-1
301,1,STEP,800680276700,800747140800,66864100,-1
302,1,STEP,800748769000,800804540100,55771100,-1
303,1,STEP,800806160800,800880735500,74574700,-1
304,1,STEP,800882641100,800946923000,64281900,-1
305,1,STEP,800948616300,801011120200,62503900,-1
306,1,STEP,801013119400,801076562900,63443500,-1
307,1,STEP,801078413900,801142425900,64012000,-1
308,1,STEP,801144547900,801203562400,59014500,-1
309,1,STEP,801205561300,801257884800,52323500,-1
310,1,STEP,801259515300,801311066900,51551600,-1
311,1,STEP,801312732600,801366651500,53918900,-1
312,1,STEP,801368499200,801424923600,56424400,-1
313,1,STEP,801426602200,801497317900,70715700,-1
314,1,STEP,801499094900,801554729300,55634400,-1
315,1,STEP,801556677600,801613313800,56636200,-1
316,1,STEP,801614935100,801675423200,60488100,-1
317,1,STEP,801677246500,801747776000,70529500,-1
318,1,STEP,801750178600,801817604700,67426100,-1
319,1,STEP,801819426100,801878010400,58584300,-1
320,1,STEP,801879734500,801936933700,57199200,-1
321,1,STEP,801939505900,802003705700,64199800,-1
322,1,STEP,802005492100,802075630900,70138800,-1
323,1,STEP,802077714500,802159670100,81955600,-1
324,1,STEP,802161803300,802231615100,69811800,-1
325,1,STEP,802234696900,802310221300,75524400,-1
326,1,STEP,802312559000,802380306700,67747700,-1
327,1,STEP,802382129200,802443593500,61464300,-1
328,1,STEP,802445577800,802507723700,62145900,-1
329,1,STEP,802509422300,802569735100,60312800,-1
330,1,STEP,802571435300,802639205000,67769700,-1
331,1,STEP,802640989700,802713155900,72166200,-1
332,1,STEP,802714852600,802783487800,68635200,-1
333,1,STEP,802785620600,802844457500,58836900,-1
334,1,STEP,802846527500,802929468000,82940500,-1
335,1,STEP,802931649300,803003776200,72126900,-1
336,1,STEP,803006603900,803096774500,90170600,-1
337,1,STEP,803100545800,803183026300,82480500,-1
338,1,STEP,803186089800,803266240700,80150900,-1
339,1,STEP,803268985000,803337625400,68640400,-1
340,1,STEP,803339360300,803405969200,66608900,-1
341,1,STEP,803408186300,803465970600,57784300,-1
342,1,STEP,803467566200,803523901500,56335300,-1
343,1,STEP,803525506600,803579763300,54256700,-1
344,1,STEP,803581373000,803638031600,56658600,-1
345,1,STEP,803639534000,803702720300,63186300,-1
346,1,STEP,803704350800,803757783000,53432200,-1
347,1,STEP,803759507800,803815431300,55923500,-1
348,1,STEP,803816943600,803876907500,59963900,-1
349,1,STEP,803878514900,803929059800,50544900,-1
350,1,STEP,803930750200,803983326800,52576600,-1
351,1,STEP,803985172500,804040710900,55538400,-1
352,1,STEP,804042706800,804106968900,64262100,-1
353,1,STEP,804108459000,804163151500,54692500,-1
354,1,STEP,804165006800,804224304700,59297900,-1
355,1,STEP,804226278800,804287029400,60750600,-1
356,1,STEP,804290053500,804350797500,60744000,-1
357,1,STEP,804352797500,804407838000,55040500,-1
358,1,STEP,804409434200,804464928800,55494600,-1
359,1,STEP,804466503300,804520616500,54113200,-1
360,1,STEP,804522226400,804577317100,55090700,-1
361,1,STEP,804578869600,804641013500,62143900,-1
362,1,STEP,804642642500,804701681400,59038900,-1
363,1,STEP,804703579400,804755742500,52163100,-1
364,1,STEP,804757432900,804812221100,54788200,-1
365,1,STEP,804813991900,804873255700,59263800,-1
366,1,STEP,804874975500,804933820900,58845400,-1
367,1,STEP,804935638300,804990623300,54985000,-1
368,1,STEP,804992219600,805045694400,53474800,-1
369,1,STEP,805047501500,805100928700,53427200,-1
370,1,STEP,805102578900,805157148400,54569500,-1
371,1,STEP,805158878200,805211637300,52759100,-1
372,1,STEP,805213656300,805268407100,54750800,-1
373,1,STEP,805270023500,805320728300,50704800,-1
374,1,STEP,805322504600,805380536300,58031700,-1
375,1,STEP,805382247700,805445998100,63750400,-1
376,1,STEP,805448055300,805501609200,53553900,-1
377,1,STEP,805503260500,805557970700,54710200,-1
378,1,STEP,805559577800,805612958600,53380800,-1
379,1,STEP,805614626300,805668651600,54025300,-1
380,1,STEP,805670302100,805722535700,52233600,-1
381,1,STEP,805724256800,805777984000,53727200,-1
382,1,STEP,805779698900,805835315100,55616200,-1
383,1,STEP,805836898900,805892035000,55136100,-1
384,1,STEP,805893688100,805952358000,58669900,-1
385,1,STEP,805953948500,806009629500,55681000,-1
386,1,STEP,806011192500,806067552700,56360200,-1
387,1,STEP,806069126500,806127314000,58187500,-1
388,1,STEP,806129002600,806183332500,54329900,-1
389,1,STEP,806184959600,806240569700,55610100,-1
390,1,STEP,806242121600,806298858800,56737200,-1
391,1,STEP,806300555100,806355515900,54960800,-1
392,1,STEP,806357454100,806416169100,58715000,-1
393,1,STEP,806418013700,806474033800,56020100,-1
394,1,STEP,806475861100,806528922200,53061100,-1
395,1,STEP,806530752800,806586827700,56074900,-1
396,1,STEP,806588796300,806640623500,51827200,-1
397,1,STEP,806642537200,806696103500,53566300,-1
398,1,STEP,806697769900,806749984200,52214300,-1
399,1,STEP,806751730300,806803192800,51462500,-1
400,1,STEP,806804808800,806859469100,54660300,-1
401,1,STEP,806861128100,806914977100,53849000,-1
402,1,STEP,806916532900,806967414900,50882000,-1
403,1,STEP,806969141600,807022320800,53179200,-1
404,1,STEP,807023931700,807076185500,52253800,-1
405,1,STEP,807077853900,807128771500,50917600,-1
406,1,STEP,807130480700,807182133600,51652900,-1
407,1,STEP,807183813500,807235533500,51720000,-1
408,1,STEP,807237211900,807291390800,54178900,-1
409,1,STEP,807293107100,807346321900,53214800,-1
410,1,STEP,807348004900,807401564600,53559700,-1
411,1,STEP,807403167800,807458489000,55321200,-1
412,1,STEP,807460400400,807533133100,72732700,-1
413,1,STEP,807534680500,807585755300,51074800,-1
414,1,STEP,807587459300,807644542900,57083600,-1
415,1,STEP,807646091200,807706325800,60234600,-1
416,1,STEP,807708218500,807786210000,77991500,-1
417,1,STEP,807788740500,807845318400,56577900,-1
418,1,STEP,807846797300,807906036100,59238800,-1
419,1,STEP,807907560000,807958421400,50861400,-1
420,1,STEP,807960188200,808014876000,54687800,-1
421,1,STEP,808016403100,808068563400,52160300,-1
422,1,STEP,808070200000,808123678600,53478600,-1
423,1,STEP,808125252500,808175409000,50156500,-1
424,1,STEP,808177310600,808229322400,52011800,-1
425,1,STEP,808230959000,808281978700,51019700,-1
426,1,STEP,808283617700,808336885700,53268000,-1
427,1,STEP,808338496600,808392936000,54439400,-1
428,1,STEP,808394765900,808447369200,52603300,-1
429,1,STEP,808448983800,808503484100,54500300,-1
430,1,STEP,808505138600,808560491600,55353000,-1
431,1,STEP,808562124800,808618602600,56477800,-1
432,1,STEP,808620677000,808677998000,57321000,-1
433,1,STEP,808679652400,808733217000,53564600,-1
434,1,STEP,808734827100,808786797000,51969900,-1
435,1,STEP,808788495100,808842729600,54234500,-1
436,1,STEP,808844331100,808896746400,52415300,-1
437,1,STEP,808898402000,808950186500,51784500,-1
438,1,STEP,808951829500,809003382500,51553000,-1
439,1,STEP,809005063100,809059158500,54095400,-1
440,1,STEP,809060732900,809111674400,50941500,-1
441,1,STEP,809113528200,809165677500,52149300,-1
442,1,STEP,809167303500,809218667400,51363900,-1
443,1,STEP,809220409900,809274809700,54399800,-1
444,1,STEP,809276380000,809327949700,51569700,-1
445,1,STEP,809329666900,809382875100,53208200,-1
446,1,STEP,809384485900,809437976800,53490900,-1
447,1,STEP,809439671400,809493646500,53975100,-1
448,1,STEP,809495197200,809546902300,51705100,-1
449,1,STEP,809548725100,809602308900,53583800,-1
450,1,STEP,809603944700,809655795200,51850500,-1
451,1,STEP,809657494900,809710401700,52906800,-1
452,1,STEP,809712142100,809765291600,53149500,-1
453,1,STEP,809767022700,809818447600,51424900,-1
454,1,STEP,809820075800,809871356000,51280200,-1
455,1,STEP,809873217300,809932967200,59749900,-1
456,1,STEP,809934809900,809986659300,51849400,-1
457,1,STEP,809988375800,810040316800,51941000,-1
458,1,STEP,810041955500,810094522200,52566700,-1
459,1,STEP,810096355300,810151744700,55389400,-1
460,1,STEP,810153284900,810203973800,50688900,-1
461,1,STEP,810205585300,810259592400,54007100,-1
462,1,STEP,810261138600,810316856100,55717500,-1
463,1,STEP,810318503200,810373063500,54560300,-1
464,1,STEP,810374659300,810427277700,52618400,-1
465,1,STEP,810428875100,810484748600,55873500,-1
466,1,STEP,810486560600,810541610700,55050100,-1
467,1,STEP,810543155200,810594313400,51158200,-1
468,1,STEP,810595958500,810649227000,53268500,-1
469,1,STEP,810652365000,810708177300,55812300,-1
470,1,STEP,810709657200,810760301200,50644000,-1
471,1,STEP,810762027800,810813990800,51963000,-1
472,1,STEP,810815606700,810869330800,53724100,-1
473,1,STEP,810871097500,810925902900,54805400,-1
474,1,STEP,810927765000,810984451700,56686700,-1
475,1,STEP,810986421400,811045515900,59094500,-1
476,1,STEP,811047016300,811101037600,54021300,-1
477,1,STEP,811102655900,811153568900,50913000,-1
478,1,STEP,811155291400,811208867600,53576200,-1
479,1,STEP,811210566100,811262305200,51739100,-1
480,1,STEP,811264006600,811317231700,53225100,-1
481,1,STEP,811318810800,811371545300,52734500,-1
482,1,STEP,811373567200,811427207400,53640200,-1
483,1,STEP,811428796800,811483954900,55158100,-1
484,1,STEP,811486046100,811540445200,54399100,-1
485,1,STEP,811542069100,811593363800,51294700,-1
486,1,STEP,811595064100,811648478400,53414300,-1
487,1,STEP,811650049200,811706236200,56187000,-1
488,1,STEP,811708230100,811759329900,51099800,-1
489,1,STEP,811761131600,811812428300,51296700,-1
490,1,STEP,811814555300,811870472400,55917100,-1
491,1,STEP,811872178600,811926080200,53901600,-1
492,1,STEP,811927679300,811997312700,69633400,-1
493,1,STEP,811998947800,812052300600,53352800,-1
494,1,STEP,812053880800,812106330100,52449300,-1
495,1,STEP,812108001300,812161856900,53855600,-1
496,1,STEP,812163445600,812214725400,51279800,-1
497,1,STEP,812216433000,812271066300,54633300,-1
498,1,STEP,812272632600,812323529200,50896600,-1
499,1,STEP,812325169500,812385856600,60687100,-1
500,1,STEP,812387486000,812438619600,51133600,-1
501,1,STEP,812440436600,812494464500,54027900,-1
502,1,STEP,812496090700,812548367600,52276900,-1
503,1,STEP,812550181800,812602983300,52801500,-1
504,1,STEP,812604595100,812654446900,49851800,-1
505,1,STEP,812655984800,812710127600,54142800,-1
506,1,STEP,812711693300,812765604200,53910900,-1
507,1,STEP,812767255500,812819679400,52423900,-1
508,1,STEP,812821291400,812872225200,50933800,-1
509,1,STEP,812873918500,812926704400,52785900,-1
510,1,STEP,812928294800,812981986400,53691600,-1
511,1,STEP,812983650400,813036440300,52789900,-1
512,1,STEP,813039003500,813092880400,53876900,-1
513,1,STEP,813094475500,813147531400,53055900,-1
514,1,STEP,813149231600,813200470600,51239000,-1
515,1,STEP,813202224300,813255406500,53182200,-1
516,1,STEP,813257065700,813309844900,52779200,-1
517,1,STEP,813311435200,813365136900,53701700,-1
518,1,STEP,813366713900,813418636600,51922700,-1
519,1,STEP,813420284100,813472901000,52616900,-1
520,1,STEP,813474598200,813527825100,53226900,-1
521,1,STEP,813529441300,813580789300,51348000,-1
522,1,STEP,813582568900,813642316800,59747900,-1
523,1,STEP,813644277400,813698617600,54340200,-1
524,1,STEP,813700343500,813753324700,52981200,-1
525,1,STEP,813754947500,813813777200,58829700,-1
526,1,STEP,813815719500,813872803500,57084000,-1
527,1,STEP,813874511800,813928236600,53724800,-1
528,1,STEP,813929946100,813985895500,55949400,-1
529,1,STEP,813989760100,814052207500,62447400,-1
530,1,STEP,814054017000,814109365900,55348900,-1
531,1,STEP,814111211500,814167211200,55999700,-1
532,1,STEP,814168908800,814224741500,55832700,-1
533,1,STEP,814226311700,814279616300,53304600,-1
534,1,STEP,814281239400,814332141600,50902200,-1
535,1,STEP,814333782800,814387651100,53868300,-1
536,1,STEP,814389424100,814443648100,54224000,-1
537,1,STEP,814445238900,814494791000,49552100,-1
538,1,STEP,814496412000,814544468100,48056100,-1
539,1,STEP,814546025300,814597971200,51945900,-1
540,1,STEP,814599687300,814651636800,51949500,-1
541,1,STEP,814653285700,814710133900,56848200,-1
542,1,STEP,814712038600,814763111300,51072700,-1
543,1,STEP,814764811300,814818620500,53809200,-1
544,1,STEP,814820590800,814875203900,54613100,-1
545,1,STEP,814876752600,814930033800,53281200,-1
546,1,STEP,814931646400,814982432200,50785800,-1
547,1,STEP,814984242800,815038543600,54300800,-1
548,1,STEP,815040100600,815095478100,55377500,-1
549,1,STEP,815097609300,815152839600,55230300,-1
550,1,STEP,815154423400,815208433400,54010000,-1
551,1,STEP,815210038000,815264294100,54256100,-1
552,1,STEP,815266116000,815317660900,51544900,-1
553,1,STEP,815319253700,815372312500,53058800,-1
554,1,STEP,815374055000,815424133100,50078100,-1
555,1,STEP,815425743400,815477584100,51840700,-1
556,1,STEP,815479238800,815532932200,53693400,-1
557,1,STEP,815534523000,815585416100,50893100,-1
558,1,STEP,815587039700,815638867100,51827400,-1
559,1,STEP,815640575900,815693426300,52850400,-1
560,1,STEP,815695039200,815749944400,54905200,-1
561,1,STEP,815751741800,815804232800,52491000,-1
562,1,STEP,815805809700,815857281300,51471600,-1
563,1,STEP,815858961700,815916236700,57275000,-1
564,1,STEP,815917991600,815969659500,51667900,-1
565,1,STEP,815971336700,816025411100,54074400,-1
566,1,STEP,816027218500,816080561300,53342800,-1
567,1,STEP,816082995600,816136423500,53427900,-1
568,1,STEP,816137989800,816191342000,53352200,-1
569,1,STEP,816193101700,816247673200,54571500,-1
570,1,STEP,816249511600,816303842300,54330700,-1
571,1,STEP,816305549000,816359608500,54059500,-1
572,1,STEP,816361191600,816421297600,60106000,-1
573,1,STEP,816423307900,816475963100,52655200,-1
574,1,STEP,816477749900,816531330300,53580400,-1
575,1,STEP,816532965600,816585523800,52558200,-1
576,1,STEP,816587099300,816639760900,52661600,-1
577,1,STEP,816641452300,816694383800,52931500,-1
578,1,STEP,816696291100,816750007300,53716200,-1
579,1,STEP,816751679500,816807312400,55632900,-1
580,1,STEP,816809074500,816863426600,54352100,-1
581,1,STEP,816865058500,816918195400,53136900,-1
582,1,STEP,816919831900,816976046100,56214200,-1
583,1,STEP,816977615300,817031670500,54055200,-1
584,1,STEP,817033547900,817086933500,53385600,-1
585,1,STEP,817088504000,817140354000,51850000,-1
586,1,STEP,817142022600,817194750500,52727900,-1
587,1,STEP,817196370800,817248678900,52308100,-1
588,1,STEP,817250312100,817303342000,53029900,-1
589,1,STEP,817304934700,817360231300,55296600,-1
590,1,STEP,817361797600,817416731400,54933800,-1
591,1,STEP,817419263700,817472023800,52760100,-1
592,1,STEP,817473790400,817529538000,55747600,-1
593,1,STEP,817531687800,817583432700,51744900,-1
594,1,STEP,817585026500,817635464700,50438200,-1
595,1,STEP,817637329400,817688724000,51394600,-1
596,1,STEP,817691403300,817744417600,53014300,-1
597,1,STEP,817746367300,817799291900,52924600,-1
598,1,STEP,817801190400,817857476800,56286400,-1
599,1,STEP,817859173400,817912874000,53700600,-1
600,1,STEP,817914496500,817966567400,52070900,-1
601,1,STEP,817968277300,818026907300,58630000,-1
602,1,STEP,818028594700,818082971200,54376500,-1
603,1,STEP,818084939400,818136447900,51508500,-1
604,1,STEP,818138105500,818190551200,52445700,-1
605,1,STEP,818192254000,818245426400,53172400,-1
606,1,STEP,818246996700,818301821900,54825200,-1
607,1,STEP,818303369300,818351930500,48561200,-1
608,1,STEP,818353420100,818406863200,53443100,-1
609,1,STEP,818408467800,818460916200,52448400,-1
610,1,STEP,818462533100,818514651600,52118500,-1
611,1,STEP,818516249900,818567398900,51149000,-1
612,1,STEP,818569121700,818618935100,49813400,-1
613,1,STEP,818620655800,818673547400,52891600,-1
614,1,STEP,818675162500,818725372400,50209900,-1
615,1,STEP,818726981500,818779257200,52275700,-1
616,1,STEP,818780904200,818833158600,52254400,-1
617,1,STEP,818834729300,818888607400,53878100,-1
618,1,STEP,818890551200,818944384800,53833600,-1
619,1,STEP,818946048000,818999494300,53446300,-1
620,1,STEP,819001110600,819059839900,58729300,-1
621,1,STEP,819061536600,819113748600,52212000,-1
622,1,STEP,819115506900,819167790800,52283900,-1
623,1,STEP,819169423100,819220703300,51280200,-1
624,1,STEP,819222443900,819274623700,52179800,-1
625,1,STEP,819276255400,819328213900,51958500,-1
626,1,STEP,819329837000,819383740000,53903000,-1
627,1,STEP,819385320900,819437681500,52360600,-1
628,1,STEP,819439487500,819492805200,53317700,-1
629,1,STEP,819494413900,819545625700,51211800,-1
630,1,STEP,819547326800,819601062100,53735300,-1
631,1,STEP,819602642700,819654585800,51943100,-1
632,1,STEP,819656338300,819708449700,52111400,-1
633,1,STEP,819710079900,819762586700,52506800,-1
634,1,STEP,819764255800,819817592500,53336700,-1
635,1,STEP,819819189400,819875569800,56380400,-1
636,1,STEP,819877852300,819934303100,56450800,-1
637,1,STEP,819936540100,819992477800,55937700,-1
638,1,STEP,819994045700,820048079100,54033400,-1
639,1,STEP,820049828200,820103959600,54131400,-1
640,1,STEP,820105770800,820160094300,54323500,-1
641,1,STEP,820161781700,820213805400,52023700,-1
642,1,STEP,820215498600,820268009800,52511200,-1
643,1,STEP,820269639100,820321613300,51974200,-1
644,1,STEP,820323300100,820374991200,51691100,-1
645,1,STEP,820376774000,820430024000,53250000,-1
646,1,STEP,820431701900,820485536700,53834800,-1
647,1,STEP,820487251400,820540931200,53679800,-1
648,1,STEP,820542519900,820597257400,54737500,-1
649,1,STEP,820598843900,820652256100,53412200,-1
650,1,STEP,820653823800,820704113900,50290100,-1
651,1,STEP,820705755200,820757086200,51331000,-1
652,1,STEP,820758900700,820811098900,52198200,-1
653,1,STEP,820812794900,820865780200,52985300,-1
654,1,STEP,820867351800,820920020800,52669000,-1
655,1,STEP,820921621300,820973982400,52361100,-1
656,1,STEP,820975827700,821030563700,54736000,-1
657,1,STEP,821032465800,821083480800,51015000,-1
658,1,STEP,821085129400,821138707600,53578200,-1
659,1,STEP,821141307200,821197301500,55994300,-1
660,1,STEP,821198805800,821251797300,52991500,-1
661,1,STEP,821253403900,821306561400,53157500,-1
662,1,STEP,821308488700,821361063700,52575000,-1
663,1,STEP,821362683500,821416680400,53996900,-1
664,1,STEP,821418476800,821470840000,52363200,-1
665,1,STEP,821472495600,821524837100,52341500,-1
666,1,STEP,821526471300,821581282300,54811000,-1
667,1,STEP,821582976600,821632571100,49594500,-1
668,1,STEP,821634045000,821684232400,50187400,-1
669,1,STEP,821685883100,821738526500,52643400,-1
670,1,STEP,821740163200,821793429600,53266400,-1
671,1,STEP,821794999000,821847703200,52704200,-1
672,1,STEP,821849321100,821900389100,51068000,-1
673,1,STEP,821902209700,821955700500,53490800,-1
674,1,STEP,821957257700,822009223500,51965800,-1
675,1,STEP,822011248500,822066526500,55278000,-1
676,1,STEP,822068129600,822122456900,54327300,-1
677,1,STEP,822124236200,822178372300,54136100,-1
678,1,STEP,822180427500,822239561400,59133900,-1
679,1,STEP,822241309800,822294603700,53293900,-1
680,1,STEP,822296205400,822347576200,51370800,-1
681,1,STEP,822349482600,822404495900,55013300,-1
682,1,STEP,822406335900,822463672800,57336900,-1
683,1,STEP,822465171700,822519057200,53885500,-1
684,1,STEP,822520704200,822572510100,51805900,-1
685,1,STEP,822574133700,822628387900,54254200,-1
686,1,STEP,822630142900,822698232000,68089100,-1
687,1,STEP,822702114400,822758036700,55922300,-1
688,1,STEP,822759631100,822847973200,88342100,-1
689,1,STEP,822849537100,822900143800,50606700,-1
690,1,STEP,822901842600,822953114300,51271700,-1
691,1,STEP,822954796900,823006173300,51376400,-1
692,1,STEP,823008161600,823060554300,52392700,-1
693,1,STEP,823062214000,823117935400,55721400,-1
694,1,STEP,823119797700,823175950900,56153200,-1
695,1,STEP,823177510900,823231489500,53978600,-1
696,1,STEP,823233344700,823288662000,55317300,-1
697,1,STEP,823290325600,823346050900,55725300,-1
698,1,STEP,823347587300,823400650500,53063200,-1
699,1,STEP,823402231600,823457713600,55482000,-1
700,1,STEP,823459456600,823513827100,54370500,-1
701,1,STEP,823515377800,823566718900,51341100,-1
702,1,STEP,823568508400,823621286100,52777700,-1
703,1,STEP,823622855000,823676407400,53552400,-1
704,1,STEP,823677989000,823733315300,55326300,-1
705,1,STEP,823734938800,823787767600,52828800,-1
706,1,STEP,823789446200,823841773400,52327200,-1
707,1,STEP,823843491400,823893340400,49849000,-1
708,1,STEP,823894969400,823948320700,53351300,-1
709,1,STEP,823949943300,824000853600,50910300,-1
710,1,STEP,824002760900,824055008800,52247900,-1
711,1,STEP,824056646000,824109122600,52476600,-1
712,1,STEP,824111183800,824166460400,55276600,-1
713,1,STEP,824168019800,824222240900,54221100,-1
714,1,STEP,824223842700,824275404600,51561900,-1
715,1,STEP,824277053300,824332323800,55270500,-1
716,1,STEP,824333849300,824384776300,50927000,-1
717,1,STEP,824386371000,824439833600,53462600,-1
718,1,STEP,824441395200,824495707700,54312500,-1
719,1,STEP,824498003900,824549917400,51913500,-1
720,1,STEP,824551522800,824605179900,53657100,-1
721,1,STEP,824606859900,824657661000,50801100,-1
722,1,STEP,824659302700,824711820700,52518000,-1
723,1,STEP,824713520700,824791381000,77860300,-1
724,1,STEP,824792924600,824846392400,53467800,-1
725,1,STEP,824847951500,824899173900,51222400,-1
726,1,STEP,824900925600,824954529500,53603900,-1
727,1,STEP,824956123000,825012007300,55884300,-1
728,1,STEP,825013550300,825064196000,50645700,-1
729,1,STEP,825065823600,825119760200,53936600,-1
730,1,STEP,825121402000,825176627700,55225700,-1
731,1,STEP,825178694400,825237558400,58864000,-1
732,1,STEP,825239258600,825292733000,53474400,-1
733,1,STEP,825294435500,825350473200,56037700,-1
734,1,STEP,825352125500,825405669300,53543800,-1
735,1,STEP,825407582800,825458333800,50751000,-1
736,1,STEP,825460076100,825512797200,52721100,-1
737,1,STEP,825514489000,825565537400,51048400,-1
738,1,STEP,825567316300,825618216800,50900500,-1
739,1,STEP,825619998300,825672077200,52078900,-1
740,1,STEP,825673690400,825726860900,53170500,-1
741,1,STEP,825728438100,825782658900,54220800,-1
742,1,STEP,825784242700,825838692900,54450200,-1
743,1,STEP,825840500300,825893316100,52815800,-1
744,1,STEP,825894893700,825946486300,51592600,-1
745,1,STEP,825948256100,826002346500,54090400,-1
746,1,STEP,826003904400,826055035600,51131200,-1
747,1,STEP,826056729100,826110089600,53360500,-1
748,1,STEP,826111603200,826165080900,53477700,-1
749,1,STEP,826166880200,826220918500,54038300,-1
750,1,STEP,826222469800,826277953500,55483700,-1
751,1,STEP,826279536500,826332804300,53267800,-1
752,1,STEP,826334390800,826384397600,50006800,-1
753,1,STEP,826386224500,826451534000,65309500,-1
754,1,STEP,826453921300,826507127700,53206400,-1
755,1,STEP,826508696200,826562798500,54102300,-1
756,1,STEP,826565395900,826620135200,54739300,-1
757,1,STEP,826621664000,826674803600,53139600,-1
758,1,STEP,826676466600,826728586400,52119800,-1
759,1,STEP,826730360400,826784562500,54202100,-1
760,1,STEP,826786123700,826839946800,53823100,-1
761,1,STEP,826841627900,826896710600,55082700,-1
762,1,STEP,826898240700,826949191100,50950400,-1
763,1,STEP,826951164300,827004910600,53746300,-1
764,1,STEP,827006432200,827059471600,53039400,-1
765,1,STEP,827061069100,827112105500,51036400,-1
766,1,STEP,827113834600,827167719600,53885000,-1
767,1,STEP,827169424700,827223717400,54292700,-1
768,1,STEP,827225441600,827276212200,50770600,-1
769,1,STEP,827277841400,827334009700,56168300,-1
770,1,STEP,827335594600,827387763600,52169000,-1
771,1,STEP,827389614100,827443646800,54032700,-1
772,1,STEP,827445265000,827499944300,54679300,-1
773,1,STEP,827501513100,827551687200,50174100,-1
774,1,STEP,827553329700,827605013200,51683500,-1
775,1,STEP,827606733500,827660054100,53320600,-1
776,1,STEP,827661685300,827713043200,51357900,-1
777,1,STEP,827714711500,827766234400,51522900,-1
778,1,STEP,827767969100,827820026700,52057600,-1
779,1,STEP,827821680900,827876748200,55067300,-1
780,1,STEP,827878315600,827930937800,52622200,-1
781,1,STEP,827932591100,827986010300,53419200,-1
782,1,STEP,827987651900,828040462600,52810700,-1
783,1,STEP,828042132200,828094038600,51906400,-1
784,1,STEP,828095691400,828150497600,54806200,-1
785,1,STEP,828152073200,828205703200,53630000,-1
786,1,STEP,828207275300,828261182100,53906800,-1
787,1,STEP,828262908600,828316433000,53524400,-1
788,1,STEP,828318047400,828372649200,54601800,-1
789,1,STEP,828374262300,828428390700,54128400,-1
790,1,STEP,828429962100,828485502600,55540500,-1
791,1,STEP,828487820900,828540656400,52835500,-1
792,1,STEP,828542258800,828593584500,51325700,-1
793,1,STEP,828595351300,828649725500,54374200,-1
794,1,STEP,828651316900,828703280200,51963300,-1
795,1,STEP,828704932500,828757471200,52538700,-1
796,1,STEP,828759165700,828812841900,53676200,-1
797,1,STEP,828814485300,828865849300,51364000,-1
798,1,STEP,828867730700,828921441600,53710900,-1
799,1,STEP,828923010900,828979981200,56970300,-1
800,1,STEP,828981671800,829034336100,52664300,-1
801,1,STEP,829035978800,829094675000,58696200,-1
802,1,STEP,829096400800,829151016400,54615600,-1
803,1,STEP,829152757000,829205116600,52359600,-1
804,1,STEP,829206779700,829262899600,56119900,-1
805,1,STEP,829264464600,829315165400,50700800,-1
806,1,STEP,829316746500,829369121800,52375300,-1
807,1,STEP,829370978800,829427687700,56708900,-1
808,1,STEP,829429648800,829484430100,54781300,-1
809,1,STEP,829486040100,829541259600,55219500,-1
810,1,STEP,829543254700,829595931300,52676600,-1
811,1,STEP,829597521100,829652595800,55074700,-1
812,1,STEP,829654177300,829705097700,50920400,-1
813,1,STEP,829708281000,829761317500,53036500,-1
814,1,STEP,829762883200,829813747500,50864300,-1
815,1,STEP,829815563500,829867372100,51808600,-1
816,1,STEP,829869142900,829922642300,53499400,-1
817,1,STEP,829924191200,829978943700,54752500,-1
818,1,STEP,829980749800,830033251200,52501400,-1
819,1,STEP,830034917300,830087929600,53012300,-1
820,1,STEP,830089733200,830143029000,53295800,-1
821,1,STEP,830144599700,830195476500,50876800,-1
822,1,STEP,830197468900,830251104700,53635800,-1
823,1,STEP,830252736700,830303971500,51234800,-1
824,1,STEP,830305730800,830359509200,53778400,-1
825,1,STEP,830361086000,830413108800,52022800,-1
826,1,STEP,830414797300,830470116400,55319100,-1
827,1,STEP,830471713000,830524457100,52744100,-1
828,1,STEP,830526039100,830580674700,54635600,-1
829,1,STEP,830582516900,830638418100,55901200,-1
830,1,STEP,830640075000,830690988000,50913000,-1
831,1,STEP,830692740400,830744471500,51731100,-1
832,1,STEP,830746183300,830798927200,52743900,-1
833,1,STEP,830800598900,830853527500,52928600,-1
834,1,STEP,830855099500,830909292600,54193100,-1
835,1,STEP,830910926300,830964201800,53275500,-1
836,1,STEP,830965813400,831016643100,50829700,-1
837,1,STEP,831018296200,831071600200,53304000,-1
838,1,STEP,831073196800,831127649700,54452900,-1
839,1,STEP,831129190200,831180130200,50940000,-1
840,1,STEP,831181804200,831235823900,54019700,-1
841,1,STEP,831237464600,831289033700,51569100,-1
842,1,STEP,831290696800,831345978900,55282100,-1
843,1,STEP,831347655600,831400651600,52996000,-1
844,1,STEP,831404546800,831466806000,62259200,-1
845,1,STEP,831468590500,831523839700,55249200,-1
846,1,STEP,831525473600,831579176100,53702500,-1
847,1,STEP,831580831700,831636300100,55468400,-1
848,1,STEP,831638126000,831694630700,56504700,-1
849,1,STEP,831696140300,831747524800,51384500,-1
850,1,STEP,831749337100,831804480200,55143100,-1
851,1,STEP,831805923200,831856006100,50082900,-1
852,1,STEP,831857665200,831914171700,56506500,-1
853,1,STEP,831915667600,831968489500,52821900,-1
854,1,STEP,831970127100,832026079300,55952200,-1
855,1,STEP,832027609800,832080673000,53063200,-1
856,1,STEP,832082399300,832136286900,53887600,-1
857,1,STEP,832137880800,832190121500,52240700,-1
858,1,STEP,832191809800,832243473700,51663900,-1
859,1,STEP,832245155400,832297389100,52233700,-1
860,1,STEP,832299315100,832354664800,55349700,-1
861,1,STEP,832356159300,832408433600,52274300,-1
862,1,STEP,832410226300,832466695300,56469000,-1
863,1,STEP,832468709600,832526738700,58029100,-1
864,1,STEP,832528510300,832582355700,53845400,-1
865,1,STEP,832584136800,832636641100,52504300,-1
866,1,STEP,832638532200,832692985300,54453100,-1
867,1,STEP,832694877100,832751511100,56634000,-1
868,1,STEP,832753171800,832806287000,53115200,-1
869,1,STEP,832807948600,832862230900,54282300,-1
870,1,STEP,832864189700,832917301000,53111300,-1
871,1,STEP,832918890100,832971327300,52437200,-1
872,1,STEP,832972968000,833027808700,54840700,-1
873,1,STEP,833029338600,833083410600,54072000,-1
874,1,STEP,833085168100,833137198800,52030700,-1
875,1,STEP,833138828400,833193232900,54404500,-1
876,1,STEP,833194734400,833248472800,53738400,-1
877,1,STEP,833250017400,833304455000,54437600,-1
878,1,STEP,833306077800,833358812800,52735000,-1
879,1,STEP,833360455600,833413456500,53000900,-1
880,1,STEP,833415075000,833466830600,51755600,-1
881,1,STEP,833468525100,833523595700,55070600,-1
882,1,STEP,833525154500,833577743300,52588800,-1
883,1,STEP,833579384200,833633902800,54518600,-1
884,1,STEP,833635578900,833687088200,51509300,-1
885,1,STEP,833688936200,833748589700,59653500,-1
886,1,STEP,833750396200,833804495100,54098900,-1
887,1,STEP,833806087800,833857933900,51846100,-1
888,1,STEP,833859632200,833913420400,53788200,-1
889,1,STEP,833915040400,833967252300,52211900,-1
890,1,STEP,833968882000,834022218900,53336900,-1
891,1,STEP,834023788200,834076300100,52511900,-1
892,1,STEP,834077931900,834131708200,53776300,-1
893,1,STEP,834133401300,834186310300,52909000,-1
894,1,STEP,834187911700,834239479600,51567900,-1
895,1,STEP,834241196000,834294720600,53524600,-1
896,1,STEP,834296313700,834351660700,55347000,-1
897,1,STEP,834353466600,834405789100,52322500,-1
898,1,STEP,834407689300,834461033000,53343700,-1
899,1,STEP,834462669400,834515628600,52959200,-1
900,1,STEP,834517236900,834569206900,51970000,-1
901,1,STEP,834570880900,834621944400,51063500,-1
902,1,STEP,834623628300,834679880500,56252200,-1
903,1,STEP,834681399600,834734079700,52680100,-1
904,1,STEP,834735663600,834784756700,49093100,-1
905,1,STEP,834786477900,834842679100,56201200,-1
906,1,STEP,834844166300,834897960800,53794500,-1
907,1,STEP,834899538900,834953633500,54094600,-1
908,1,STEP,834955434800,835008976000,53541200,-1
909,1,STEP,835010659800,835062196600,51536800,-1
910,1,STEP,835063718800,835115713700,51994900,-1
911,1,STEP,835117334800,835170211900,52877100,-1
912,1,STEP,835171811400,835223740600,51929200,-1
913,1,STEP,835225376500,835277597000,52220500,-1
914,1,STEP,835279220500,835332982600,53762100,-1
915,1,STEP,835334649600,835390280200,55630600,-1
916,1,STEP,835391816300,835443992200,52175900,-1
917,1,STEP,835445589600,835498911000,53321400,-1
918,1,STEP,835500492300,835553964600,53472300,-1
919,1,STEP,835555631300,835608178600,52547300,-1
920,1,STEP,835609793600,835662344700,52551100,-1
921,1,STEP,835664007600,835721651900,57644300,-1
922,1,STEP,835723602400,835776439600,52837200,-1
923,1,STEP,835778032500,835833145400,55112900,-1
924,1,STEP,835835356600,835894858500,59501900,-1
925,1,STEP,835896510400,835947539500,51029100,-1
926,1,STEP,835949201500,836003935400,54733900,-1
927,1,STEP,836005646900,836059729100,54082200,-1
928,1,STEP,836061307600,836113100700,51793100,-1
929,1,STEP,836114782500,836167707600,52925100,-1
930,1,STEP,836169315400,836223516500,54201100,-1
931,1,STEP,836225072300,836278226100,53153800,-1
932,1,STEP,836280083400,836332319300,52235900,-1
933,1,STEP,836333969600,836390088400,56118800,-1
934,1,STEP,836391917100,836446595500,54678400,-1
935,1,STEP,836448242200,836508855200,60613000,-1
936,1,STEP,836510905100,836562824500,51919400,-1
937,1,STEP,836564877800,836617687300,52809500,-1
938,1,STEP,836619271000,836671983400,52712400,-1
939,1,STEP,836673735900,836728514000,54778100,-1
940,1,STEP,836730389400,836783552700,53163300,-1
941,1,STEP,836785160300,836837646200,52485900,-1
942,1,STEP,836839250800,836894279900,55029100,-1
943,1,STEP,836896456000,836951183900,54727900,-1
944,1,STEP,836952832700,837008229000,55396300,-1
945,1,STEP,837009825600,837063241500,53415900,-1
946,1,STEP,837064844100,837114644000,49799900,-1
947,1,STEP,837116269400,837170913100,54643700,-1
948,1,STEP,837172420400,837229474600,57054200,-1
949,1,STEP,837233983200,837303164100,69180900,-1
950,1,STEP,837304722700,837358933900,54211200,-1
951,1,STEP,837361026400,837415359400,54333000,-1
952,1,STEP,837416852300,837468522700,51670400,-1
953,1,STEP,837470302100,837523173300,52871200,-1
954,1,STEP,837524751000,837575158600,50407600,-1
955,1,STEP,837576725300,837629346500,52621200,-1
956,1,STEP,837630963300,837683982700,53019400,-1
957,1,STEP,837685563200,837739557700,53994500,-1
958,1,STEP,837741205700,837794712700,53507000,-1
959,1,STEP,837796377700,837849197500,52819800,-1
960,1,STEP,837850839900,837902868000,52028100,-1
961,1,STEP,837904496800,837960127400,55630600,-1
962,1,STEP,837961805100,838036194100,74389000,-1
963,1,STEP,838040161300,838110548100,70386800,-1
964,1,STEP,838112123000,838161787200,49664200,-1
965,1,STEP,838163294000,838217052400,53758400,-1
966,1,STEP,838218620100,838272346500,53726400,-1
967,1,STEP,838273932400,838325113500,51181100,-1
968,1,STEP,838326841900,838380821600,53979700,-1
969,1,STEP,838382503200,838437116200,54613000,-1
970,1,STEP,838438635100,838491732300,53097200,-1
971,1,STEP,838493422000,838548424300,55002300,-1
972,1,STEP,838549931300,838601188100,51256800,-1
973,1,STEP,838602898800,838656844800,53946000,-1
974,1,STEP,838658401300,838712662500,54261200,-1
975,1,STEP,838714181100,838765759200,51578100,-1
976,1,STEP,838767487200,838821871200,54384000,-1
977,1,STEP,838823733300,838879410800,55677500,-1
978,1,STEP,838881137700,838932546400,51408700,-1
979,1,STEP,838934238300,838989598500,55360200,-1
980,1,STEP,838991430500,839046961100,55530600,-1
981,1,STEP,839048424900,839100786000,52361100,-1
982,1,STEP,839102432800,839155729800,53297000,-1
983,1,STEP,839157295300,839210868000,53572700,-1
984,1,STEP,839212423000,839263503600,51080600,-1
985,1,STEP,839265312600,839317885200,52572600,-1
986,1,STEP,839319537900,839374652800,55114900,-1
987,1,STEP,839376198900,839432585300,56386400,-1
988,1,STEP,839434198000,839487742700,53544700,-1
989,1,STEP,839489441400,839562108000,72666600,-1
990,1,STEP,839563623700,839619023600,55399900,-1
991,1,STEP,839621390700,839674500400,53109700,-1
992,1,STEP,839676437700,839729970500,53532800,-1
993,1,STEP,839731630900,839783075300,51444400,-1
994,1,STEP,839784803300,839836456000,51652700,-1
995,1,STEP,839838313700,839895270000,56956300,-1
996,1,STEP,839896792100,839949577200,52785100,-1
997,1,STEP,839951157500,840002256000,51098500,-1
998,1,STEP,840003921400,840059074300,55152900,-1
999,1,STEP,840060686600,840116091800,55405200,-1
