Gen,Resource,Stamp,TimeStamp_Start,TimeStamp_End,Duration,Indiv_id
0,1,TransfertToDevice,556876539800,557307580500,431040700,-1
0,1,STEP,557449570300,557472313000,22742700,-1
1,1,STEP,557472381200,557494665500,22284300,-1
2,1,STEP,557494740500,557516086100,21345600,-1
3,1,STEP,557516145600,557534698000,18552400,-1
4,1,STEP,557534757100,557553715700,18958600,-1
5,1,STEP,557553773900,557572560600,18786700,-1
6,1,STEP,557572626100,557591060600,18434500,-1
7,1,STEP,557591163800,557609662100,18498300,-1
8,1,STEP,557609717100,557628277800,18560700,-1
9,1,STEP,557628327900,557646894900,18567000,-1
10,1,STEP,557646951300,557665835100,18883800,-1
11,1,STEP,557665884200,557684600400,18716200,-1
12,1,STEP,557684637300,557703435900,18798600,-1
13,1,STEP,557703491000,557722376500,18885500,-1
14,1,STEP,557722439700,557741324700,18885000,-1
15,1,STEP,557741370900,557760053900,18683000,-1
16,1,STEP,557760104800,557778963600,18858800,-1
17,1,STEP,557779021700,557797721200,18699500,-1
18,1,STEP,557797771000,557816613400,18842400,-1
19,1,STEP,557816659600,557835722700,19063100,-1
20,1,STEP,557835768700,557854609500,18840800,-1
21,1,STEP,557854699800,557873464100,18764300,-1
22,1,STEP,557873505000,557892333100,18828100,-1
23,1,STEP,557892375400,557911172500,18797100,-1
24,1,STEP,557911247300,557929871000,18623700,-1
25,1,STEP,557929924100,557948566800,18642700,-1
26,1,STEP,557948613200,557967562200,18949000,-1
27,1,STEP,557967611900,557986585700,18973800,-1
28,1,STEP,557986644300,558005283700,18639400,-1
29,1,STEP,558005332900,558024379500,19046600,-1
30,1,STEP,558024426200,558043267300,18841100,-1
31,1,STEP,558043325400,558061945100,18619700,-1
32,1,STEP,558061994400,558080955400,18961000,-1
33,1,STEP,558081002000,558100029100,19027100,-1
34,1,STEP,558100082500,558118542900,18460400,-1
35,1,STEP,558118627700,558137446100,18818400,-1
36,1,STEP,558137490100,558156663300,19173200,-1
37,1,STEP,558156715500,558175660200,18944700,-1
38,1,STEP,558175708300,558194493500,18785200,-1
39,1,STEP,558194551500,558213151800,18600300,-1
40,1,STEP,558213209700,558232408000,19198300,-1
41,1,STEP,558232457000,558251750900,19293900,-1
42,1,STEP,558251801200,558270850700,19049500,-1
43,1,STEP,558270929300,558289979300,19050000,-1
44,1,STEP,558290025100,558309025900,19000800,-1
45,1,STEP,558309075100,558327825900,18750800,-1
46,1,STEP,558327884600,558346455400,18570800,-1
47,1,STEP,558346503700,558364978500,18474800,-1
48,1,STEP,558365035900,558384406300,19370400,-1
49,1,STEP,558384537300,558403428100,18890800,-1
50,1,STEP,558403504000,558422355900,18851900,-1
51,1,STEP,558422417100,558441222900,18805800,-1
52,1,STEP,558441273000,558459990000,18717000,-1
53,1,STEP,558460049400,558478816100,18766700,-1
54,1,STEP,558478875300,558497676800,18801500,-1
55,1,STEP,558497735500,558516484700,18749200,-1
56,1,STEP,558516549700,558535205500,18655800,-1
57,1,STEP,558535267000,558553855900,18588900,-1
58,1,STEP,558553912900,558572894200,18981300,-1
59,1,STEP,558572943600,558591783300,18839700,-1
60,1,STEP,558591862100,558610906800,19044700,-1
61,1,STEP,558610957000,558629331600,18374600,-1
62,1,STEP,558629378200,558648393800,19015600,-1
63,1,STEP,558648439400,558667421800,18982400,-1
64,1,STEP,558667486800,558686923600,19436800,-1
65,1,STEP,558686964900,558705857000,18892100,-1
66,1,STEP,558705902700,558725198300,19295600,-1
67,1,STEP,558725246900,558744282700,19035800,-1
68,1,STEP,558744343200,558762927900,18584700,-1
69,1,STEP,558762977600,558782567100,19589500,-1
70,1,STEP,558782612500,558802184900,19572400,-1
71,1,STEP,558802233400,558821729600,19496200,-1
72,1,STEP,558821778900,558841161900,19383000,-1
73,1,STEP,558841210500,558860809400,19598900,-1
74,1,STEP,558860882400,558880067800,19185400,-1
75,1,STEP,558880113000,558899175000,19062000,-1
76,1,STEP,558899221500,558918583100,19361600,-1
77,1,STEP,558918633500,558937753300,19119800,-1
78,1,STEP,558937807700,558957599700,19792000,-1
79,1,STEP,558957644800,558977331700,19686900,-1
80,1,STEP,558977377200,558997337700,19960500,-1
81,1,STEP,558997377100,559017291600,19914500,-1
82,1,STEP,559017336800,559037268900,19932100,-1
83,1,STEP,559037319600,559056942200,19622600,-1
84,1,STEP,559056988700,559076761400,19772700,-1
85,1,STEP,559076806800,559096844000,20037200,-1
86,1,STEP,559096889800,559116746300,19856500,-1
87,1,STEP,559116789800,559136911800,20122000,-1
88,1,STEP,559136961200,559157451000,20489800,-1
89,1,STEP,559157504500,559177443300,19938800,-1
90,1,STEP,559177504100,559197526400,20022300,-1
91,1,STEP,559197579500,559217827000,20247500,-1
92,1,STEP,559217874200,559238307800,20433600,-1
93,1,STEP,559238352300,559259129200,20776900,-1
94,1,STEP,559259175500,559279954900,20779400,-1
95,1,STEP,559280002900,559300750100,20747200,-1
96,1,STEP,559300799100,559321574700,20775600,-1
97,1,STEP,559321626800,559342857500,21230700,-1
98,1,STEP,559342904300,559363521000,20616700,-1
99,1,STEP,559363561300,559384429500,20868200,-1
100,1,STEP,559384472600,559404947700,20475100,-1
101,1,STEP,559404999500,559426934000,21934500,-1
102,1,STEP,559426988800,559448230400,21241600,-1
103,1,STEP,559448298600,559469574100,21275500,-1
104,1,STEP,559469636400,559491205300,21568900,-1
105,1,STEP,559491252000,559511791300,20539300,-1
106,1,STEP,559511839800,559533082300,21242500,-1
107,1,STEP,559533133200,559554268400,21135200,-1
108,1,STEP,559554317400,559575528500,21211100,-1
109,1,STEP,559575571500,559596047800,20476300,-1
110,1,STEP,559596091300,559616436000,20344700,-1
111,1,STEP,559616482500,559637679800,21197300,-1
112,1,STEP,559637727800,559658957300,21229500,-1
113,1,STEP,559659011900,559680687000,21675100,-1
114,1,STEP,559680739000,559701392900,20653900,-1
115,1,STEP,559701430000,559722397900,20967900,-1
116,1,STEP,559722443900,559743216500,20772600,-1
117,1,STEP,559743265100,559763564300,20299200,-1
118,1,STEP,559763638500,559784273500,20635000,-1
119,1,STEP,559784328900,559804943600,20614700,-1
120,1,STEP,559804993200,559826118900,21125700,-1
121,1,STEP,559826168400,559847254300,21085900,-1
122,1,STEP,559847323300,559868519400,21196100,-1
123,1,STEP,559868645700,559889540400,20894700,-1
124,1,STEP,559889594300,559910158000,20563700,-1
125,1,STEP,559910204900,559931309200,21104300,-1
126,1,STEP,559931363200,559951710100,20346900,-1
127,1,STEP,559951763600,559972479200,20715600,-1
128,1,STEP,559972538600,559993580200,21041600,-1
129,1,STEP,559993625300,560014755900,21130600,-1
130,1,STEP,560014809800,560035086100,20276300,-1
131,1,STEP,560035135200,560055715200,20580000,-1
132,1,STEP,560055771800,560077215100,21443300,-1
133,1,STEP,560077269500,560097851400,20581900,-1
134,1,STEP,560097895300,560118979900,21084600,-1
135,1,STEP,560119041400,560140516100,21474700,-1
136,1,STEP,560140682700,560161767200,21084500,-1
137,1,STEP,560161826500,560182677400,20850900,-1
138,1,STEP,560182747800,560204059600,21311800,-1
139,1,STEP,560204176200,560224606600,20430400,-1
140,1,STEP,560224689700,560245997200,21307500,-1
141,1,STEP,560246065600,560267052100,20986500,-1
142,1,STEP,560267120900,560288650900,21530000,-1
143,1,STEP,560288700200,560309530500,20830300,-1
144,1,STEP,560309582200,560330750400,21168200,-1
145,1,STEP,560330793400,560352333300,21539900,-1
146,1,STEP,560352383100,560373004500,20621400,-1
147,1,STEP,560373060400,560394256600,21196200,-1
148,1,STEP,560394306700,560415950900,21644200,-1
149,1,STEP,560416008000,560437546100,21538100,-1
150,1,STEP,560437603500,560459099200,21495700,-1
151,1,STEP,560459164300,560480682300,21518000,-1
152,1,STEP,560481060100,560502121600,21061500,-1
153,1,STEP,560502176500,560523522100,21345600,-1
154,1,STEP,560523601600,560545069300,21467700,-1
155,1,STEP,560545123600,560566798800,21675200,-1
156,1,STEP,560566848100,560587971200,21123100,-1
157,1,STEP,560588028800,560609443000,21414200,-1
158,1,STEP,560609489100,560630607000,21117900,-1
159,1,STEP,560630656100,560652163000,21506900,-1
160,1,STEP,560652230000,560673165300,20935300,-1
161,1,STEP,560673217800,560694464400,21246600,-1
162,1,STEP,560694517000,560716634100,22117100,-1
163,1,STEP,560716708300,560737905400,21197100,-1
164,1,STEP,560737961300,560758888700,20927400,-1
165,1,STEP,560758954900,560780025400,21070500,-1
166,1,STEP,560780075500,560801756900,21681400,-1
167,1,STEP,560801827800,560822951600,21123800,-1
168,1,STEP,560823008100,560844561800,21553700,-1
169,1,STEP,560844608500,560865823400,21214900,-1
170,1,STEP,560865885800,560887181700,21295900,-1
171,1,STEP,560887225100,560908551900,21326800,-1
172,1,STEP,560908598800,560929843600,21244800,-1
173,1,STEP,560929896900,560951942000,22045100,-1
174,1,STEP,560952080300,560973815700,21735400,-1
175,1,STEP,560973928400,560996688900,22760500,-1
176,1,STEP,560996790900,561018400200,21609300,-1
177,1,STEP,561018445500,561039196500,20751000,-1
178,1,STEP,561039238300,561060090500,20852200,-1
179,1,STEP,561060137800,561080903500,20765700,-1
180,1,STEP,561080952900,561102190500,21237600,-1
181,1,STEP,561102238100,561123377800,21139700,-1
182,1,STEP,561123431500,561145035200,21603700,-1
183,1,STEP,561145102800,561166304100,21201300,-1
184,1,STEP,561166372600,561186789400,20416800,-1
185,1,STEP,561186855800,561207498600,20642800,-1
186,1,STEP,561207551800,561228716400,21164600,-1
187,1,STEP,561228782300,561249959000,21176700,-1
188,1,STEP,561250020200,561271593500,21573300,-1
189,1,STEP,561271680900,561292387200,20706300,-1
190,1,STEP,561292481100,561313513300,21032200,-1
191,1,STEP,561313613300,561334253000,20639700,-1
192,1,STEP,561334338300,561355787600,21449300,-1
193,1,STEP,561355846300,561376455200,20608900,-1
194,1,STEP,561376505500,561397161100,20655600,-1
195,1,STEP,561397222400,561417734000,20511600,-1
196,1,STEP,561417783100,561438840800,21057700,-1
197,1,STEP,561438895200,561459443200,20548000,-1
198,1,STEP,561459506800,561480739800,21233000,-1
199,1,STEP,561480797600,561501393000,20595400,-1
200,1,STEP,561501459400,561522427700,20968300,-1
201,1,STEP,561522531800,561543831600,21299800,-1
202,1,STEP,561543922700,561564738100,20815400,-1
203,1,STEP,561564792500,561586140500,21348000,-1
204,1,STEP,561586190500,561607132900,20942400,-1
205,1,STEP,561607184000,561627692200,20508200,-1
206,1,STEP,561627741700,561648771600,21029900,-1
207,1,STEP,561648822000,561669495700,20673700,-1
208,1,STEP,561669545400,561690838400,21293000,-1
209,1,STEP,561690885000,561711998600,21113600,-1
210,1,STEP,561712050300,561733172700,21122400,-1
211,1,STEP,561733221900,561754296900,21075000,-1
212,1,STEP,561754345800,561775714400,21368600,-1
213,1,STEP,561775760500,561797208300,21447800,-1
214,1,STEP,561797258700,561817661100,20402400,-1
215,1,STEP,561817705400,561838669300,20963900,-1
216,1,STEP,561838714800,561859942000,21227200,-1
217,1,STEP,561859986900,561881021700,21034800,-1
218,1,STEP,561881070600,561902250100,21179500,-1
219,1,STEP,561902300200,561922967500,20667300,-1
220,1,STEP,561923014100,561944106300,21092200,-1
221,1,STEP,561944153100,561964546900,20393800,-1
222,1,STEP,561964592300,561984968600,20376300,-1
223,1,STEP,561985014500,562005800900,20786400,-1
224,1,STEP,562005849200,562027578500,21729300,-1
225,1,STEP,562027629700,562048813400,21183700,-1
226,1,STEP,562048861800,562069670000,20808200,-1
227,1,STEP,562069710600,562091128300,21417700,-1
228,1,STEP,562091170800,562112073000,20902200,-1
229,1,STEP,562112118800,562133133000,21014200,-1
230,1,STEP,562133181200,562153608600,20427400,-1
231,1,STEP,562153656800,562174004300,20347500,-1
232,1,STEP,562174051100,562195491300,21440200,-1
233,1,STEP,562195533800,562216399700,20865900,-1
234,1,STEP,562216443200,562237287100,20843900,-1
235,1,STEP,562237332400,562258341000,21008600,-1
236,1,STEP,562258379400,562279741600,21362200,-1
237,1,STEP,562279781000,562300736400,20955400,-1
238,1,STEP,562300785800,562321626400,20840600,-1
239,1,STEP,562321677300,562341960300,20283000,-1
240,1,STEP,562342003800,562362794400,20790600,-1
241,1,STEP,562362837100,562383221600,20384500,-1
242,1,STEP,562383259600,562404464000,21204400,-1
243,1,STEP,562404532900,562424759000,20226100,-1
244,1,STEP,562424814300,562445380000,20565700,-1
245,1,STEP,562445422400,562466281900,20859500,-1
246,1,STEP,562466322700,562486671900,20349200,-1
247,1,STEP,562486724700,562507095000,20370300,-1
248,1,STEP,562507150600,562527130100,19979500,-1
249,1,STEP,562527184900,562547875300,20690400,-1
250,1,STEP,562547929400,562569317500,21388100,-1
251,1,STEP,562569381900,562590405600,21023700,-1
252,1,STEP,562590456500,562611450200,20993700,-1
253,1,STEP,562611508500,562632271100,20762600,-1
254,1,STEP,562632324000,562653448700,21124700,-1
255,1,STEP,562653498900,562674747900,21249000,-1
256,1,STEP,562674787600,562695712100,20924500,-1
257,1,STEP,562695755900,562716104300,20348400,-1
258,1,STEP,562716150100,562737629700,21479600,-1
259,1,STEP,562737668600,562759239100,21570500,-1
260,1,STEP,562759280100,562779907500,20627400,-1
261,1,STEP,562779945200,562800839800,20894600,-1
262,1,STEP,562800877500,562821954800,21077300,-1
263,1,STEP,562822006000,562842892600,20886600,-1
264,1,STEP,562842939200,562863386200,20447000,-1
265,1,STEP,562863428700,562884832100,21403400,-1
266,1,STEP,562884877000,562905899800,21022800,-1
267,1,STEP,562905941900,562926972300,21030400,-1
268,1,STEP,562927021200,562948061100,21039900,-1
269,1,STEP,562948103300,562969116000,21012700,-1
270,1,STEP,562969159600,562990606200,21446600,-1
271,1,STEP,562990651600,563011729600,21078000,-1
272,1,STEP,563011772700,563033211100,21438400,-1
273,1,STEP,563033258000,563054064500,20806500,-1
274,1,STEP,563054103300,563074698300,20595000,-1
275,1,STEP,563074742900,563095143000,20400100,-1
276,1,STEP,563095189700,563116133000,20943300,-1
277,1,STEP,563116178400,563136600900,20422500,-1
278,1,STEP,563136653100,563157937800,21284700,-1
279,1,STEP,563157983500,563179458900,21475400,-1
280,1,STEP,563179499000,563200493400,20994400,-1
281,1,STEP,563200533400,563220677900,20144500,-1
282,1,STEP,563220724800,563241099700,20374900,-1
283,1,STEP,563241149100,563262141300,20992200,-1
284,1,STEP,563262186300,563282694600,20508300,-1
285,1,STEP,563282753100,563303282100,20529000,-1
286,1,STEP,563303331700,563324046000,20714300,-1
287,1,STEP,563324097500,563344892100,20794600,-1
288,1,STEP,563344944700,563365831900,20887200,-1
289,1,STEP,563365869200,563388148200,22279000,-1
290,1,STEP,563388193500,563409882000,21688500,-1
291,1,STEP,563409962900,563430750600,20787700,-1
292,1,STEP,563430798000,563451266200,20468200,-1
293,1,STEP,563451312200,563473349200,22037000,-1
294,1,STEP,563473391000,563495102100,21711100,-1
295,1,STEP,563495150400,563516268200,21117800,-1
296,1,STEP,563516308500,563537335500,21027000,-1
297,1,STEP,563537386700,563559053500,21666800,-1
298,1,STEP,563559093700,563579619600,20525900,-1
299,1,STEP,563579661700,563600990100,21328400,-1
300,1,STEP,563601030500,563622092000,21061500,-1
301,1,STEP,563622154300,563643012500,20858200,-1
302,1,STEP,563643066000,563665178700,22112700,-1
303,1,STEP,563665237800,563687432900,22195100,-1
304,1,STEP,563687473500,563710922400,23448900,-1
305,1,STEP,563710968900,563734003800,23034900,-1
306,1,STEP,563734045200,563758339200,24294000,-1
307,1,STEP,563758381800,563781968100,23586300,-1
308,1,STEP,563782005900,563805606900,23601000,-1
309,1,STEP,563805652600,563829174400,23521800,-1
310,1,STEP,563829215600,563853068100,23852500,-1
311,1,STEP,563853124300,563876643300,23519000,-1
312,1,STEP,563876694800,563899750900,23056100,-1
313,1,STEP,563899793800,563924210500,24416700,-1
314,1,STEP,563924253100,563948037500,23784400,-1
315,1,STEP,563948083200,563971764300,23681100,-1
316,1,STEP,563971809700,563995517000,23707300,-1
317,1,STEP,563995561500,564019350400,23788900,-1
318,1,STEP,564019389700,564043290100,23900400,-1
319,1,STEP,564043327100,564066679700,23352600,-1
320,1,STEP,564066727000,564090960500,24233500,-1
321,1,STEP,564091003500,564115072500,24069000,-1
322,1,STEP,564115126800,564140008900,24882100,-1
323,1,STEP,564140066700,564165103200,25036500,-1
324,1,STEP,564165156800,564189625800,24469000,-1
325,1,STEP,564189667100,564214766400,25099300,-1
326,1,STEP,564214844900,564240182400,25337500,-1
327,1,STEP,564240225800,564265482200,25256400,-1
328,1,STEP,564265532800,564290977900,25445100,-1
329,1,STEP,564291024700,564315996300,24971600,-1
330,1,STEP,564316043400,564340893900,24850500,-1
331,1,STEP,564340930900,564365861300,24930400,-1
332,1,STEP,564365908200,564390351700,24443500,-1
333,1,STEP,564390395800,564416356600,25960800,-1
334,1,STEP,564416397100,564441436400,25039300,-1
335,1,STEP,564441481800,564466462300,24980500,-1
336,1,STEP,564466502100,564492397400,25895300,-1
337,1,STEP,564492446500,564517365500,24919000,-1
338,1,STEP,564517412200,564542332000,24919800,-1
339,1,STEP,564542387500,564566963500,24576000,-1
340,1,STEP,564567018600,564591938500,24919900,-1
341,1,STEP,564591982300,564617328300,25346000,-1
342,1,STEP,564617411400,564642154000,24742600,-1
343,1,STEP,564642196700,564667559200,25362500,-1
344,1,STEP,564667625600,564693172400,25546800,-1
345,1,STEP,564693215600,564719084100,25868500,-1
346,1,STEP,564719128400,564744122500,24994100,-1
347,1,STEP,564744173400,564769093000,24919600,-1
348,1,STEP,564769130700,564794665100,25534400,-1
349,1,STEP,564794709800,564820616200,25906400,-1
350,1,STEP,564820654000,564846073600,25419600,-1
351,1,STEP,564846115400,564871092400,24977000,-1
352,1,STEP,564871138300,564897005300,25867000,-1
353,1,STEP,564897052300,564922571200,25518900,-1
354,1,STEP,564922608500,564947274900,24666400,-1
355,1,STEP,564947318200,564973012300,25694100,-1
356,1,STEP,564973061400,564997989900,24928500,-1
357,1,STEP,564998047200,565022602200,24555000,-1
358,1,STEP,565022641700,565047710300,25068600,-1
359,1,STEP,565047748800,565073733500,25984700,-1
360,1,STEP,565073775600,565099213800,25438200,-1
361,1,STEP,565099258100,565123846400,24588300,-1
362,1,STEP,565123909100,565148967200,25058100,-1
363,1,STEP,565149015100,565174258400,25243300,-1
364,1,STEP,565174299900,565199007100,24707200,-1
365,1,STEP,565199060800,565224124900,25064100,-1
366,1,STEP,565224171800,565249025700,24853900,-1
367,1,STEP,565249065100,565274307500,25242400,-1
368,1,STEP,565274353800,565299319900,24966100,-1
369,1,STEP,565299377400,565324913100,25535700,-1
370,1,STEP,565324956900,565349852200,24895300,-1
371,1,STEP,565349892600,565374401100,24508500,-1
372,1,STEP,565374440000,565400261900,25821900,-1
373,1,STEP,565400308300,565425983800,25675500,-1
374,1,STEP,565426026400,565450901200,24874800,-1
375,1,STEP,565450938800,565475639300,24700500,-1
376,1,STEP,565475697200,565500705300,25008100,-1
377,1,STEP,565500754000,565525682500,24928500,-1
378,1,STEP,565525725900,565551454200,25728300,-1
379,1,STEP,565551497800,565576113400,24615600,-1
380,1,STEP,565576156000,565601651000,25495000,-1
381,1,STEP,565601697800,565627138800,25441000,-1
382,1,STEP,565627254000,565654127600,26873600,-1
383,1,STEP,565654198500,565679951700,25753200,-1
384,1,STEP,565680038400,565704733400,24695000,-1
385,1,STEP,565704790200,565729651500,24861300,-1
386,1,STEP,565729706100,565754927800,25221700,-1
387,1,STEP,565754981600,565779613300,24631700,-1
388,1,STEP,565779660400,565804630100,24969700,-1
389,1,STEP,565804671400,565829670700,24999300,-1
390,1,STEP,565829716700,565854598800,24882100,-1
391,1,STEP,565854647100,565879935700,25288600,-1
392,1,STEP,565880060100,565905708900,25648800,-1
393,1,STEP,565905757400,565930580500,24823100,-1
394,1,STEP,565930631800,565955693000,25061200,-1
395,1,STEP,565955742700,565981147800,25405100,-1
396,1,STEP,565981192200,566005950700,24758500,-1
397,1,STEP,566006000000,566031321200,25321200,-1
398,1,STEP,566031371800,566056906300,25534500,-1
399,1,STEP,566056962300,566082363800,25401500,-1
400,1,STEP,566082411000,566108174900,25763900,-1
401,1,STEP,566108230500,566133151300,24920800,-1
402,1,STEP,566133201400,566158374800,25173400,-1
403,1,STEP,566158448400,566184912100,26463700,-1
404,1,STEP,566184965500,566210051000,25085500,-1
405,1,STEP,566210098600,566235608000,25509400,-1
406,1,STEP,566235673200,566260795000,25121800,-1
407,1,STEP,566260842300,566285997000,25154700,-1
408,1,STEP,566286048500,566310589600,24541100,-1
409,1,STEP,566310632800,566335259500,24626700,-1
410,1,STEP,566335307700,566360943800,25636100,-1
411,1,STEP,566361012300,566386324600,25312300,-1
412,1,STEP,566386373300,566412046700,25673400,-1
413,1,STEP,566412093800,566436851000,24757200,-1
414,1,STEP,566436901000,566462490900,25589900,-1
415,1,STEP,566462536200,566487222600,24686400,-1
416,1,STEP,566487294700,566513238300,25943600,-1
417,1,STEP,566513283200,566538364900,25081700,-1
418,1,STEP,566538422200,566563795000,25372800,-1
419,1,STEP,566563847500,566589180900,25333400,-1
420,1,STEP,566589227200,566615049600,25822400,-1
421,1,STEP,566615097800,566640134400,25036600,-1
422,1,STEP,566640179600,566666539700,26360100,-1
423,1,STEP,566666602700,566692276300,25673600,-1
424,1,STEP,566692317100,566717777700,25460600,-1
425,1,STEP,566717821500,566743367400,25545900,-1
426,1,STEP,566743518900,566768479500,24960600,-1
427,1,STEP,566768535400,566793418900,24883500,-1
428,1,STEP,566793473400,566819020300,25546900,-1
429,1,STEP,566819084100,566844631500,25547400,-1
430,1,STEP,566844681900,566870309100,25627200,-1
431,1,STEP,566870345000,566896329200,25984200,-1
432,1,STEP,566896382800,566922319600,25936800,-1
433,1,STEP,566922366300,566948504900,26138600,-1
434,1,STEP,566948551200,566974360600,25809400,-1
435,1,STEP,566974410500,567000781900,26371400,-1
436,1,STEP,567000852800,567026661400,25808600,-1
437,1,STEP,567026710800,567052503100,25792300,-1
438,1,STEP,567052546800,567078439400,25892600,-1
439,1,STEP,567078482100,567104079500,25597400,-1
440,1,STEP,567104126100,567129827700,25701600,-1
441,1,STEP,567129867600,567156065400,26197800,-1
442,1,STEP,567156113200,567181750300,25637100,-1
443,1,STEP,567181793100,567207291400,25498300,-1
444,1,STEP,567207369700,567232544000,25174300,-1
445,1,STEP,567232586200,567258193600,25607400,-1
446,1,STEP,567258242600,567283212400,24969800,-1
447,1,STEP,567283260600,567308844800,25584200,-1
448,1,STEP,567308894400,567333724600,24830200,-1
449,1,STEP,567333792300,567359004200,25211900,-1
450,1,STEP,567359056500,567384354900,25298400,-1
451,1,STEP,567384403000,567409453900,25050900,-1
452,1,STEP,567409508300,567433903600,24395300,-1
453,1,STEP,567433949000,567458727700,24778700,-1
454,1,STEP,567458770600,567483700400,24929800,-1
455,1,STEP,567483742000,567509244500,25502500,-1
456,1,STEP,567509295700,567534203300,24907600,-1
457,1,STEP,567534248800,567559761900,25513100,-1
458,1,STEP,567559804300,567584558700,24754400,-1
459,1,STEP,567584602800,567609728200,25125400,-1
460,1,STEP,567609816000,567635605000,25789000,-1
461,1,STEP,567635651300,567660588400,24937100,-1
462,1,STEP,567660631700,567685812500,25180800,-1
463,1,STEP,567685850900,567710280900,24430000,-1
464,1,STEP,567710327900,567735475300,25147400,-1
465,1,STEP,567735549800,567760971200,25421400,-1
466,1,STEP,567761025300,567785715400,24690100,-1
467,1,STEP,567785763900,567811610600,25846700,-1
468,1,STEP,567811658500,567836933600,25275100,-1
469,1,STEP,567836986200,567863413100,26426900,-1
470,1,STEP,567863531300,567888414800,24883500,-1
471,1,STEP,567888479100,567913662800,25183700,-1
472,1,STEP,567913715900,567938771700,25055800,-1
473,1,STEP,567938822200,567964045500,25223300,-1
474,1,STEP,567964096000,567988745800,24649800,-1
475,1,STEP,567988812900,568014841300,26028400,-1
476,1,STEP,568014889100,568039674700,24785600,-1
477,1,STEP,568039719000,568065446500,25727500,-1
478,1,STEP,568065493500,568089911000,24417500,-1
479,1,STEP,568089953200,568115261900,25308700,-1
480,1,STEP,568115302100,568141068300,25766200,-1
481,1,STEP,568141139100,568166664300,25525200,-1
482,1,STEP,568166752300,568191785300,25033000,-1
483,1,STEP,568191831400,568216747300,24915900,-1
484,1,STEP,568216793700,568242504500,25710800,-1
485,1,STEP,568242559600,568267548200,24988600,-1
486,1,STEP,568267601200,568292186200,24585000,-1
487,1,STEP,568292242900,568317539800,25296900,-1
488,1,STEP,568317596500,568341971000,24374500,-1
489,1,STEP,568342025000,568367271500,25246500,-1
490,1,STEP,568367331500,568391781600,24450100,-1
491,1,STEP,568391826200,568417455800,25629600,-1
492,1,STEP,568417503200,568442799300,25296100,-1
493,1,STEP,568442858300,568467535600,24677300,-1
494,1,STEP,568467585600,568493581200,25995600,-1
495,1,STEP,568493703100,568518681900,24978800,-1
496,1,STEP,568518725600,568543244000,24518400,-1
497,1,STEP,568543293900,568568904500,25610600,-1
498,1,STEP,568568960600,568593573200,24612600,-1
499,1,STEP,568593621800,568619235200,25613400,-1
500,1,STEP,568619292400,568644751000,25458600,-1
501,1,STEP,568644802000,568669659700,24857700,-1
502,1,STEP,568669722600,568694341800,24619200,-1
503,1,STEP,568704572900,568730037300,25464400,-1
504,1,STEP,568730088000,568755211600,25123600,-1
505,1,STEP,568755275600,568781788900,26513300,-1
506,1,STEP,568781862900,568807527300,25664400,-1
507,1,STEP,568807578700,568833241600,25662900,-1
508,1,STEP,568833294600,568859308400,26013800,-1
509,1,STEP,568859356600,568885484600,26128000,-1
510,1,STEP,568885540800,568911292300,25751500,-1
511,1,STEP,568911356900,568937162800,25805900,-1
512,1,STEP,568937234400,568962563000,25328600,-1
513,1,STEP,568962611100,568988198200,25587100,-1
514,1,STEP,568988285000,569014058600,25773600,-1
515,1,STEP,569014112400,569039303000,25190600,-1
516,1,STEP,569039348600,569064197500,24848900,-1
517,1,STEP,569064247300,569089779700,25532400,-1
518,1,STEP,569089847400,569114518000,24670600,-1
519,1,STEP,569114566400,569140019700,25453300,-1
520,1,STEP,569140081100,569165428800,25347700,-1
521,1,STEP,569165478500,569190815900,25337400,-1
522,1,STEP,569190896600,569216069100,25172500,-1
523,1,STEP,569216269100,569242632700,26363600,-1
524,1,STEP,569242718300,569268895500,26177200,-1
525,1,STEP,569269020800,569295211300,26190500,-1
526,1,STEP,569295399800,569320493500,25093700,-1
527,1,STEP,569320568100,569346964900,26396800,-1
528,1,STEP,569347178900,569372428300,25249400,-1
529,1,STEP,569372547700,569396851800,24304100,-1
530,1,STEP,569396931900,569421582900,24651000,-1
531,1,STEP,569421640100,569445812600,24172500,-1
532,1,STEP,569445870700,569470980100,25109400,-1
533,1,STEP,569471040000,569496213100,25173100,-1
534,1,STEP,569496273000,569521345900,25072900,-1
535,1,STEP,569521400400,569546926700,25526300,-1
536,1,STEP,569546982100,569571746500,24764400,-1
537,1,STEP,569571791300,569597118800,25327500,-1
538,1,STEP,569597171500,569622735500,25564000,-1
539,1,STEP,569622786800,569648214400,25427600,-1
540,1,STEP,569648266200,569673061100,24794900,-1
541,1,STEP,569673175100,569699028100,25853000,-1
542,1,STEP,569699076400,569724163400,25087000,-1
543,1,STEP,569724238200,569749640100,25401900,-1
544,1,STEP,569749711700,569775104600,25392900,-1
545,1,STEP,569775159600,569801224800,26065200,-1
546,1,STEP,569801275600,569826534700,25259100,-1
547,1,STEP,569826617500,569852296100,25678600,-1
548,1,STEP,569852347900,569878129900,25782000,-1
549,1,STEP,569878189700,569903447100,25257400,-1
550,1,STEP,569903498900,569928811500,25312600,-1
551,1,STEP,569928866600,569954185300,25318700,-1
552,1,STEP,569954233900,569978438200,24204300,-1
553,1,STEP,569978488500,570004543400,26054900,-1
554,1,STEP,570004591000,570030339100,25748100,-1
555,1,STEP,570030385400,570054902300,24516900,-1
556,1,STEP,570054937500,570079264700,24327200,-1
557,1,STEP,570079302800,570103629200,24326400,-1
558,1,STEP,570103681100,570128385100,24704000,-1
559,1,STEP,570128430700,570153347100,24916400,-1
560,1,STEP,570153394900,570178649100,25254200,-1
561,1,STEP,570178688800,570203637200,24948400,-1
562,1,STEP,570203678700,570228534100,24855400,-1
563,1,STEP,570228592200,570253901400,25309200,-1
564,1,STEP,570253948500,570278240400,24291900,-1
565,1,STEP,570278287300,570303774300,25487000,-1
566,1,STEP,570303811600,570329013200,25201600,-1
567,1,STEP,570329053700,570355007400,25953700,-1
568,1,STEP,570355058600,570380472700,25414100,-1
569,1,STEP,570380518400,570405128600,24610200,-1
570,1,STEP,570405175100,570430410500,25235400,-1
571,1,STEP,570430475000,570455712100,25237100,-1
572,1,STEP,570455767200,570480765500,24998300,-1
573,1,STEP,570480816300,570505895500,25079200,-1
574,1,STEP,570505946800,570531468200,25521400,-1
575,1,STEP,570531518800,570555918100,24399300,-1
576,1,STEP,570555979500,570580435300,24455800,-1
577,1,STEP,570580488600,570605402900,24914300,-1
578,1,STEP,570605448200,570630532400,25084200,-1
579,1,STEP,570630573300,570655350300,24777000,-1
580,1,STEP,570655401600,570679832600,24431000,-1
581,1,STEP,570679886000,570704581900,24695900,-1
582,1,STEP,570704627400,570729340700,24713300,-1
583,1,STEP,570729384000,570754402100,25018100,-1
584,1,STEP,570754451500,570778933200,24481700,-1
585,1,STEP,570778994800,570803997900,25003100,-1
586,1,STEP,570804042100,570828731900,24689800,-1
587,1,STEP,570828781800,570853663900,24882100,-1
588,1,STEP,570853713500,570879671400,25957900,-1
589,1,STEP,570879714400,570904233900,24519500,-1
590,1,STEP,570904273700,570929934100,25660400,-1
591,1,STEP,570929970400,570955191800,25221400,-1
592,1,STEP,570955240200,570979539200,24299000,-1
593,1,STEP,570979591900,571004197800,24605900,-1
594,1,STEP,571004246400,571029689500,25443100,-1
595,1,STEP,571029738400,571055349600,25611200,-1
596,1,STEP,571055399300,571079938400,24539100,-1
597,1,STEP,571079980600,571104625900,24645300,-1
598,1,STEP,571104663900,571129611800,24947900,-1
599,1,STEP,571129651100,571154713600,25062500,-1
600,1,STEP,571154760800,571179775400,25014600,-1
601,1,STEP,571179824400,571204839500,25015100,-1
602,1,STEP,571204892400,571229743400,24851000,-1
603,1,STEP,571229794900,571255029000,25234100,-1
604,1,STEP,571255074300,571281476800,26402500,-1
605,1,STEP,571281608600,571307727300,26118700,-1
606,1,STEP,571307839900,571333424000,25584100,-1
607,1,STEP,571333488300,571358673600,25185300,-1
608,1,STEP,571358730000,571383661300,24931300,-1
609,1,STEP,571383711500,571408521700,24810200,-1
610,1,STEP,571408563700,571434025000,25461300,-1
611,1,STEP,571434069200,571459883900,25814700,-1
612,1,STEP,571459931300,571485313900,25382600,-1
613,1,STEP,571485359200,571510876900,25517700,-1
614,1,STEP,571510921500,571535463700,24542200,-1
615,1,STEP,571535507200,571560880100,25372900,-1
616,1,STEP,571560915200,571587344800,26429600,-1
617,1,STEP,571587381400,571613345100,25963700,-1
618,1,STEP,571613393200,571638968600,25575400,-1
619,1,STEP,571639011000,571664055300,25044300,-1
620,1,STEP,571664099700,571689091900,24992200,-1
621,1,STEP,571689147600,571713854100,24706500,-1
622,1,STEP,571713901100,571739512200,25611100,-1
623,1,STEP,571739551800,571765764200,26212400,-1
624,1,STEP,571765804100,571790230600,24426500,-1
625,1,STEP,571790283000,571815404500,25121500,-1
626,1,STEP,571815453100,571840763900,25310800,-1
627,1,STEP,571840806000,571866511600,25705600,-1
628,1,STEP,571866545100,571891860000,25314900,-1
629,1,STEP,571891905700,571917229600,25323900,-1
630,1,STEP,571917276400,571942820400,25544000,-1
631,1,STEP,571942863900,571968081300,25217400,-1
632,1,STEP,571968127900,571993376000,25248100,-1
633,1,STEP,571993418500,572019184100,25765600,-1
634,1,STEP,572019236000,572043925500,24689500,-1
635,1,STEP,572043974200,572069094400,25120200,-1
636,1,STEP,572069153200,572094631500,25478300,-1
637,1,STEP,572094682200,572120109000,25426800,-1
638,1,STEP,572120151600,572145659500,25507900,-1
639,1,STEP,572145706200,572171670200,25964000,-1
640,1,STEP,572171711400,572197924800,26213400,-1
641,1,STEP,572197966900,572223720500,25753600,-1
642,1,STEP,572223761900,572248561300,24799400,-1
643,1,STEP,572248611800,572273912400,25300600,-1
644,1,STEP,572273961700,572299103500,25141800,-1
645,1,STEP,572299141200,572324097500,24956300,-1
646,1,STEP,572324138700,572348878100,24739400,-1
647,1,STEP,572348932300,572374409000,25476700,-1
648,1,STEP,572374459600,572399558200,25098600,-1
649,1,STEP,572399601700,572425364600,25762900,-1
650,1,STEP,572425401900,572450800900,25399000,-1
651,1,STEP,572450850700,572475495400,24644700,-1
652,1,STEP,572475542800,572501332500,25789700,-1
653,1,STEP,572501374600,572527040500,25665900,-1
654,1,STEP,572527085500,572552046800,24961300,-1
655,1,STEP,572552094100,572576597000,24502900,-1
656,1,STEP,572576643900,572601761200,25117300,-1
657,1,STEP,572601807800,572627211100,25403300,-1
658,1,STEP,572627251600,572652533900,25282300,-1
659,1,STEP,572652618200,572678122400,25504200,-1
660,1,STEP,572678165400,572703328400,25163000,-1
661,1,STEP,572703369400,572728397800,25028400,-1
662,1,STEP,572728439100,572754976200,26537100,-1
663,1,STEP,572755018500,572780137600,25119100,-1
664,1,STEP,572780184100,572805539200,25355100,-1
665,1,STEP,572805597900,572830918700,25320800,-1
666,1,STEP,572830966700,572857620400,26653700,-1
667,1,STEP,572857663300,572882078300,24415000,-1
668,1,STEP,572882123600,572907697700,25574100,-1
669,1,STEP,572907741300,572932681700,24940400,-1
670,1,STEP,572932725700,572958270700,25545000,-1
671,1,STEP,572958323000,572983629100,25306100,-1
672,1,STEP,572983681100,573009708000,26026900,-1
673,1,STEP,573009755200,573035510100,25754900,-1
674,1,STEP,573035567300,573061113400,25546100,-1
675,1,STEP,573061167500,573086895700,25728200,-1
676,1,STEP,573086963000,573112492600,25529600,-1
677,1,STEP,573112625300,573138269500,25644200,-1
678,1,STEP,573138400600,573163823700,25423100,-1
679,1,STEP,573163880100,573189457900,25577800,-1
680,1,STEP,573189533200,573215476400,25943200,-1
681,1,STEP,573215625200,573240279700,24654500,-1
682,1,STEP,573240328100,573266502200,26174100,-1
683,1,STEP,573266560900,573291227700,24666800,-1
684,1,STEP,573291314800,573316789000,25474200,-1
685,1,STEP,573316841600,573342197700,25356100,-1
686,1,STEP,573342249900,573367712700,25462800,-1
687,1,STEP,573367758500,573393128600,25370100,-1
688,1,STEP,573393174300,573418752800,25578500,-1
689,1,STEP,573418795100,573443665800,24870700,-1
690,1,STEP,573443709400,573469739300,26029900,-1
691,1,STEP,573469782700,573495869100,26086400,-1
692,1,STEP,573495909700,573521023900,25114200,-1
693,1,STEP,573521076300,573546434600,25358300,-1
694,1,STEP,573546480000,573572018700,25538700,-1
695,1,STEP,573572059700,573597983100,25923400,-1
696,1,STEP,573598035600,573623106400,25070800,-1
697,1,STEP,573623151100,573648219800,25068700,-1
698,1,STEP,573648269900,573674086200,25816300,-1
699,1,STEP,573674135700,573699484500,25348800,-1
700,1,STEP,573699528200,573724940700,25412500,-1
701,1,STEP,573724993300,573749538700,24545400,-1
702,1,STEP,573749591600,573774472700,24881100,-1
703,1,STEP,573774522500,573799135000,24612500,-1
704,1,STEP,573799181200,573824999400,25818200,-1
705,1,STEP,573825046000,573850281200,25235200,-1
706,1,STEP,573850332000,573876243600,25911600,-1
707,1,STEP,573876295100,573902867400,26572300,-1
708,1,STEP,573902923500,573928203800,25280300,-1
709,1,STEP,573928254500,573954798000,26543500,-1
710,1,STEP,573954850500,573980144300,25293800,-1
711,1,STEP,573980196900,574004884000,24687100,-1
712,1,STEP,574004937400,574029240900,24303500,-1
713,1,STEP,574029290500,574054194800,24904300,-1
714,1,STEP,574054243600,574078660400,24416800,-1
715,1,STEP,574078711300,574102850000,24138700,-1
716,1,STEP,574102894200,574127329700,24435500,-1
717,1,STEP,574127388200,574152036400,24648200,-1
718,1,STEP,574152093300,574176568200,24474900,-1
719,1,STEP,574176621300,574201315200,24693900,-1
720,1,STEP,574201367100,574226966300,25599200,-1
721,1,STEP,574227014300,574252009400,24995100,-1
722,1,STEP,574252056600,574276862300,24805700,-1
723,1,STEP,574276914600,574301147900,24233300,-1
724,1,STEP,574301195600,574325891600,24696000,-1
725,1,STEP,574325939100,574351041200,25102100,-1
726,1,STEP,574351081100,574375951900,24870800,-1
727,1,STEP,574375997600,574401606600,25609000,-1
728,1,STEP,574401655600,574426470600,24815000,-1
729,1,STEP,574426510400,574451751000,25240600,-1
730,1,STEP,574451794600,574477060700,25266100,-1
731,1,STEP,574477098100,574502608400,25510300,-1
732,1,STEP,574502653700,574527968000,25314300,-1
733,1,STEP,574528007300,574553493900,25486600,-1
734,1,STEP,574553532100,574577927000,24394900,-1
735,1,STEP,574577972900,574603277700,25304800,-1
736,1,STEP,574603320900,574628272900,24952000,-1
737,1,STEP,574628320500,574653305600,24985100,-1
738,1,STEP,574653351000,574678824700,25473700,-1
739,1,STEP,574678862700,574704066500,25203800,-1
740,1,STEP,574704122700,574729686300,25563600,-1
741,1,STEP,574729728400,574755470200,25741800,-1
742,1,STEP,574755509900,574780992500,25482600,-1
743,1,STEP,574781043200,574805767600,24724400,-1
744,1,STEP,574805816200,574831572800,25756600,-1
745,1,STEP,574831616100,574857543300,25927200,-1
746,1,STEP,574857593800,574882495000,24901200,-1
747,1,STEP,574882547100,574907476700,24929600,-1
748,1,STEP,574907532000,574932433200,24901200,-1
749,1,STEP,574932485100,574957540400,25055300,-1
750,1,STEP,574957597200,574983026600,25429400,-1
751,1,STEP,574983107100,575008788600,25681500,-1
752,1,STEP,575008864300,575034410000,25545700,-1
753,1,STEP,575034505200,575059132800,24627600,-1
754,1,STEP,575059182800,575083726200,24543400,-1
755,1,STEP,575083776700,575108451000,24674300,-1
756,1,STEP,575108527300,575132811600,24284300,-1
757,1,STEP,575132870300,575157829700,24959400,-1
758,1,STEP,575157884100,575183550100,25666000,-1
759,1,STEP,575183646500,575209808300,26161800,-1
760,1,STEP,575209857400,575234955500,25098100,-1
761,1,STEP,575235005700,575260417700,25412000,-1
762,1,STEP,575260468500,575284425900,23957400,-1
763,1,STEP,575284473100,575309461700,24988600,-1
764,1,STEP,575309506400,575334205600,24699200,-1
765,1,STEP,575334257100,575360387400,26130300,-1
766,1,STEP,575360443500,575385666300,25222800,-1
767,1,STEP,575385721800,575410957800,25236000,-1
768,1,STEP,575411013400,575436149600,25136200,-1
769,1,STEP,575436205900,575462366100,26160200,-1
770,1,STEP,575462421800,575487573700,25151900,-1
771,1,STEP,575487651300,575513022000,25370700,-1
772,1,STEP,575513080300,575537545500,24465200,-1
773,1,STEP,575537688900,575563082700,25393800,-1
774,1,STEP,575563140200,575588431200,25291000,-1
775,1,STEP,575588485900,575613868000,25382100,-1
776,1,STEP,575613918700,575638410300,24491600,-1
777,1,STEP,575638466700,575664226400,25759700,-1
778,1,STEP,575664284600,575690131100,25846500,-1
779,1,STEP,575690181500,575714801600,24620100,-1
780,1,STEP,575714857900,575740140500,25282600,-1
781,1,STEP,575740186900,575765776300,25589400,-1
782,1,STEP,575765873900,575792177900,26304000,-1
783,1,STEP,575792266200,575818512900,26246700,-1
784,1,STEP,575818574400,575843925800,25351400,-1
785,1,STEP,575843973000,575869003900,25030900,-1
786,1,STEP,575869053000,575894378500,25325500,-1
787,1,STEP,575894427300,575918482700,24055400,-1
788,1,STEP,575918561600,575944121200,25559600,-1
789,1,STEP,575944172600,575970006700,25834100,-1
790,1,STEP,575970054600,575994398600,24344000,-1
791,1,STEP,575994451700,576020091000,25639300,-1
792,1,STEP,576020208000,576045416700,25208700,-1
793,1,STEP,576045469100,576069982700,24513600,-1
794,1,STEP,576070034600,576094867800,24833200,-1
795,1,STEP,576094926300,576120732100,25805800,-1
796,1,STEP,576120780100,576145497700,24717600,-1
797,1,STEP,576145562700,576170592000,25029300,-1
798,1,STEP,576170637500,576195322600,24685100,-1
799,1,STEP,576195380800,576220751400,25370600,-1
800,1,STEP,576220825800,576246693300,25867500,-1
801,1,STEP,576246744100,576270885600,24141500,-1
802,1,STEP,576270955300,576295628000,24672700,-1
803,1,STEP,576295690300,576320834500,25144200,-1
804,1,STEP,576320891600,576346499600,25608000,-1
805,1,STEP,576346574300,576371206700,24632400,-1
806,1,STEP,576371260500,576396073900,24813400,-1
807,1,STEP,576396132800,576420999100,24866300,-1
808,1,STEP,576421048200,576445799200,24751000,-1
809,1,STEP,576445852200,576471455100,25602900,-1
810,1,STEP,576471499800,576496731300,25231500,-1
811,1,STEP,576496782200,576522348400,25566200,-1
812,1,STEP,576522396100,576547149000,24752900,-1
813,1,STEP,576547199300,576572110500,24911200,-1
814,1,STEP,576572154800,576598000300,25845500,-1
815,1,STEP,576598045100,576623798200,25753100,-1
816,1,STEP,576623866200,576648218700,24352500,-1
817,1,STEP,576648265700,576673702300,25436600,-1
818,1,STEP,576673746300,576699177900,25431600,-1
819,1,STEP,576699218200,576725533800,26315600,-1
820,1,STEP,576725578200,576750160100,24581900,-1
821,1,STEP,576750205500,576774964800,24759300,-1
822,1,STEP,576775005800,576799559400,24553600,-1
823,1,STEP,576799600500,576825179300,25578800,-1
824,1,STEP,576825221900,576850515200,25293300,-1
825,1,STEP,576850567100,576876242300,25675200,-1
826,1,STEP,576876298600,576901453900,25155300,-1
827,1,STEP,576901500400,576926953000,25452600,-1
828,1,STEP,576926993100,576952760500,25767400,-1
829,1,STEP,576952809000,576979234400,26425400,-1
830,1,STEP,576979279500,577004448500,25169000,-1
831,1,STEP,577004491000,577029619400,25128400,-1
832,1,STEP,577029662300,577054690200,25027900,-1
833,1,STEP,577054734500,577079520500,24786000,-1
834,1,STEP,577079567200,577104441400,24874200,-1
835,1,STEP,577104501000,577128893400,24392400,-1
836,1,STEP,577128948500,577153514500,24566000,-1
837,1,STEP,577153581300,577178281000,24699700,-1
838,1,STEP,577178336600,577203018000,24681400,-1
839,1,STEP,577203097800,577229253400,26155600,-1
840,1,STEP,577229309100,577254396800,25087700,-1
841,1,STEP,577254446800,577279526000,25079200,-1
842,1,STEP,577279589400,577304961300,25371900,-1
843,1,STEP,577305038100,577330036300,24998200,-1
844,1,STEP,577330092300,577355246500,25154200,-1
845,1,STEP,577355311500,577380840100,25528600,-1
846,1,STEP,577380898300,577406396500,25498200,-1
847,1,STEP,577406451500,577431959700,25508200,-1
848,1,STEP,577432013600,577457296000,25282400,-1
849,1,STEP,577457346900,577482584200,25237300,-1
850,1,STEP,577482626300,577507164800,24538500,-1
851,1,STEP,577507218100,577532030300,24812200,-1
852,1,STEP,577532083100,577557634700,25551600,-1
853,1,STEP,577557688100,577583013700,25325600,-1
854,1,STEP,577583074700,577608542200,25467500,-1
855,1,STEP,577608590400,577633414900,24824500,-1
856,1,STEP,577633467600,577658816500,25348900,-1
857,1,STEP,577658862700,577684086900,25224200,-1
858,1,STEP,577684146200,577709519100,25372900,-1
859,1,STEP,577709569000,577734900500,25331500,-1
860,1,STEP,577734942300,577759960200,25017900,-1
861,1,STEP,577760010000,577784784400,24774400,-1
862,1,STEP,577784838500,577809435700,24597200,-1
863,1,STEP,577809490600,577834913100,25422500,-1
864,1,STEP,577834964700,577860099600,25134900,-1
865,1,STEP,577860148800,577885286100,25137300,-1
866,1,STEP,577885333000,577909866300,24533300,-1
867,1,STEP,577909918100,577934774800,24856700,-1
868,1,STEP,577934829100,577959686700,24857600,-1
869,1,STEP,577959741500,577985397700,25656200,-1
870,1,STEP,577985538600,578011321800,25783200,-1
871,1,STEP,578011373200,578037061000,25687800,-1
872,1,STEP,578037119500,578062163700,25044200,-1
873,1,STEP,578062206700,578087101900,24895200,-1
874,1,STEP,578087143100,578111991200,24848100,-1
875,1,STEP,578112037600,578137369900,25332300,-1
876,1,STEP,578137418300,578163285000,25866700,-1
877,1,STEP,578163325600,578188757900,25432300,-1
878,1,STEP,578188793800,578213443600,24649800,-1
879,1,STEP,578213482400,578238135900,24653500,-1
880,1,STEP,578238184500,578263653700,25469200,-1
881,1,STEP,578263712500,578289275700,25563200,-1
882,1,STEP,578289321700,578314086600,24764900,-1
883,1,STEP,578314140800,578339450500,25309700,-1
884,1,STEP,578339513600,578363785500,24271900,-1
885,1,STEP,578363844400,578390119400,26275000,-1
886,1,STEP,578390180500,578415048600,24868100,-1
887,1,STEP,578415104800,578439575300,24470500,-1
888,1,STEP,578439631100,578464772600,25141500,-1
889,1,STEP,578464832200,578489822300,24990100,-1
890,1,STEP,578489882600,578514784400,24901800,-1
891,1,STEP,578514842200,578539965500,25123300,-1
892,1,STEP,578540015400,578565009400,24994000,-1
893,1,STEP,578565072200,578589339700,24267500,-1
894,1,STEP,578589388900,578614692000,25303100,-1
895,1,STEP,578614743500,578639837400,25093900,-1
896,1,STEP,578639909500,578664855600,24946100,-1
897,1,STEP,578664921200,578689470700,24549500,-1
898,1,STEP,578689540500,578714616900,25076400,-1
899,1,STEP,578714682000,578739273400,24591400,-1
900,1,STEP,578739324100,578764949700,25625600,-1
901,1,STEP,578765006300,578789982100,24975800,-1
902,1,STEP,578790032200,578815029500,24997300,-1
903,1,STEP,578815084000,578840692100,25608100,-1
904,1,STEP,578840744200,578865892300,25148100,-1
905,1,STEP,578865940400,578890377300,24436900,-1
906,1,STEP,578890438000,578916647600,26209600,-1
907,1,STEP,578916707800,578941600000,24892200,-1
908,1,STEP,578941651700,578967216300,25564600,-1
909,1,STEP,578967274100,578992253800,24979700,-1
910,1,STEP,578992304800,579017459100,25154300,-1
911,1,STEP,579017512200,579043172500,25660300,-1
912,1,STEP,579043222600,579068769300,25546700,-1
913,1,STEP,579068822900,579093968800,25145900,-1
914,1,STEP,579094019700,579119276700,25257000,-1
915,1,STEP,579119330400,579144517600,25187200,-1
916,1,STEP,579144571300,579169336500,24765200,-1
917,1,STEP,579169383200,579194199900,24816700,-1
918,1,STEP,579194244000,579219906500,25662500,-1
919,1,STEP,579219950300,579244943000,24992700,-1
920,1,STEP,579244994100,579270514800,25520700,-1
921,1,STEP,579270555100,579295872900,25317800,-1
922,1,STEP,579295944100,579320842800,24898700,-1
923,1,STEP,579320907600,579345836500,24928900,-1
924,1,STEP,579345889800,579371543900,25654100,-1
925,1,STEP,579371603800,579397320700,25716900,-1
926,1,STEP,579397373100,579422540700,25167600,-1
927,1,STEP,579422609800,579448118900,25509100,-1
928,1,STEP,579448166200,579473144300,24978100,-1
929,1,STEP,579473206000,579498787300,25581300,-1
930,1,STEP,579498837000,579523445000,24608000,-1
931,1,STEP,579523513100,579548624800,25111700,-1
932,1,STEP,579548713900,579572942900,24229000,-1
933,1,STEP,579573000300,579599103900,26103600,-1
934,1,STEP,579599161400,579623329500,24168100,-1
935,1,STEP,579623384400,579648744700,25360300,-1
936,1,STEP,579648811800,579673826800,25015000,-1
937,1,STEP,579673989200,579699568600,25579400,-1
938,1,STEP,579699620000,579724173700,24553700,-1
939,1,STEP,579724246600,579748406900,24160300,-1
940,1,STEP,579748473800,579772996200,24522400,-1
941,1,STEP,579773050800,579798248600,25197800,-1
942,1,STEP,579798303800,579823416500,25112700,-1
943,1,STEP,579823465700,579848778000,25312300,-1
944,1,STEP,579848824000,579873251500,24427500,-1
945,1,STEP,579873309100,579897053100,23744000,-1
946,1,STEP,579897110700,579921268800,24158100,-1
947,1,STEP,579921328300,579946614000,25285700,-1
948,1,STEP,579946667300,579971339200,24671900,-1
949,1,STEP,579971390100,579996192500,24802400,-1
950,1,STEP,579996250100,580021034000,24783900,-1
951,1,STEP,580021088400,580045404200,24315800,-1
952,1,STEP,580045454500,580070428500,24974000,-1
953,1,STEP,580070477100,580095899700,25422600,-1
954,1,STEP,580095944400,580122102700,26158300,-1
955,1,STEP,580122148900,580147378300,25229400,-1
956,1,STEP,580147424900,580173681300,26256400,-1
957,1,STEP,580173728800,580199750600,26021800,-1
958,1,STEP,580199800700,580224562200,24761500,-1
959,1,STEP,580224607300,580250527100,25919800,-1
960,1,STEP,580250568300,580275408300,24840000,-1
961,1,STEP,580275452200,580299645200,24193000,-1
962,1,STEP,580299694000,580324681200,24987200,-1
963,1,STEP,580324729000,580350123200,25394200,-1
964,1,STEP,580350160600,580376292600,26132000,-1
965,1,STEP,580376333500,580401658400,25324900,-1
966,1,STEP,580401705900,580426548900,24843000,-1
967,1,STEP,580426604500,580452266000,25661500,-1
968,1,STEP,580452319000,580478170200,25851200,-1
969,1,STEP,580478237300,580504111900,25874600,-1
970,1,STEP,580504163900,580529707700,25543800,-1
971,1,STEP,580529765900,580554298800,24532900,-1
972,1,STEP,580554344900,580578800000,24455100,-1
973,1,STEP,580578852000,580603434400,24582400,-1
974,1,STEP,580603497100,580628170900,24673800,-1
975,1,STEP,580628218200,580654116900,25898700,-1
976,1,STEP,580654174300,580678535700,24361400,-1
977,1,STEP,580678586600,580704111700,25525100,-1
978,1,STEP,580704165700,580729553500,25387800,-1
979,1,STEP,580729627200,580754374300,24747100,-1
980,1,STEP,580754423300,580779091500,24668200,-1
981,1,STEP,580779136700,580804460600,25323900,-1
982,1,STEP,580804508300,580830818700,26310400,-1
983,1,STEP,580830866600,580856147100,25280500,-1
984,1,STEP,580856191200,580881089000,24897800,-1
985,1,STEP,580881130600,580906509000,25378400,-1
986,1,STEP,580906551600,580932552800,26001200,-1
987,1,STEP,580932602200,580958904100,26301900,-1
988,1,STEP,580958953100,580984643700,25690600,-1
989,1,STEP,580984689700,581010085200,25395500,-1
990,1,STEP,581010129500,581035615500,25486000,-1
991,1,STEP,581035662400,581061509600,25847200,-1
992,1,STEP,581061554300,581086316400,24762100,-1
993,1,STEP,581086362700,581111549800,25187100,-1
994,1,STEP,581111594000,581137461500,25867500,-1
995,1,STEP,581137510000,581162773900,25263900,-1
996,1,STEP,581162846100,581187760700,24914600,-1
997,1,STEP,581187801100,581213465800,25664700,-1
998,1,STEP,581213512800,581239129900,25617100,-1
999,1,STEP,581239181600,581264927400,25745800,-1
