Gen,Resource,Stamp,TimeStamp_Start,TimeStamp_End,Duration,Indiv_id
0,1,TransfertToDevice,780699124300,780993401800,294277500,-1
0,1,STEP,781132090500,781150473800,18383300,-1
1,1,STEP,781150587000,781169390300,18803300,-1
2,1,STEP,781169514000,781188094800,18580800,-1
3,1,STEP,781188159800,781206218200,18058400,-1
4,1,STEP,781206287500,781224313700,18026200,-1
5,1,STEP,781224395000,781242567200,18172200,-1
6,1,STEP,781242639200,781260894900,18255700,-1
7,1,STEP,781260965300,781285150100,24184800,-1
8,1,STEP,781285239900,781305824500,20584600,-1
9,1,STEP,781305912700,781325278300,19365600,-1
10,1,STEP,781325353900,781344167700,18813800,-1
11,1,STEP,781344256300,781362664500,18408200,-1
12,1,STEP,781362725400,781381130400,18405000,-1
13,1,STEP,781381200400,781400449200,19248800,-1
14,1,STEP,781400522200,781420057200,19535000,-1
15,1,STEP,781420161800,781439887600,19725800,-1
16,1,STEP,781439960800,781459389900,19429100,-1
17,1,STEP,781459449900,781478889100,19439200,-1
18,1,STEP,781478948700,781498671400,19722700,-1
19,1,STEP,781498728500,781518309200,19580700,-1
20,1,STEP,781518388100,781537878100,19490000,-1
21,1,STEP,781537941400,781557245000,19303600,-1
22,1,STEP,781557351100,781577294900,19943800,-1
23,1,STEP,781577358100,781597529000,20170900,-1
24,1,STEP,781597595900,781617570200,19974300,-1
25,1,STEP,781617638800,781637832200,20193400,-1
26,1,STEP,781637903000,781657815400,19912400,-1
27,1,STEP,781657900600,781677960000,20059400,-1
28,1,STEP,781678022400,781697926600,19904200,-1
29,1,STEP,781697984400,781717623100,19638700,-1
30,1,STEP,781717698500,781737416700,19718200,-1
31,1,STEP,781737477800,781757178100,19700300,-1
32,1,STEP,781757238300,781777373200,20134900,-1
33,1,STEP,781777441000,781798194100,20753100,-1
34,1,STEP,781798252600,781818287700,20035100,-1
35,1,STEP,781818342900,781838373800,20030900,-1
36,1,STEP,781838429100,781859104700,20675600,-1
37,1,STEP,781859186400,781879455500,20269100,-1
38,1,STEP,781879525600,781900156100,20630500,-1
39,1,STEP,781900209100,781920379700,20170600,-1
40,1,STEP,781920442100,781940838900,20396800,-1
41,1,STEP,781940915900,781961367100,20451200,-1
42,1,STEP,781961429400,781981154000,19724600,-1
43,1,STEP,781981222100,782001526100,20304000,-1
44,1,STEP,782001595000,782021909600,20314600,-1
45,1,STEP,782021969400,782042176800,20207400,-1
46,1,STEP,782042239300,782062906900,20667600,-1
47,1,STEP,782062961800,782083469700,20507900,-1
48,1,STEP,782083528900,782103713800,20184900,-1
49,1,STEP,782103915200,782123978800,20063600,-1
50,1,STEP,782124054300,782144185600,20131300,-1
51,1,STEP,782144245400,782164443100,20197700,-1
52,1,STEP,782164552600,782185110800,20558200,-1
53,1,STEP,782185185500,782206023600,20838100,-1
54,1,STEP,782206113600,782226615700,20502100,-1
55,1,STEP,782226800000,782247271400,20471400,-1
56,1,STEP,782247376500,782268258600,20882100,-1
57,1,STEP,782268406600,782288445700,20039100,-1
58,1,STEP,782288605200,782308092600,19487400,-1
59,1,STEP,782308266100,782327744600,19478500,-1
60,1,STEP,782327815900,782347623300,19807400,-1
61,1,STEP,782347724300,782367392700,19668400,-1
62,1,STEP,782367489100,782387795000,20305900,-1
63,1,STEP,782387861300,782408044200,20182900,-1
64,1,STEP,782408118300,782428249800,20131500,-1
65,1,STEP,782428313400,782448439500,20126100,-1
66,1,STEP,782448507400,782468158500,19651100,-1
67,1,STEP,782468206100,782488316400,20110300,-1
68,1,STEP,782488364400,782508342800,19978400,-1
69,1,STEP,782508391100,782528390500,19999400,-1
70,1,STEP,782528448900,782548991900,20543000,-1
71,1,STEP,782549051900,782568572800,19520900,-1
72,1,STEP,782568632200,782589230400,20598200,-1
73,1,STEP,782589289400,782610286900,20997500,-1
74,1,STEP,782610341200,782630555400,20214200,-1
75,1,STEP,782630612900,782651152800,20539900,-1
76,1,STEP,782651207200,782671872600,20665400,-1
77,1,STEP,782671945500,782693231000,21285500,-1
78,1,STEP,782693290000,782714648500,21358500,-1
79,1,STEP,782714700100,782735699800,20999700,-1
80,1,STEP,782735753900,782756336400,20582500,-1
81,1,STEP,782756390800,782777832400,21441600,-1
82,1,STEP,782777890800,782800093600,22202800,-1
83,1,STEP,782800156900,782822995400,22838500,-1
84,1,STEP,782823101100,782845875500,22774400,-1
85,1,STEP,782845941800,782868782000,22840200,-1
86,1,STEP,782868856500,782891622700,22766200,-1
87,1,STEP,782891686500,782914007300,22320800,-1
88,1,STEP,782914067400,782937040300,22972900,-1
89,1,STEP,782937115200,782960139300,23024100,-1
90,1,STEP,782960215400,782983269700,23054300,-1
91,1,STEP,782983326700,783006975200,23648500,-1
92,1,STEP,783007044400,783030620700,23576300,-1
93,1,STEP,783030687100,783053500600,22813500,-1
94,1,STEP,783053572900,783077215700,23642800,-1
95,1,STEP,783077276200,783101774500,24498300,-1
96,1,STEP,783101843600,783126259800,24416200,-1
97,1,STEP,783126320400,783149862000,23541600,-1
98,1,STEP,783149929000,783173687300,23758300,-1
99,1,STEP,783173746800,783197270400,23523600,-1
100,1,STEP,783197341500,783220776300,23434800,-1
101,1,STEP,783220833700,783244345300,23511600,-1
102,1,STEP,783244403000,783267641100,23238100,-1
103,1,STEP,783267719700,783291883900,24164200,-1
104,1,STEP,783291948600,783315697600,23749000,-1
105,1,STEP,783315771200,783339561900,23790700,-1
106,1,STEP,783339622000,783363769100,24147100,-1
107,1,STEP,783363825500,783387435200,23609700,-1
108,1,STEP,783387488600,783412351800,24863200,-1
109,1,STEP,783412410100,783436570000,24159900,-1
110,1,STEP,783436623700,783460844800,24221100,-1
111,1,STEP,783460907200,783485322700,24415500,-1
112,1,STEP,783485379700,783508759700,23380000,-1
113,1,STEP,783508819100,783532764700,23945600,-1
114,1,STEP,783532822300,783556430600,23608300,-1
115,1,STEP,783556487400,783580386900,23899500,-1
116,1,STEP,783580442300,783604212100,23769800,-1
117,1,STEP,783604273600,783628008400,23734800,-1
118,1,STEP,783628065300,783652297200,24231900,-1
119,1,STEP,783652349300,783677139600,24790300,-1
120,1,STEP,783677201700,783701871400,24669700,-1
121,1,STEP,783701930700,783725653800,23723100,-1
122,1,STEP,783725703800,783750565400,24861600,-1
123,1,STEP,783750623100,783774879900,24256800,-1
124,1,STEP,783774942300,783799405700,24463400,-1
125,1,STEP,783799467200,783823290200,23823000,-1
126,1,STEP,783823351300,783847911400,24560100,-1
127,1,STEP,783847962400,783872317600,24355200,-1
128,1,STEP,783872376200,783896148800,23772600,-1
129,1,STEP,783896212100,783919914900,23702800,-1
130,1,STEP,783919975300,783943928300,23953000,-1
131,1,STEP,783943991300,783968253300,24262000,-1
132,1,STEP,783968359400,783992333000,23973600,-1
133,1,STEP,783992411100,784016177300,23766200,-1
134,1,STEP,784016234300,784039844100,23609800,-1
135,1,STEP,784039897700,784064433600,24535900,-1
136,1,STEP,784064491900,784088822000,24330100,-1
137,1,STEP,784088875100,784113121400,24246300,-1
138,1,STEP,784113180200,784136952400,23772200,-1
139,1,STEP,784137007100,784161435700,24428600,-1
140,1,STEP,784161521900,784185350900,23829000,-1
141,1,STEP,784185412700,784209583600,24170900,-1
142,1,STEP,784209642800,784234010000,24367200,-1
143,1,STEP,784234064500,784258136200,24071700,-1
144,1,STEP,784258192000,784282136500,23944500,-1
145,1,STEP,784282198800,784306190700,23991900,-1
146,1,STEP,784306245300,784330123000,23877700,-1
147,1,STEP,784330172600,784354522600,24350000,-1
148,1,STEP,784354579500,784379856500,25277000,-1
149,1,STEP,784379930600,784404171000,24240400,-1
150,1,STEP,784404253500,784428807400,24553900,-1
151,1,STEP,784428857900,784452472900,23615000,-1
152,1,STEP,784452521000,784476355000,23834000,-1
153,1,STEP,784476409100,784500946500,24537400,-1
154,1,STEP,784501006800,784525754600,24747800,-1
155,1,STEP,784525812400,784549054000,23241600,-1
156,1,STEP,784549101900,784572911000,23809100,-1
157,1,STEP,784572962700,784597273000,24310300,-1
158,1,STEP,784597326100,784621966500,24640400,-1
159,1,STEP,784622014900,784646775200,24760300,-1
160,1,STEP,784646826700,784670776900,23950200,-1
161,1,STEP,784670820100,784695294700,24474600,-1
162,1,STEP,784695345900,784720365400,25019500,-1
163,1,STEP,784720416900,784745029400,24612500,-1
164,1,STEP,784745076400,784768852700,23776300,-1
165,1,STEP,784768894900,784793047600,24152700,-1
166,1,STEP,784793088500,784816975100,23886600,-1
167,1,STEP,784817032700,784841205900,24173200,-1
168,1,STEP,784841255100,784865438600,24183500,-1
169,1,STEP,784865479100,784889278900,23799800,-1
170,1,STEP,784889325800,784912818900,23493100,-1
171,1,STEP,784912878000,784937371900,24493900,-1
172,1,STEP,784937429300,784962517600,25088300,-1
173,1,STEP,784962572700,784986700600,24127900,-1
174,1,STEP,784986743500,785010415500,23672000,-1
175,1,STEP,785010470500,785034354400,23883900,-1
176,1,STEP,785034402800,785059084700,24681900,-1
177,1,STEP,785059132200,785083069500,23937300,-1
178,1,STEP,785083108300,785107795800,24687500,-1
179,1,STEP,785107846200,785131833800,23987600,-1
180,1,STEP,785131893300,785155142500,23249200,-1
181,1,STEP,785155204800,785178684200,23479400,-1
182,1,STEP,785178737700,785202327700,23590000,-1
183,1,STEP,785202386700,785226513700,24127000,-1
184,1,STEP,785226584900,785250559300,23974400,-1
185,1,STEP,785250619300,785274354200,23734900,-1
186,1,STEP,785274423000,785299099900,24676900,-1
187,1,STEP,785299149600,785323478800,24329200,-1
188,1,STEP,785323535900,785348939000,25403100,-1
189,1,STEP,785348984600,785373131200,24146600,-1
190,1,STEP,785373207400,785396370200,23162800,-1
191,1,STEP,785396421800,785420196800,23775000,-1
192,1,STEP,785420252300,785444166000,23913700,-1
193,1,STEP,785444223500,785468660100,24436600,-1
194,1,STEP,785468710800,785492202600,23491800,-1
195,1,STEP,785492250900,785516146100,23895200,-1
196,1,STEP,785516201400,785539938500,23737100,-1
197,1,STEP,785539993100,785564305900,24312800,-1
198,1,STEP,785564358100,785588822500,24464400,-1
199,1,STEP,785588869800,785613193700,24323900,-1
200,1,STEP,785613248500,785637260200,24011700,-1
201,1,STEP,785637307900,785660495200,23187300,-1
202,1,STEP,785660554300,785684606100,24051800,-1
203,1,STEP,785684662900,785709615200,24952300,-1
204,1,STEP,785709669900,785734045700,24375800,-1
205,1,STEP,785734101400,785757458200,23356800,-1
206,1,STEP,785757514000,785781378400,23864400,-1
207,1,STEP,785781452700,785805677300,24224600,-1
208,1,STEP,785805732300,785830611600,24879300,-1
209,1,STEP,785830673500,785855337900,24664400,-1
210,1,STEP,785855394000,785878901300,23507300,-1
211,1,STEP,785879039500,785902777000,23737500,-1
212,1,STEP,785902874500,785927681200,24806700,-1
213,1,STEP,785927755100,785953327800,25572700,-1
214,1,STEP,785953400700,785976900500,23499800,-1
215,1,STEP,785976962700,786000666500,23703800,-1
216,1,STEP,786000742800,786024549000,23806200,-1
217,1,STEP,786024644000,786047928000,23284000,-1
218,1,STEP,786047992700,786071833200,23840500,-1
219,1,STEP,786071905500,786095762300,23856800,-1
220,1,STEP,786095823800,786119665900,23842100,-1
221,1,STEP,786119717200,786143638000,23920800,-1
222,1,STEP,786143703800,786167433300,23729500,-1
223,1,STEP,786167514200,786191581700,24067500,-1
224,1,STEP,786191652600,786216020300,24367700,-1
225,1,STEP,786216085500,786239463900,23378400,-1
226,1,STEP,786239563500,786263117200,23553700,-1
227,1,STEP,786263175900,786286943300,23767400,-1
228,1,STEP,786287001200,786311738900,24737700,-1
229,1,STEP,786311795600,786335580600,23785000,-1
230,1,STEP,786335662500,786360348900,24686400,-1
231,1,STEP,786360404600,786384189300,23784700,-1
232,1,STEP,786384254800,786408905800,24651000,-1
233,1,STEP,786408959100,786432841000,23881900,-1
234,1,STEP,786432926400,786457084900,24158500,-1
235,1,STEP,786457145000,786481314800,24169800,-1
236,1,STEP,786481387500,786505447800,24060300,-1
237,1,STEP,786505521600,786530315900,24794300,-1
238,1,STEP,786530382400,786554813200,24430800,-1
239,1,STEP,786554867700,786579767000,24899300,-1
240,1,STEP,786579870200,786603321100,23450900,-1
241,1,STEP,786603381100,786626870300,23489200,-1
242,1,STEP,786626946900,786650573400,23626500,-1
243,1,STEP,786650649500,786674149400,23499900,-1
244,1,STEP,786674217400,786699299100,25081700,-1
245,1,STEP,786699354000,786724143400,24789400,-1
246,1,STEP,786724262000,786749487100,25225100,-1
247,1,STEP,786749547300,786772551400,23004100,-1
248,1,STEP,786772608400,786796553100,23944700,-1
249,1,STEP,786796603600,786820542000,23938400,-1
250,1,STEP,786820593800,786844106100,23512300,-1
251,1,STEP,786844164800,786867765700,23600900,-1
252,1,STEP,786867818800,786891902500,24083700,-1
253,1,STEP,786891979700,786916316800,24337100,-1
254,1,STEP,786916369100,786940020500,23651400,-1
255,1,STEP,786940080800,786964142800,24062000,-1
256,1,STEP,786964204900,786987735000,23530100,-1
257,1,STEP,786987789600,787011757000,23967400,-1
258,1,STEP,787011809900,787035570300,23760400,-1
259,1,STEP,787035620000,787061178800,25558800,-1
260,1,STEP,787061226100,787084954300,23728200,-1
261,1,STEP,787085006700,787108348200,23341500,-1
262,1,STEP,787108397300,787131746200,23348900,-1
263,1,STEP,787131809400,787155136300,23326900,-1
264,1,STEP,787155189100,787179306000,24116900,-1
265,1,STEP,787179357500,787203151600,23794100,-1
266,1,STEP,787203200600,787227525200,24324600,-1
267,1,STEP,787227578700,787250727000,23148300,-1
268,1,STEP,787250780000,787275038400,24258400,-1
269,1,STEP,787275091300,787300103700,25012400,-1
270,1,STEP,787300160100,787324440400,24280300,-1
271,1,STEP,787324499500,787348840100,24340600,-1
272,1,STEP,787348902900,787373042900,24140000,-1
273,1,STEP,787373093100,787397045600,23952500,-1
274,1,STEP,787397104400,787420580800,23476400,-1
275,1,STEP,787420638000,787444258900,23620900,-1
276,1,STEP,787444315300,787468606200,24290900,-1
277,1,STEP,787468657300,787492714400,24057100,-1
278,1,STEP,787492772100,787517410500,24638400,-1
279,1,STEP,787517487000,787542447400,24960400,-1
280,1,STEP,787542504900,787566721400,24216500,-1
281,1,STEP,787566785800,787590287200,23501400,-1
282,1,STEP,787590337900,787613675700,23337800,-1
283,1,STEP,787613730900,787637011900,23281000,-1
284,1,STEP,787637061800,787661964500,24902700,-1
285,1,STEP,787662029400,787686537300,24507900,-1
286,1,STEP,787686584700,787710225800,23641100,-1
287,1,STEP,787710280900,787734723100,24442200,-1
288,1,STEP,787734776300,787758749900,23973600,-1
289,1,STEP,787758792000,787784009300,25217300,-1
290,1,STEP,787784080500,787810497400,26416900,-1
291,1,STEP,787810558000,787836519100,25961100,-1
292,1,STEP,787836578800,787860035500,23456700,-1
293,1,STEP,787860077900,787885567400,25489500,-1
294,1,STEP,787885627600,787911515600,25888000,-1
295,1,STEP,787911564400,787937335200,25770800,-1
296,1,STEP,787937459800,787961681200,24221400,-1
297,1,STEP,787961733300,787986568400,24835100,-1
298,1,STEP,787986623200,788010172200,23549000,-1
299,1,STEP,788010228900,788034160500,23931600,-1
300,1,STEP,788034216300,788058099500,23883200,-1
301,1,STEP,788058152800,788082288700,24135900,-1
302,1,STEP,788082344800,788107492200,25147400,-1
303,1,STEP,788107554600,788134606700,27052100,-1
304,1,STEP,788134663200,788161592900,26929700,-1
305,1,STEP,788161644300,788188293000,26648700,-1
306,1,STEP,788188344800,788215808700,27463900,-1
307,1,STEP,788215876100,788242808800,26932700,-1
308,1,STEP,788242889000,788270453700,27564700,-1
309,1,STEP,788270506600,788297960400,27453800,-1
310,1,STEP,788298012200,788324579400,26567200,-1
311,1,STEP,788324638100,788352300300,27662200,-1
312,1,STEP,788352358400,788380240500,27882100,-1
313,1,STEP,788380298300,788407198300,26900000,-1
314,1,STEP,788407315700,788435091400,27775700,-1
315,1,STEP,788435148400,788464090600,28942200,-1
316,1,STEP,788464156500,788492862100,28705600,-1
317,1,STEP,788492912600,788520163400,27250800,-1
318,1,STEP,788520216500,788546158600,25942100,-1
319,1,STEP,788546233000,788571884000,25651000,-1
320,1,STEP,788571939200,788597929500,25990300,-1
321,1,STEP,788597984900,788623484600,25499700,-1
322,1,STEP,788623549100,788650168800,26619700,-1
323,1,STEP,788650232400,788676572600,26340200,-1
324,1,STEP,788676628800,788703513800,26885000,-1
325,1,STEP,788703569200,788730580200,27011000,-1
326,1,STEP,788730654300,788757761100,27106800,-1
327,1,STEP,788757811800,788784980200,27168400,-1
328,1,STEP,788785082500,788811966200,26883700,-1
329,1,STEP,788812019700,788840138300,28118600,-1
330,1,STEP,788840191900,788868752500,28560600,-1
331,1,STEP,788868904000,788895746400,26842400,-1
332,1,STEP,788895827000,788923152500,27325500,-1
333,1,STEP,788923209400,788950194900,26985500,-1
334,1,STEP,788950246600,788977629500,27382900,-1
335,1,STEP,788977694100,789005433600,27739500,-1
336,1,STEP,789005504300,789032637500,27133200,-1
337,1,STEP,789032694000,789059800000,27106000,-1
338,1,STEP,789059858700,789087339800,27481100,-1
339,1,STEP,789087390300,789114942300,27552000,-1
340,1,STEP,789115015000,789142611200,27596200,-1
341,1,STEP,789142692200,789170005600,27313400,-1
342,1,STEP,789170059300,789196306000,26246700,-1
343,1,STEP,789196360900,789223677300,27316400,-1
344,1,STEP,789223728500,789251562300,27833800,-1
345,1,STEP,789251662400,789279039200,27376800,-1
346,1,STEP,789279095400,789306755000,27659600,-1
347,1,STEP,789306804400,789333615600,26811200,-1
348,1,STEP,789333674100,789360301900,26627800,-1
349,1,STEP,789360474500,789388140200,27665700,-1
350,1,STEP,789388200200,789415243600,27043400,-1
351,1,STEP,789415311700,789442268000,26956300,-1
352,1,STEP,789442326700,789469149600,26822900,-1
353,1,STEP,789469204000,789496714400,27510400,-1
354,1,STEP,789496812500,789523624500,26812000,-1
355,1,STEP,789523675700,789551417800,27742100,-1
356,1,STEP,789551485900,789577989400,26503500,-1
357,1,STEP,789578072300,789604765900,26693600,-1
358,1,STEP,789604828000,789631895600,27067600,-1
359,1,STEP,789631952200,789659344700,27392500,-1
360,1,STEP,789659396700,789686246900,26850200,-1
361,1,STEP,789686325400,789713262900,26937500,-1
362,1,STEP,789713317000,789739903800,26586800,-1
363,1,STEP,789739965700,789770717000,30751300,-1
364,1,STEP,789770762800,789801177200,30414400,-1
365,1,STEP,789801229800,789831057700,29827900,-1
366,1,STEP,789831116500,789861885900,30769400,-1
367,1,STEP,789861936000,789891878600,29942600,-1
368,1,STEP,789891930200,789921914000,29983800,-1
369,1,STEP,789922046300,789951290900,29244600,-1
370,1,STEP,789951338100,789980926700,29588600,-1
371,1,STEP,789980980400,790010898800,29918400,-1
372,1,STEP,790010963400,790041173900,30210500,-1
373,1,STEP,790041225700,790071402300,30176600,-1
374,1,STEP,790071459900,790101897400,30437500,-1
375,1,STEP,790101953700,790131935000,29981300,-1
376,1,STEP,790131990600,790161649600,29659000,-1
377,1,STEP,790161719800,790190491600,28771800,-1
378,1,STEP,790190545300,790219374200,28828900,-1
379,1,STEP,790219429300,790246688400,27259100,-1
380,1,STEP,790246744600,790275492200,28747600,-1
381,1,STEP,790275552100,790304115800,28563700,-1
382,1,STEP,790304174500,790331971700,27797200,-1
383,1,STEP,790332022400,790361118600,29096200,-1
384,1,STEP,790361169600,790389808400,28638800,-1
385,1,STEP,790389862800,790418556000,28693200,-1
386,1,STEP,790418605400,790447242400,28637000,-1
387,1,STEP,790447296200,790474883300,27587100,-1
388,1,STEP,790474943100,790503939300,28996200,-1
389,1,STEP,790503996700,790533106600,29109900,-1
390,1,STEP,790533164400,790562331800,29167400,-1
391,1,STEP,790562387700,790590247200,27859500,-1
392,1,STEP,790590302800,790619076500,28773700,-1
393,1,STEP,790619129200,790647291400,28162200,-1
394,1,STEP,790647345600,790676015000,28669400,-1
395,1,STEP,790676065500,790704942400,28876900,-1
396,1,STEP,790705003500,790734313400,29309900,-1
397,1,STEP,790734366000,790762722600,28356600,-1
398,1,STEP,790762813200,790791301200,28488000,-1
399,1,STEP,790791354600,790820174700,28820100,-1
400,1,STEP,790820231200,790849717100,29485900,-1
401,1,STEP,790849776800,790877859400,28082600,-1
402,1,STEP,790877925300,790905632100,27706800,-1
403,1,STEP,790905707100,790933444100,27737000,-1
404,1,STEP,790933504700,790962047600,28542900,-1
405,1,STEP,790962104100,790991138100,29034000,-1
406,1,STEP,790991205700,791019776600,28570900,-1
407,1,STEP,791019834200,791048952500,29118300,-1
408,1,STEP,791049008900,791076858400,27849500,-1
409,1,STEP,791076907800,791105225000,28317200,-1
410,1,STEP,791105280100,791133227600,27947500,-1
411,1,STEP,791133292400,791161800000,28507600,-1
412,1,STEP,791161854000,791189973900,28119900,-1
413,1,STEP,791190025600,791218857500,28831900,-1
414,1,STEP,791218911400,791247677200,28765800,-1
415,1,STEP,791247734800,791276540500,28805700,-1
416,1,STEP,791276672600,791305191300,28518700,-1
417,1,STEP,791305281000,791333251000,27970000,-1
418,1,STEP,791333347500,791361947400,28599900,-1
419,1,STEP,791362034600,791390699400,28664800,-1
420,1,STEP,791390783600,791418345200,27561600,-1
421,1,STEP,791418433100,791447207000,28773900,-1
422,1,STEP,791447336500,791476843700,29507200,-1
423,1,STEP,791476920000,791504949000,28029000,-1
424,1,STEP,791505065600,791533427700,28362100,-1
425,1,STEP,791533511800,791562365400,28853600,-1
426,1,STEP,791562433700,791589938200,27504500,-1
427,1,STEP,791590016200,791618315800,28299600,-1
428,1,STEP,791618398700,791646196700,27798000,-1
429,1,STEP,791646256800,791674450200,28193400,-1
430,1,STEP,791674518600,791701733500,27214900,-1
431,1,STEP,791701795600,791730196600,28401000,-1
432,1,STEP,791730270400,791758214700,27944300,-1
433,1,STEP,791758275900,791786026000,27750100,-1
434,1,STEP,791786083100,791814804800,28721700,-1
435,1,STEP,791815020100,791842783700,27763600,-1
436,1,STEP,791842981200,791872084200,29103000,-1
437,1,STEP,791872151400,791901436300,29284900,-1
438,1,STEP,791901574400,791930754600,29180200,-1
439,1,STEP,791930819300,791958959800,28140500,-1
440,1,STEP,791959022900,791987109000,28086100,-1
441,1,STEP,791987180000,792015741500,28561500,-1
442,1,STEP,792015820000,792044946400,29126400,-1
443,1,STEP,792045018900,792074825600,29806700,-1
444,1,STEP,792074923500,792103232400,28308900,-1
445,1,STEP,792103304800,792132666700,29361900,-1
446,1,STEP,792132738700,792161513100,28774400,-1
447,1,STEP,792161583100,792190674200,29091100,-1
448,1,STEP,792190756300,792219639600,28883300,-1
449,1,STEP,792219714000,792248544500,28830500,-1
450,1,STEP,792248624600,792276548000,27923400,-1
451,1,STEP,792276611500,792304389500,27778000,-1
452,1,STEP,792304460200,792333020100,28559900,-1
453,1,STEP,792333089100,792361292800,28203700,-1
454,1,STEP,792361372600,792389345200,27972600,-1
455,1,STEP,792389410300,792417201000,27790700,-1
456,1,STEP,792417266000,792445043800,27777800,-1
457,1,STEP,792445109600,792473892000,28782400,-1
458,1,STEP,792473975900,792501228500,27252600,-1
459,1,STEP,792501301300,792529583100,28281800,-1
460,1,STEP,792529657600,792558551600,28894000,-1
461,1,STEP,792558634500,792587729100,29094600,-1
462,1,STEP,792587856700,792616685200,28828500,-1
463,1,STEP,792616769100,792646104300,29335200,-1
464,1,STEP,792646276100,792675114900,28838800,-1
465,1,STEP,792675270300,792703573500,28303200,-1
466,1,STEP,792703660900,792732463600,28802700,-1
467,1,STEP,792732538200,792760012800,27474600,-1
468,1,STEP,792760104400,792788982000,28877600,-1
469,1,STEP,792789042500,792817742300,28699800,-1
470,1,STEP,792817892800,792846102300,28209500,-1
471,1,STEP,792846168400,792873802900,27634500,-1
472,1,STEP,792873869700,792902305300,28435600,-1
473,1,STEP,792902413300,792931604600,29191300,-1
474,1,STEP,792931685100,792960613700,28928600,-1
475,1,STEP,792960682800,792989632100,28949300,-1
476,1,STEP,792989764900,793018977600,29212700,-1
477,1,STEP,793019075300,793048329800,29254500,-1
478,1,STEP,793048391600,793076310800,27919200,-1
479,1,STEP,793076398700,793105571800,29173100,-1
480,1,STEP,793105636600,793134463500,28826900,-1
481,1,STEP,793134525200,793164133300,29608100,-1
482,1,STEP,793164220100,793192511400,28291300,-1
483,1,STEP,793192581100,793221191300,28610200,-1
484,1,STEP,793221253100,793249924300,28671200,-1
485,1,STEP,793250103500,793278920000,28816500,-1
486,1,STEP,793278990100,793307587700,28597600,-1
487,1,STEP,793307653400,793335754700,28101300,-1
488,1,STEP,793335982400,793366304500,30322100,-1
489,1,STEP,793366370300,793395886100,29515800,-1
490,1,STEP,793395949600,793425081200,29131600,-1
491,1,STEP,793425156100,793453646700,28490600,-1
492,1,STEP,793453723600,793482122100,28398500,-1
493,1,STEP,793482189300,793510653300,28464000,-1
494,1,STEP,793510763000,793539166100,28403100,-1
495,1,STEP,793539229500,793567412400,28182900,-1
496,1,STEP,793567501600,793596391500,28889900,-1
497,1,STEP,793596455100,793624563200,28108100,-1
498,1,STEP,793624621500,793652273400,27651900,-1
499,1,STEP,793652330800,793680528100,28197300,-1
500,1,STEP,793680585800,793709255800,28670000,-1
501,1,STEP,793709310300,793737911800,28601500,-1
502,1,STEP,793737983300,793765361400,27378100,-1
503,1,STEP,793765426400,793794057100,28630700,-1
504,1,STEP,793794113900,793821627400,27513500,-1
505,1,STEP,793821683900,793850629200,28945300,-1
506,1,STEP,793850688000,793879793700,29105700,-1
507,1,STEP,793879849100,793907447600,27598500,-1
508,1,STEP,793907503800,793934843900,27340100,-1
509,1,STEP,793934900200,793962926300,28026100,-1
510,1,STEP,793962991900,793992019000,29027100,-1
511,1,STEP,793992081000,794020616700,28535700,-1
512,1,STEP,794020682900,794048581900,27899000,-1
513,1,STEP,794048637500,794076243400,27605900,-1
514,1,STEP,794076299300,794105642600,29343300,-1
515,1,STEP,794105701100,794134555800,28854700,-1
516,1,STEP,794134641300,794163362700,28721400,-1
517,1,STEP,794163426200,794191775000,28348800,-1
518,1,STEP,794191838300,794219820700,27982400,-1
519,1,STEP,794219882800,794247483400,27600600,-1
520,1,STEP,794247549100,794275726000,28176900,-1
521,1,STEP,794275781800,794303903000,28121200,-1
522,1,STEP,794303950600,794332745000,28794400,-1
523,1,STEP,794332797100,794360922800,28125700,-1
524,1,STEP,794360975900,794389313400,28337500,-1
525,1,STEP,794389359000,794418352500,28993500,-1
526,1,STEP,794418408800,794446135200,27726400,-1
527,1,STEP,794446197200,794474379700,28182500,-1
528,1,STEP,794474428400,794502188400,27760000,-1
529,1,STEP,794502245800,794530196300,27950500,-1
530,1,STEP,794530257200,794558460100,28202900,-1
531,1,STEP,794558562600,794587117400,28554800,-1
532,1,STEP,794587189700,794615982500,28792800,-1
533,1,STEP,794616046600,794643769200,27722600,-1
534,1,STEP,794643829500,794671149400,27319900,-1
535,1,STEP,794671210500,794699185900,27975400,-1
536,1,STEP,794699240900,794728477200,29236300,-1
537,1,STEP,794728570900,794756035200,27464300,-1
538,1,STEP,794756091200,794784916900,28825700,-1
539,1,STEP,794784973800,794813151700,28177900,-1
540,1,STEP,794813209900,794842355100,29145200,-1
541,1,STEP,794842416200,794870204200,27788000,-1
542,1,STEP,794870262900,794899043800,28780900,-1
543,1,STEP,794899096700,794927858300,28761600,-1
544,1,STEP,794927913900,794956119700,28205800,-1
545,1,STEP,794956187700,794984371000,28183300,-1
546,1,STEP,794984434500,795013154900,28720400,-1
547,1,STEP,795013244600,795042905700,29661100,-1
548,1,STEP,795042961500,795070790600,27829100,-1
549,1,STEP,795070846300,795099364100,28517800,-1
550,1,STEP,795099439800,795128026400,28586600,-1
551,1,STEP,795128116800,795156628500,28511700,-1
552,1,STEP,795156687800,795185009000,28321200,-1
553,1,STEP,795185068200,795213074700,28006500,-1
554,1,STEP,795213129200,795241507000,28377800,-1
555,1,STEP,795241562000,795269512500,27950500,-1
556,1,STEP,795269570200,795297807400,28237200,-1
557,1,STEP,795297862300,795326421800,28559500,-1
558,1,STEP,795326478000,795354671300,28193300,-1
559,1,STEP,795354725500,795382511200,27785700,-1
560,1,STEP,795382565400,795411110700,28545300,-1
561,1,STEP,795411158400,795439394600,28236200,-1
562,1,STEP,795439440100,795467759900,28319800,-1
563,1,STEP,795467807600,795495936900,28129300,-1
564,1,STEP,795495992300,795524431700,28439400,-1
565,1,STEP,795524476700,795551805200,27328500,-1
566,1,STEP,795551859800,795579079700,27219900,-1
567,1,STEP,795579128500,795608685100,29556600,-1
568,1,STEP,795608734500,795637831400,29096900,-1
569,1,STEP,795637875200,795666667300,28792100,-1
570,1,STEP,795666712000,795695419300,28707300,-1
571,1,STEP,795695485400,795724053900,28568500,-1
572,1,STEP,795724098700,795752230700,28132000,-1
573,1,STEP,795752276900,795781029500,28752600,-1
574,1,STEP,795781105800,795808774600,27668800,-1
575,1,STEP,795808825700,795836890600,28064900,-1
576,1,STEP,795836956000,795865814300,28858300,-1
577,1,STEP,795865869800,795893326500,27456700,-1
578,1,STEP,795893384900,795922186300,28801400,-1
579,1,STEP,795922237100,795951382900,29145800,-1
580,1,STEP,795951429600,795980299800,28870200,-1
581,1,STEP,795980350400,796008187500,27837100,-1
582,1,STEP,796008234800,796036638400,28403600,-1
583,1,STEP,796036690700,796065213800,28523100,-1
584,1,STEP,796065256600,796093266400,28009800,-1
585,1,STEP,796093334800,796120704400,27369600,-1
586,1,STEP,796120763900,796149935900,29172000,-1
587,1,STEP,796150014600,796177979400,27964800,-1
588,1,STEP,796178035100,796206286900,28251800,-1
589,1,STEP,796206353000,796233939300,27586300,-1
590,1,STEP,796233985300,796263460800,29475500,-1
591,1,STEP,796263506900,796290971300,27464400,-1
592,1,STEP,796291035500,796319550700,28515200,-1
593,1,STEP,796319601800,796348168400,28566600,-1
594,1,STEP,796348217400,796377086700,28869300,-1
595,1,STEP,796377134000,796405080300,27946300,-1
596,1,STEP,796405125500,796434727300,29601800,-1
597,1,STEP,796434783400,796463335700,28552300,-1
598,1,STEP,796463378600,796490994000,27615400,-1
599,1,STEP,796491047100,796519246800,28199700,-1
600,1,STEP,796519302900,796547417900,28115000,-1
601,1,STEP,796547464800,796576038000,28573200,-1
602,1,STEP,796576089800,796604920800,28831000,-1
603,1,STEP,796604965000,796633227100,28262100,-1
604,1,STEP,796633282300,796661531100,28248800,-1
605,1,STEP,796661580400,796689112300,27531900,-1
606,1,STEP,796689152000,796718201100,29049100,-1
607,1,STEP,796718253200,796746535600,28282400,-1
608,1,STEP,796746581800,796773889400,27307600,-1
609,1,STEP,796773943100,796801668500,27725400,-1
610,1,STEP,796801724200,796829232200,27508000,-1
611,1,STEP,796829280000,796857437800,28157800,-1
612,1,STEP,796857486600,796886198400,28711800,-1
613,1,STEP,796886246400,796914607500,28361100,-1
614,1,STEP,796914663600,796943128200,28464600,-1
615,1,STEP,796943182800,796971202800,28020000,-1
616,1,STEP,796971256600,797000382400,29125800,-1
617,1,STEP,797000431300,797028772100,28340800,-1
618,1,STEP,797028820600,797057636000,28815400,-1
619,1,STEP,797057684800,797087202800,29518000,-1
620,1,STEP,797087246900,797115719000,28472100,-1
621,1,STEP,797115764900,797145495000,29730100,-1
622,1,STEP,797145542800,797173872100,28329300,-1
623,1,STEP,797173927500,797202712000,28784500,-1
624,1,STEP,797202763800,797230785500,28021700,-1
625,1,STEP,797230834100,797258864800,28030700,-1
626,1,STEP,797258918000,797287156200,28238200,-1
627,1,STEP,797287199900,797315686900,28487000,-1
628,1,STEP,797315742000,797343915900,28173900,-1
629,1,STEP,797343969100,797373331500,29362400,-1
630,1,STEP,797373378800,797401456100,28077300,-1
631,1,STEP,797401505000,797430243900,28738900,-1
632,1,STEP,797430303100,797459756200,29453100,-1
633,1,STEP,797459809400,797488213200,28403800,-1
634,1,STEP,797488264500,797515751700,27487200,-1
635,1,STEP,797515796700,797543533200,27736500,-1
636,1,STEP,797543591900,797571154200,27562300,-1
637,1,STEP,797571209400,797599305600,28096200,-1
638,1,STEP,797599359300,797627952500,28593200,-1
639,1,STEP,797628040700,797656638600,28597900,-1
640,1,STEP,797656699200,797686069900,29370700,-1
641,1,STEP,797686128400,797715000100,28871700,-1
642,1,STEP,797715052600,797743644500,28591900,-1
643,1,STEP,797743692300,797771748300,28056000,-1
644,1,STEP,797771806200,797800460900,28654700,-1
645,1,STEP,797800536400,797829399300,28862900,-1
646,1,STEP,797829467900,797857385800,27917900,-1
647,1,STEP,797857444700,797886408800,28964100,-1
648,1,STEP,797886458600,797914799400,28340800,-1
649,1,STEP,797914887000,797943325300,28438300,-1
650,1,STEP,797943391800,797971436900,28045100,-1
651,1,STEP,797971500400,797999626200,28125800,-1
652,1,STEP,797999676900,798028210600,28533700,-1
653,1,STEP,798028275300,798057429500,29154200,-1
654,1,STEP,798057477700,798085553300,28075600,-1
655,1,STEP,798085604100,798114343200,28739100,-1
656,1,STEP,798114396100,798143537200,29141100,-1
657,1,STEP,798143599100,798172567600,28968500,-1
658,1,STEP,798172621700,798201610500,28988800,-1
659,1,STEP,798201662600,798229555900,27893300,-1
660,1,STEP,798229612500,798258566800,28954300,-1
661,1,STEP,798258619000,798286060400,27441400,-1
662,1,STEP,798286115600,798314348900,28233300,-1
663,1,STEP,798314396200,798343082400,28686200,-1
664,1,STEP,798343139500,798372574200,29434700,-1
665,1,STEP,798372624600,798401294500,28669900,-1
666,1,STEP,798401348200,798430813500,29465300,-1
667,1,STEP,798430865500,798459608500,28743000,-1
668,1,STEP,798459653300,798488098500,28445200,-1
669,1,STEP,798488164300,798516066700,27902400,-1
670,1,STEP,798516111200,798544530300,28419100,-1
671,1,STEP,798544584400,798572439900,27855500,-1
672,1,STEP,798572492900,798601373000,28880100,-1
673,1,STEP,798601424300,798630291300,28867000,-1
674,1,STEP,798630343100,798659775800,29432700,-1
675,1,STEP,798659826700,798687674000,27847300,-1
676,1,STEP,798687717300,798716298900,28581600,-1
677,1,STEP,798716347600,798744779300,28431700,-1
678,1,STEP,798744835500,798773452000,28616500,-1
679,1,STEP,798773499800,798802688000,29188200,-1
680,1,STEP,798802739800,798831585400,28845600,-1
681,1,STEP,798831634500,798859950900,28316400,-1
682,1,STEP,798860005400,798888766500,28761100,-1
683,1,STEP,798888806500,798916892900,28086400,-1
684,1,STEP,798916940300,798944968300,28028000,-1
685,1,STEP,798945020900,798972676200,27655300,-1
686,1,STEP,798972716400,799002059400,29343000,-1
687,1,STEP,799002103600,799030420000,28316400,-1
688,1,STEP,799030480000,799058527500,28047500,-1
689,1,STEP,799058581200,799087642900,29061700,-1
690,1,STEP,799087694600,799116235400,28540800,-1
691,1,STEP,799116286800,799145178200,28891400,-1
692,1,STEP,799145223200,799173686400,28463200,-1
693,1,STEP,799173723600,799202833600,29110000,-1
694,1,STEP,799202886800,799231700800,28814000,-1
695,1,STEP,799231757700,799260302900,28545200,-1
696,1,STEP,799260352500,799288571600,28219100,-1
697,1,STEP,799288629700,799316134500,27504800,-1
698,1,STEP,799316189900,799345363500,29173600,-1
699,1,STEP,799345409300,799373185000,27775700,-1
700,1,STEP,799373236200,799401890900,28654700,-1
701,1,STEP,799401938700,799431323400,29384700,-1
702,1,STEP,799431377100,799459683200,28306100,-1
703,1,STEP,799459731100,799487770600,28039500,-1
704,1,STEP,799487817100,799517180200,29363100,-1
705,1,STEP,799517228200,799546115100,28886900,-1
706,1,STEP,799546167000,799575961000,29794000,-1
707,1,STEP,799576012800,799604528500,28515700,-1
708,1,STEP,799604574600,799632174400,27599800,-1
709,1,STEP,799632223100,799660833000,28609900,-1
710,1,STEP,799660880600,799689927100,29046500,-1
711,1,STEP,799689966500,799717778400,27811900,-1
712,1,STEP,799717830500,799745860800,28030300,-1
713,1,STEP,799745909600,799774423400,28513800,-1
714,1,STEP,799774473000,799802573700,28100700,-1
715,1,STEP,799802621100,799830845900,28224800,-1
716,1,STEP,799830894100,799859238600,28344500,-1
717,1,STEP,799859287800,799888248300,28960500,-1
718,1,STEP,799888287500,799917623900,29336400,-1
719,1,STEP,799917668300,799946169100,28500800,-1
720,1,STEP,799946256700,799974612300,28355600,-1
721,1,STEP,799974664700,800002917000,28252300,-1
722,1,STEP,800002958100,800031791500,28833400,-1
723,1,STEP,800031850300,800060851800,29001500,-1
724,1,STEP,800060904200,800090155200,29251000,-1
725,1,STEP,800090210000,800118331000,28121000,-1
726,1,STEP,800118382500,800146401700,28019200,-1
727,1,STEP,800146459500,800176229900,29770400,-1
728,1,STEP,800176283700,800205315300,29031600,-1
729,1,STEP,800205367100,800233309800,27942700,-1
730,1,STEP,800233372900,800262277500,28904600,-1
731,1,STEP,800262331600,800290310800,27979200,-1
732,1,STEP,800290365700,800318621100,28255400,-1
733,1,STEP,800318690200,800347606900,28916700,-1
734,1,STEP,800347679900,800375250000,27570100,-1
735,1,STEP,800375312600,800403273300,27960700,-1
736,1,STEP,800403337700,800431346900,28009200,-1
737,1,STEP,800431396800,800460781100,29384300,-1
738,1,STEP,800460848100,800488752100,27904000,-1
739,1,STEP,800488799000,800517549200,28750200,-1
740,1,STEP,800517601400,800545886100,28284700,-1
741,1,STEP,800545926500,800573697600,27771100,-1
742,1,STEP,800573752300,800603122900,29370600,-1
743,1,STEP,800603173800,800630271400,27097600,-1
744,1,STEP,800630320200,800658991600,28671400,-1
745,1,STEP,800659041900,800687918400,28876500,-1
746,1,STEP,800687968600,800716999500,29030900,-1
747,1,STEP,800717058200,800744903100,27844900,-1
748,1,STEP,800744942600,800772795200,27852600,-1
749,1,STEP,800772856200,800801191900,28335700,-1
750,1,STEP,800801240800,800829781900,28541100,-1
751,1,STEP,800829835800,800858348900,28513100,-1
752,1,STEP,800858414700,800886560400,28145700,-1
753,1,STEP,800886607300,800916434400,29827100,-1
754,1,STEP,800916477700,800944638400,28160700,-1
755,1,STEP,800944687200,800972519800,27832600,-1
756,1,STEP,800972561100,801002623200,30062100,-1
757,1,STEP,801002678300,801030899600,28221300,-1
758,1,STEP,801030943100,801059020100,28077000,-1
759,1,STEP,801059070200,801087044200,27974000,-1
760,1,STEP,801087087300,801114697800,27610500,-1
761,1,STEP,801114753700,801143298700,28545000,-1
762,1,STEP,801143351500,801171924100,28572600,-1
763,1,STEP,801171979700,801200540800,28561100,-1
764,1,STEP,801200612900,801228647100,28034200,-1
765,1,STEP,801228688600,801256863500,28174900,-1
766,1,STEP,801256924600,801285344100,28419500,-1
767,1,STEP,801285389500,801314205500,28816000,-1
768,1,STEP,801314258000,801342150400,27892400,-1
769,1,STEP,801342204500,801371146000,28941500,-1
770,1,STEP,801371212200,801399675800,28463600,-1
771,1,STEP,801399737000,801428620800,28883800,-1
772,1,STEP,801428687100,801457482000,28794900,-1
773,1,STEP,801457536200,801486919300,29383100,-1
774,1,STEP,801486963300,801515079500,28116200,-1
775,1,STEP,801515132800,801544152100,29019300,-1
776,1,STEP,801544194100,801572491500,28297400,-1
777,1,STEP,801572538800,801601054600,28515800,-1
778,1,STEP,801601106700,801630062900,28956200,-1
779,1,STEP,801630105300,801658941300,28836000,-1
780,1,STEP,801659007600,801687840200,28832600,-1
781,1,STEP,801687894200,801716848000,28953800,-1
782,1,STEP,801716898700,801745549200,28650500,-1
783,1,STEP,801745598500,801774465500,28867000,-1
784,1,STEP,801774508400,801802877000,28368600,-1
785,1,STEP,801802922500,801832685300,29762800,-1
786,1,STEP,801832742800,801860359600,27616800,-1
787,1,STEP,801860413200,801889549800,29136600,-1
788,1,STEP,801889599400,801918244700,28645300,-1
789,1,STEP,801918291300,801946640200,28348900,-1
790,1,STEP,801946690500,801974841700,28151200,-1
791,1,STEP,801974883600,802003475900,28592300,-1
792,1,STEP,802003528800,802031163500,27634700,-1
793,1,STEP,802031205500,802058868700,27663200,-1
794,1,STEP,802058917900,802087353400,28435500,-1
795,1,STEP,802087412800,802116253000,28840200,-1
796,1,STEP,802116305400,802144705900,28400500,-1
797,1,STEP,802144755600,802172796800,28041200,-1
798,1,STEP,802172843200,802200623000,27779800,-1
799,1,STEP,802200675300,802228593800,27918500,-1
800,1,STEP,802228646800,802257662200,29015400,-1
801,1,STEP,802257721100,802287365700,29644600,-1
802,1,STEP,802287414900,802315616300,28201400,-1
803,1,STEP,802315664700,802344384500,28719800,-1
804,1,STEP,802344438600,802373272800,28834200,-1
805,1,STEP,802373330500,802401326600,27996100,-1
806,1,STEP,802401379200,802428987400,27608200,-1
807,1,STEP,802429037100,802458057700,29020600,-1
808,1,STEP,802458116700,802486751400,28634700,-1
809,1,STEP,802486805300,802514852200,28046900,-1
810,1,STEP,802514900600,802543674000,28773400,-1
811,1,STEP,802543730800,802572151700,28420900,-1
812,1,STEP,802572208200,802601039200,28831000,-1
813,1,STEP,802601097100,802630146500,29049400,-1
814,1,STEP,802630196300,802659189400,28993100,-1
815,1,STEP,802659353500,802687470100,28116600,-1
816,1,STEP,802687527600,802715776300,28248700,-1
817,1,STEP,802715824000,802745180600,29356600,-1
818,1,STEP,802745223500,802773827800,28604300,-1
819,1,STEP,802773880100,802802624200,28744100,-1
820,1,STEP,802802664800,802830335600,27670800,-1
821,1,STEP,802830387100,802859189100,28802000,-1
822,1,STEP,802859254100,802888293700,29039600,-1
823,1,STEP,802888344800,802917109300,28764500,-1
824,1,STEP,802917158000,802946093100,28935100,-1
825,1,STEP,802946147200,802974301300,28154100,-1
826,1,STEP,802974347200,803003882300,29535100,-1
827,1,STEP,803003933700,803032613900,28680200,-1
828,1,STEP,803032663700,803061858500,29194800,-1
829,1,STEP,803061903700,803090844200,28940500,-1
830,1,STEP,803090928400,803119937400,29009000,-1
831,1,STEP,803120029900,803148162400,28132500,-1
832,1,STEP,803148234600,803175960900,27726300,-1
833,1,STEP,803176039100,803204199800,28160700,-1
834,1,STEP,803204259300,803231962800,27703500,-1
835,1,STEP,803232024000,803261673900,29649900,-1
836,1,STEP,803261779200,803290553500,28774300,-1
837,1,STEP,803290728900,803318552300,27823400,-1
838,1,STEP,803318620800,803348383700,29762900,-1
839,1,STEP,803348534300,803376901600,28367300,-1
840,1,STEP,803376984300,803405839900,28855600,-1
841,1,STEP,803405919100,803434654000,28734900,-1
842,1,STEP,803434752900,803463650100,28897200,-1
843,1,STEP,803463754500,803493171600,29417100,-1
844,1,STEP,803493254700,803521168800,27914100,-1
845,1,STEP,803521247700,803550318800,29071100,-1
846,1,STEP,803550412000,803579829200,29417200,-1
847,1,STEP,803579918500,803608746800,28828300,-1
848,1,STEP,803608829100,803636327900,27498800,-1
849,1,STEP,803636467100,803665557300,29090200,-1
850,1,STEP,803665644400,803693877700,28233300,-1
851,1,STEP,803693952400,803722184000,28231600,-1
852,1,STEP,803722247500,803751007300,28759800,-1
853,1,STEP,803751106600,803779280200,28173600,-1
854,1,STEP,803779345400,803809554600,30209200,-1
855,1,STEP,803809615700,803838095300,28479600,-1
856,1,STEP,803838174500,803867161000,28986500,-1
857,1,STEP,803867294300,803895080200,27785900,-1
858,1,STEP,803895139800,803922635300,27495500,-1
859,1,STEP,803922730300,803950766100,28035800,-1
860,1,STEP,803950886700,803978696500,27809800,-1
861,1,STEP,803978764000,804008997800,30233800,-1
862,1,STEP,804009065500,804036953600,27888100,-1
863,1,STEP,804037045200,804066096200,29051000,-1
864,1,STEP,804066194500,804094323500,28129000,-1
865,1,STEP,804094395500,804122077600,27682100,-1
866,1,STEP,804122212400,804150439400,28227000,-1
867,1,STEP,804150522800,804178241800,27719000,-1
868,1,STEP,804178354500,804206218600,27864100,-1
869,1,STEP,804206283100,804235802300,29519200,-1
870,1,STEP,804235869000,804264614000,28745000,-1
871,1,STEP,804264697800,804294902800,30205000,-1
872,1,STEP,804294968100,804324811800,29843700,-1
873,1,STEP,804324925400,804354209400,29284000,-1
874,1,STEP,804354291500,804381596600,27305100,-1
875,1,STEP,804381672900,804409030800,27357900,-1
876,1,STEP,804409146300,804437709300,28563000,-1
877,1,STEP,804437790000,804466339500,28549500,-1
878,1,STEP,804466412000,804494707000,28295000,-1
879,1,STEP,804494772900,804524107400,29334500,-1
880,1,STEP,804524181900,804552990000,28808100,-1
881,1,STEP,804553100900,804581805100,28704200,-1
882,1,STEP,804581930600,804610963500,29032900,-1
883,1,STEP,804611038100,804640187500,29149400,-1
884,1,STEP,804640259500,804668116000,27856500,-1
885,1,STEP,804668212100,804696758100,28546000,-1
886,1,STEP,804696823700,804726255900,29432200,-1
887,1,STEP,804726337900,804754389100,28051200,-1
888,1,STEP,804754487700,804782888300,28400600,-1
889,1,STEP,804782943900,804811884100,28940200,-1
890,1,STEP,804811937500,804840618400,28680900,-1
891,1,STEP,804840698100,804869741600,29043500,-1
892,1,STEP,804869830600,804898687400,28856800,-1
893,1,STEP,804898835300,804927191500,28356200,-1
894,1,STEP,804927282800,804955563400,28280600,-1
895,1,STEP,804955625300,804983645500,28020200,-1
896,1,STEP,804983711800,805013031800,29320000,-1
897,1,STEP,805013108100,805042623400,29515300,-1
898,1,STEP,805042703700,805071061100,28357400,-1
899,1,STEP,805071154300,805100181400,29027100,-1
900,1,STEP,805100251000,805129114400,28863400,-1
901,1,STEP,805129196200,805158003100,28806900,-1
902,1,STEP,805158068100,805187334900,29266800,-1
903,1,STEP,805187491100,805216061500,28570400,-1
904,1,STEP,805216147400,805244730600,28583200,-1
905,1,STEP,805244814800,805273795500,28980700,-1
906,1,STEP,805273868500,805302771100,28902600,-1
907,1,STEP,805302927500,805331959000,29031500,-1
908,1,STEP,805332020800,805360119100,28098300,-1
909,1,STEP,805360254100,805388763400,28509300,-1
910,1,STEP,805388828300,805417431500,28603200,-1
911,1,STEP,805417501500,805446515800,29014300,-1
912,1,STEP,805446608200,805474881500,28273300,-1
913,1,STEP,805475049500,805504116800,29067300,-1
914,1,STEP,805504210800,805532808800,28598000,-1
915,1,STEP,805532918600,805561584500,28665900,-1
916,1,STEP,805561664100,805590823200,29159100,-1
917,1,STEP,805590940200,805619152300,28212100,-1
918,1,STEP,805619251400,805648889600,29638200,-1
919,1,STEP,805648983300,805677672300,28689000,-1
920,1,STEP,805677747000,805706484700,28737700,-1
921,1,STEP,805706558600,805735308100,28749500,-1
922,1,STEP,805735396500,805763690000,28293500,-1
923,1,STEP,805763774000,805793378300,29604300,-1
924,1,STEP,805793435200,805822531200,29096000,-1
925,1,STEP,805822625100,805851513800,28888700,-1
926,1,STEP,805851581000,805880439300,28858300,-1
927,1,STEP,805880504200,805910142200,29638000,-1
928,1,STEP,805910209500,805938451600,28242100,-1
929,1,STEP,805938551100,805966932400,28381300,-1
930,1,STEP,805966999400,805995400300,28400900,-1
931,1,STEP,805995485600,806023725500,28239900,-1
932,1,STEP,806023793400,806051999600,28206200,-1
933,1,STEP,806052069900,806080204900,28135000,-1
934,1,STEP,806080280300,806108325300,28045000,-1
935,1,STEP,806108398500,806135944500,27546000,-1
936,1,STEP,806136076500,806164568500,28492000,-1
937,1,STEP,806164689700,806193092900,28403200,-1
938,1,STEP,806193216700,806221265700,28049000,-1
939,1,STEP,806221380300,806249079800,27699500,-1
940,1,STEP,806249138200,806277949400,28811200,-1
941,1,STEP,806278015700,806305682500,27666800,-1
942,1,STEP,806305807300,806333370500,27563200,-1
943,1,STEP,806333471000,806361756100,28285100,-1
944,1,STEP,806361872800,806390953000,29080200,-1
945,1,STEP,806391035600,806419322700,28287100,-1
946,1,STEP,806419401100,806447196400,27795300,-1
947,1,STEP,806447299300,806475453000,28153700,-1
948,1,STEP,806475532500,806503439500,27907000,-1
949,1,STEP,806503512100,806532735200,29223100,-1
950,1,STEP,806532813400,806562170900,29357500,-1
951,1,STEP,806562234800,806589362600,27127800,-1
952,1,STEP,806589471500,806617327100,27855600,-1
953,1,STEP,806617403200,806645373800,27970600,-1
954,1,STEP,806645438200,806673599200,28161000,-1
955,1,STEP,806673652500,806701189300,27536800,-1
956,1,STEP,806701243200,806729219100,27975900,-1
957,1,STEP,806729270900,806757524800,28253900,-1
958,1,STEP,806757585700,806785192000,27606300,-1
959,1,STEP,806785246300,806814330000,29083700,-1
960,1,STEP,806814395400,806842490000,28094600,-1
961,1,STEP,806842541300,806870514800,27973500,-1
962,1,STEP,806870564800,806899011600,28446800,-1
963,1,STEP,806899056200,806926905600,27849400,-1
964,1,STEP,806926958600,806955624900,28666300,-1
965,1,STEP,806955675700,806984799600,29123900,-1
966,1,STEP,806984851600,807012654700,27803100,-1
967,1,STEP,807012788800,807042426600,29637800,-1
968,1,STEP,807042501900,807070917200,28415300,-1
969,1,STEP,807071009200,807100362200,29353000,-1
970,1,STEP,807100432100,807129296900,28864800,-1
971,1,STEP,807129401300,807157432100,28030800,-1
972,1,STEP,807157502600,807186363100,28860500,-1
973,1,STEP,807186429900,807215994100,29564200,-1
974,1,STEP,807216059200,807245443900,29384700,-1
975,1,STEP,807245526500,807273841400,28314900,-1
976,1,STEP,807273918100,807303196700,29278600,-1
977,1,STEP,807303265300,807333390200,30124900,-1
978,1,STEP,807333461000,807362499200,29038200,-1
979,1,STEP,807362568400,807390194600,27626200,-1
980,1,STEP,807390260000,807419697300,29437300,-1
981,1,STEP,807419775100,807448795800,29020700,-1
982,1,STEP,807448966600,807477905800,28939200,-1
983,1,STEP,807477982200,807506309500,28327300,-1
984,1,STEP,807506365800,807536029400,29663600,-1
985,1,STEP,807536101500,807565154500,29053000,-1
986,1,STEP,807565301600,807594540600,29239000,-1
987,1,STEP,807594633700,807622946900,28313200,-1
988,1,STEP,807623044100,807652738000,29693900,-1
989,1,STEP,807652807500,807680512800,27705300,-1
990,1,STEP,807680582400,807709573500,28991100,-1
991,1,STEP,807709642600,807738316900,28674300,-1
992,1,STEP,807738449500,807767043100,28593600,-1
993,1,STEP,807767112200,807796420400,29308200,-1
994,1,STEP,807796518700,807824371600,27852900,-1
995,1,STEP,807824478500,807853782900,29304400,-1
996,1,STEP,807853859700,807882387500,28527800,-1
997,1,STEP,807882469600,807911888300,29418700,-1
998,1,STEP,807911965700,807939472300,27506600,-1
999,1,STEP,807939555500,807968612700,29057200,-1
