Gen,Resource,Stamp,TimeStamp_Start,TimeStamp_End,Duration,Indiv_id
0,1,TransfertToDevice,709238680600,709580131300,341450700,-1
0,1,STEP,709716025700,709734459800,18434100,-1
1,1,STEP,709734542200,709751450600,16908400,-1
2,1,STEP,709751558500,709768984500,17426000,-1
3,1,STEP,709769057500,709786472800,17415300,-1
4,1,STEP,709786565400,709803996600,17431200,-1
5,1,STEP,709804066100,709821518200,17452100,-1
6,1,STEP,709821637300,709839166400,17529100,-1
7,1,STEP,709839241700,709856128100,16886400,-1
8,1,STEP,709856212600,709871843000,15630400,-1
9,1,STEP,709871958500,709887473100,15514600,-1
10,1,STEP,709887549600,709902548200,14998600,-1
11,1,STEP,709902622400,709917857800,15235400,-1
12,1,STEP,709917994200,709933168700,15174500,-1
13,1,STEP,709933245400,709948606700,15361300,-1
14,1,STEP,709948665100,709963996300,15331200,-1
15,1,STEP,709964055100,709979131500,15076400,-1
16,1,STEP,709979191100,709994451200,15260100,-1
17,1,STEP,709994514900,710009351700,14836800,-1
18,1,STEP,710009402900,710024437300,15034400,-1
19,1,STEP,710024494100,710039590600,15096500,-1
20,1,STEP,710039666900,710054830400,15163500,-1
21,1,STEP,710054897600,710070019200,15121600,-1
22,1,STEP,710070093200,710085455300,15362100,-1
23,1,STEP,710085577200,710101853700,16276500,-1
24,1,STEP,710101951500,710118368800,16417300,-1
25,1,STEP,710118558900,710134851900,16293000,-1
26,1,STEP,710134946200,710151053100,16106900,-1
27,1,STEP,710151150500,710167030200,15879700,-1
28,1,STEP,710167185100,710183071200,15886100,-1
29,1,STEP,710183151500,710198784900,15633400,-1
30,1,STEP,710198873300,710214054500,15181200,-1
31,1,STEP,710214143600,710232620600,18477000,-1
32,1,STEP,710232747400,710248175600,15428200,-1
33,1,STEP,710248279500,710263056300,14776800,-1
34,1,STEP,710263153300,710278567500,15414200,-1
35,1,STEP,710278636500,710294517000,15880500,-1
36,1,STEP,710294633900,710310081200,15447300,-1
37,1,STEP,710310211200,710325710300,15499100,-1
38,1,STEP,710325791400,710340949000,15157600,-1
39,1,STEP,710341045400,710357144900,16099500,-1
40,1,STEP,710357223100,710372596700,15373600,-1
41,1,STEP,710372719700,710387800300,15080600,-1
42,1,STEP,710387880500,710403362900,15482400,-1
43,1,STEP,710403442900,710418906600,15463700,-1
44,1,STEP,710419008300,710434266200,15257900,-1
45,1,STEP,710434361600,710449798100,15436500,-1
46,1,STEP,710449913100,710465339700,15426600,-1
47,1,STEP,710465423000,710481160900,15737900,-1
48,1,STEP,710481313100,710497337200,16024100,-1
49,1,STEP,710497456800,710513851900,16395100,-1
50,1,STEP,710513937400,710530092200,16154800,-1
51,1,STEP,710530195700,710545983400,15787700,-1
52,1,STEP,710546073300,710561223700,15150400,-1
53,1,STEP,710561360800,710577215200,15854400,-1
54,1,STEP,710577311000,710592996400,15685400,-1
55,1,STEP,710593137400,710608966600,15829200,-1
56,1,STEP,710609051100,710625489900,16438800,-1
57,1,STEP,710625610800,710641707200,16096400,-1
58,1,STEP,710641799200,710657686200,15887000,-1
59,1,STEP,710657782900,710673714100,15931200,-1
60,1,STEP,710673796600,710690474200,16677600,-1
61,1,STEP,710690677200,710707322900,16645700,-1
62,1,STEP,710707528600,710724572500,17043900,-1
63,1,STEP,710724687700,710741861500,17173800,-1
64,1,STEP,710742023000,710758805500,16782500,-1
65,1,STEP,710758894500,710776079600,17185100,-1
66,1,STEP,710776207700,710794017100,17809400,-1
67,1,STEP,710794098100,710810975500,16877400,-1
68,1,STEP,710811073100,710828768400,17695300,-1
69,1,STEP,710828838400,710845763200,16924800,-1
70,1,STEP,710845911000,710864161900,18250900,-1
71,1,STEP,710864252900,710882320300,18067400,-1
72,1,STEP,710882536000,710900730800,18194800,-1
73,1,STEP,710900815900,710918259700,17443800,-1
74,1,STEP,710918360500,710936467200,18106700,-1
75,1,STEP,710936544600,710954075000,17530400,-1
76,1,STEP,710954177200,710972195200,18018000,-1
77,1,STEP,710972277500,710990511700,18234200,-1
78,1,STEP,710990584300,711008619800,18035500,-1
79,1,STEP,711008693600,711026200000,17506400,-1
80,1,STEP,711026282100,711043883500,17601400,-1
81,1,STEP,711043948900,711062105300,18156400,-1
82,1,STEP,711062245900,711080292300,18046400,-1
83,1,STEP,711080428200,711099063700,18635500,-1
84,1,STEP,711099169100,711116953800,17784700,-1
85,1,STEP,711117034400,711135321900,18287500,-1
86,1,STEP,711135400100,711153116300,17716200,-1
87,1,STEP,711153186800,711171810500,18623700,-1
88,1,STEP,711171938200,711189567500,17629300,-1
89,1,STEP,711189739200,711207476100,17736900,-1
90,1,STEP,711207561800,711226302500,18740700,-1
91,1,STEP,711226447100,711244702700,18255600,-1
92,1,STEP,711244799900,711262274200,17474300,-1
93,1,STEP,711262403100,711280190000,17786900,-1
94,1,STEP,711280264800,711298100400,17835600,-1
95,1,STEP,711298235900,711316325400,18089500,-1
96,1,STEP,711316525300,711333765500,17240200,-1
97,1,STEP,711333864000,711351790000,17926000,-1
98,1,STEP,711351921800,711369842000,17920200,-1
99,1,STEP,711369926500,711387430700,17504200,-1
100,1,STEP,711387516300,711405876100,18359800,-1
101,1,STEP,711405945700,711423290900,17345200,-1
102,1,STEP,711423383500,711440762600,17379100,-1
103,1,STEP,711440939400,711459007800,18068400,-1
104,1,STEP,711459145900,711476869200,17723300,-1
105,1,STEP,711476949200,711494281000,17331800,-1
106,1,STEP,711494415300,711511901500,17486200,-1
107,1,STEP,711512041800,711529152100,17110300,-1
108,1,STEP,711529238600,711546480400,17241800,-1
109,1,STEP,711546549000,711563552700,17003700,-1
110,1,STEP,711563608500,711580438400,16829900,-1
111,1,STEP,711580495300,711597441500,16946200,-1
112,1,STEP,711597497200,711615086900,17589700,-1
113,1,STEP,711615144400,711632666500,17522100,-1
114,1,STEP,711632733500,711650111500,17378000,-1
115,1,STEP,711650167500,711668225600,18058100,-1
116,1,STEP,711668286100,711686515700,18229600,-1
117,1,STEP,711686578400,711704758200,18179800,-1
118,1,STEP,711704890200,711722946400,18056200,-1
119,1,STEP,711723019800,711741302300,18282500,-1
120,1,STEP,711741359100,711759697800,18338700,-1
121,1,STEP,711759761000,711777840900,18079900,-1
122,1,STEP,711777938200,711796699300,18761100,-1
123,1,STEP,711796742200,711815244700,18502500,-1
124,1,STEP,711815307800,711833529900,18222100,-1
125,1,STEP,711833588100,711852331500,18743400,-1
126,1,STEP,711852383200,711871692700,19309500,-1
127,1,STEP,711871740400,711890219500,18479100,-1
128,1,STEP,711890264700,711908458800,18194100,-1
129,1,STEP,711908511500,711927714400,19202900,-1
130,1,STEP,711927766000,711946969500,19203500,-1
131,1,STEP,711947018600,711965562700,18544100,-1
132,1,STEP,711965605300,711984688100,19082800,-1
133,1,STEP,711984732100,712003154100,18422000,-1
134,1,STEP,712003202000,712022854700,19652700,-1
135,1,STEP,712022898400,712042854100,19955700,-1
136,1,STEP,712042910800,712064692900,21782100,-1
137,1,STEP,712064743300,712086929400,22186100,-1
138,1,STEP,712086982300,712109284100,22301800,-1
139,1,STEP,712109338800,712131773400,22434600,-1
140,1,STEP,712131826700,712154996700,23170000,-1
141,1,STEP,712155078700,712177418700,22340000,-1
142,1,STEP,712177477900,712199718100,22240200,-1
143,1,STEP,712199771500,712223135800,23364300,-1
144,1,STEP,712223202100,712245980300,22778200,-1
145,1,STEP,712246036100,712269245700,23209600,-1
146,1,STEP,712269295200,712291731800,22436600,-1
147,1,STEP,712291779600,712314749400,22969800,-1
148,1,STEP,712314828300,712338305700,23477400,-1
149,1,STEP,712338361300,712361744600,23383300,-1
150,1,STEP,712361800900,712384243700,22442800,-1
151,1,STEP,712384310400,712407421100,23110700,-1
152,1,STEP,712407477500,712430128500,22651000,-1
153,1,STEP,712430179000,712452346400,22167400,-1
154,1,STEP,712452416200,712474971500,22555300,-1
155,1,STEP,712475036000,712498184800,23148800,-1
156,1,STEP,712498239700,712519893100,21653400,-1
157,1,STEP,712519947300,712541220200,21272900,-1
158,1,STEP,712541264000,712562252900,20988900,-1
159,1,STEP,712562303500,712584002200,21698700,-1
160,1,STEP,712584047100,712603750900,19703800,-1
161,1,STEP,712603791700,712625056000,21264300,-1
162,1,STEP,712625096700,712645969500,20872800,-1
163,1,STEP,712646018700,712665086700,19068000,-1
164,1,STEP,712665132300,712683824600,18692300,-1
165,1,STEP,712683864800,712702392800,18528000,-1
166,1,STEP,712702436200,712720906900,18470700,-1
167,1,STEP,712720969400,712739339800,18370400,-1
168,1,STEP,712739405200,712758205100,18799900,-1
169,1,STEP,712758273000,712777217000,18944000,-1
170,1,STEP,712777274600,712795776600,18502000,-1
171,1,STEP,712795835200,712814853600,19018400,-1
172,1,STEP,712814913100,712833796500,18883400,-1
173,1,STEP,712833872800,712852654700,18781900,-1
174,1,STEP,712852720100,712871645500,18925400,-1
175,1,STEP,712871709400,712891066400,19357000,-1
176,1,STEP,712891122300,712910166400,19044100,-1
177,1,STEP,712910228700,712929050300,18821600,-1
178,1,STEP,712929115800,712949017500,19901700,-1
179,1,STEP,712949090300,712968217400,19127100,-1
180,1,STEP,712968289000,712987263000,18974000,-1
181,1,STEP,712987324800,713006754800,19430000,-1
182,1,STEP,713006816700,713026008200,19191500,-1
183,1,STEP,713026085100,713044971000,18885900,-1
184,1,STEP,713045043200,713064429300,19386100,-1
185,1,STEP,713064485700,713083164000,18678300,-1
186,1,STEP,713083216400,713102767700,19551300,-1
187,1,STEP,713102821000,713122044200,19223200,-1
188,1,STEP,713122118800,713140670200,18551400,-1
189,1,STEP,713140728300,713159281400,18553100,-1
190,1,STEP,713159333700,713179012000,19678300,-1
191,1,STEP,713179061900,713199515500,20453600,-1
192,1,STEP,713199563600,713220141400,20577800,-1
193,1,STEP,713220191500,713240594700,20403200,-1
194,1,STEP,713240646900,713261032800,20385900,-1
195,1,STEP,713261121900,713281489800,20367900,-1
196,1,STEP,713281547600,713301597500,20049900,-1
197,1,STEP,713301653700,713321744800,20091100,-1
198,1,STEP,713321809200,713341536700,19727500,-1
199,1,STEP,713341592300,713360622700,19030400,-1
200,1,STEP,713360675100,713380635200,19960100,-1
201,1,STEP,713380685900,713400242700,19556800,-1
202,1,STEP,713400305100,713420072600,19767500,-1
203,1,STEP,713420139000,713440258100,20119100,-1
204,1,STEP,713440319900,713459440400,19120500,-1
205,1,STEP,713459490900,713478392500,18901600,-1
206,1,STEP,713478443000,713497403100,18960100,-1
207,1,STEP,713497461500,713517312300,19850800,-1
208,1,STEP,713517361100,713537025400,19664300,-1
209,1,STEP,713537087100,713556373000,19285900,-1
210,1,STEP,713556422800,713575143200,18720400,-1
211,1,STEP,713575200600,713594582600,19382000,-1
212,1,STEP,713594636300,713614371500,19735200,-1
213,1,STEP,713614422400,713633430200,19007800,-1
214,1,STEP,713633479700,713652674800,19195100,-1
215,1,STEP,713652721200,713672478500,19757300,-1
216,1,STEP,713672527100,713692014200,19487100,-1
217,1,STEP,713692062200,713711187200,19125000,-1
218,1,STEP,713711242800,713730174300,18931500,-1
219,1,STEP,713730221500,713749067400,18845900,-1
220,1,STEP,713749141700,713768700600,19558900,-1
221,1,STEP,713768754500,713787760700,19006200,-1
222,1,STEP,713787861700,713806864500,19002800,-1
223,1,STEP,713806925900,713827033100,20107200,-1
224,1,STEP,713827096200,713846828400,19732200,-1
225,1,STEP,713846932000,713866893400,19961400,-1
226,1,STEP,713866992200,713887026800,20034600,-1
227,1,STEP,713887094800,713907067500,19972700,-1
228,1,STEP,713907157700,713926228400,19070700,-1
229,1,STEP,713926296700,713945605300,19308600,-1
230,1,STEP,713945671000,713964409400,18738400,-1
231,1,STEP,713964522000,713983531300,19009300,-1
232,1,STEP,713983598100,714003074000,19475900,-1
233,1,STEP,714003172300,714022094100,18921800,-1
234,1,STEP,714022178200,714041145600,18967400,-1
235,1,STEP,714041207700,714060359600,19151900,-1
236,1,STEP,714060422900,714079792300,19369400,-1
237,1,STEP,714079888900,714098859200,18970300,-1
238,1,STEP,714098929300,714118427100,19497800,-1
239,1,STEP,714118478000,714138338500,19860500,-1
240,1,STEP,714138394200,714157535900,19141700,-1
241,1,STEP,714157588800,714177368000,19779200,-1
242,1,STEP,714177409900,714196814900,19405000,-1
243,1,STEP,714196862300,714216289800,19427500,-1
244,1,STEP,714216350400,714235463900,19113500,-1
245,1,STEP,714235513100,714253672400,18159300,-1
246,1,STEP,714253710900,714272832600,19121700,-1
247,1,STEP,714272877400,714291619600,18742200,-1
248,1,STEP,714291662100,714310366500,18704400,-1
249,1,STEP,714310414500,714328930900,18516400,-1
250,1,STEP,714328974900,714347901300,18926400,-1
251,1,STEP,714347957400,714367571800,19614400,-1
252,1,STEP,714367621500,714385954300,18332800,-1
253,1,STEP,714386000000,714404908600,18908600,-1
254,1,STEP,714404967100,714423715700,18748600,-1
255,1,STEP,714423772500,714442150100,18377600,-1
256,1,STEP,714442199100,714460855700,18656600,-1
257,1,STEP,714460897700,714479356900,18459200,-1
258,1,STEP,714479402900,714498649500,19246600,-1
259,1,STEP,714498696500,714517897500,19201000,-1
260,1,STEP,714517970200,714537729600,19759400,-1
261,1,STEP,714537793100,714557422400,19629300,-1
262,1,STEP,714557460100,714576753700,19293600,-1
263,1,STEP,714576801200,714595885500,19084300,-1
264,1,STEP,714595929300,714614938700,19009400,-1
265,1,STEP,714614981800,714634055300,19073500,-1
266,1,STEP,714634101200,714652706400,18605200,-1
267,1,STEP,714652747300,714672089800,19342500,-1
268,1,STEP,714672128100,714691103300,18975200,-1
269,1,STEP,714691145400,714710277100,19131700,-1
270,1,STEP,714710315700,714729586700,19271000,-1
271,1,STEP,714729634000,714748272600,18638600,-1
272,1,STEP,714748333800,714767323800,18990000,-1
273,1,STEP,714767360400,714786644600,19284200,-1
274,1,STEP,714786686100,714805802600,19116500,-1
275,1,STEP,714805842200,714825470300,19628100,-1
276,1,STEP,714825524400,714844101000,18576600,-1
277,1,STEP,714844143100,714863183800,19040700,-1
278,1,STEP,714863233100,714882279700,19046600,-1
279,1,STEP,714882347700,714901499500,19151800,-1
280,1,STEP,714901555300,714921064200,19508900,-1
281,1,STEP,714921119700,714939447300,18327600,-1
282,1,STEP,714939498300,714958093700,18595400,-1
283,1,STEP,714958144300,714977683100,19538800,-1
284,1,STEP,714977735700,714996073300,18337600,-1
285,1,STEP,714996136400,715015997200,19860800,-1
286,1,STEP,715016063000,715036260700,20197700,-1
287,1,STEP,715036311700,715055659700,19348000,-1
288,1,STEP,715055713500,715075005200,19291700,-1
289,1,STEP,715075057200,715094587300,19530100,-1
290,1,STEP,715094635800,715114622300,19986500,-1
291,1,STEP,715114681200,715134749600,20068400,-1
292,1,STEP,715134795300,715154372800,19577500,-1
293,1,STEP,715154425000,715174355900,19930900,-1
294,1,STEP,715174394000,715194809500,20415500,-1
295,1,STEP,715194855200,715214802700,19947500,-1
296,1,STEP,715214853600,715234534900,19681300,-1
297,1,STEP,715234602600,715254673600,20071000,-1
298,1,STEP,715254723200,715274622200,19899000,-1
299,1,STEP,715274668500,715294441800,19773300,-1
300,1,STEP,715294488600,715313931400,19442800,-1
301,1,STEP,715313973200,715333855300,19882100,-1
302,1,STEP,715333900700,715353790100,19889400,-1
303,1,STEP,715353838100,715373168500,19330400,-1
304,1,STEP,715373217800,715393824700,20606900,-1
305,1,STEP,715393873300,715414362900,20489600,-1
306,1,STEP,715414408900,715434253800,19844900,-1
307,1,STEP,715434335900,715454326600,19990700,-1
308,1,STEP,715454377000,715473650800,19273800,-1
309,1,STEP,715473691300,715493735900,20044600,-1
310,1,STEP,715493770100,715513557200,19787100,-1
311,1,STEP,715513613000,715533455400,19842400,-1
312,1,STEP,715533501000,715553005900,19504900,-1
313,1,STEP,715553053800,715573143000,20089200,-1
314,1,STEP,715573188400,715593048200,19859800,-1
315,1,STEP,715593094700,715612706800,19612100,-1
316,1,STEP,715612756700,715632859900,20103200,-1
317,1,STEP,715632903600,715652732100,19828500,-1
318,1,STEP,715652776600,715673472700,20696100,-1
319,1,STEP,715673519700,715694028100,20508400,-1
320,1,STEP,715694074600,715714551100,20476500,-1
321,1,STEP,715714596200,715734707300,20111100,-1
322,1,STEP,715734746000,715754106600,19360600,-1
323,1,STEP,715754151800,715774426600,20274800,-1
324,1,STEP,715774466800,715795005400,20538600,-1
325,1,STEP,715795061200,715814479900,19418700,-1
326,1,STEP,715814525500,715834265100,19739600,-1
327,1,STEP,715834335800,715853992900,19657100,-1
328,1,STEP,715854037900,715874159300,20121400,-1
329,1,STEP,715874233500,715893923400,19689900,-1
330,1,STEP,715893974700,715913890500,19915800,-1
331,1,STEP,715913937500,715933291600,19354100,-1
332,1,STEP,715933371900,715953768300,20396400,-1
333,1,STEP,715953823400,715973635100,19811700,-1
334,1,STEP,715973686800,715993649800,19963000,-1
335,1,STEP,715993698200,716014229000,20530800,-1
336,1,STEP,716014285200,716034500000,20214800,-1
337,1,STEP,716034550400,716054916500,20366100,-1
338,1,STEP,716054976700,716074892700,19916000,-1
339,1,STEP,716074945600,716094096500,19150900,-1
340,1,STEP,716094145100,716115142100,20997000,-1
341,1,STEP,716115197400,716135327700,20130300,-1
342,1,STEP,716135407300,716154932500,19525200,-1
343,1,STEP,716154971800,716174696400,19724600,-1
344,1,STEP,716174754200,716194641500,19887300,-1
345,1,STEP,716194688100,716215185600,20497500,-1
346,1,STEP,716215233900,716236091200,20857300,-1
347,1,STEP,716236142500,716255774600,19632100,-1
348,1,STEP,716255826800,716275215700,19388900,-1
349,1,STEP,716275269000,716294441800,19172800,-1
350,1,STEP,716294488700,716313766800,19278100,-1
351,1,STEP,716313805600,716332912600,19107000,-1
352,1,STEP,716332950900,716351936500,18985600,-1
353,1,STEP,716351981300,716370647500,18666200,-1
354,1,STEP,716370684900,716389867400,19182500,-1
355,1,STEP,716389916700,716409070000,19153300,-1
356,1,STEP,716409109800,716428518200,19408400,-1
357,1,STEP,716428553600,716447790700,19237100,-1
358,1,STEP,716447828200,716466553900,18725700,-1
359,1,STEP,716466585800,716485171900,18586100,-1
360,1,STEP,716485225800,716504888500,19662700,-1
361,1,STEP,716504927600,716523424900,18497300,-1
362,1,STEP,716523470700,716543241500,19770800,-1
363,1,STEP,716543289300,716562512600,19223300,-1
364,1,STEP,716562565600,716581109600,18544000,-1
365,1,STEP,716581146200,716600258700,19112500,-1
366,1,STEP,716600309400,716620036200,19726800,-1
367,1,STEP,716620074200,716639773900,19699700,-1
368,1,STEP,716639818500,716659228400,19409900,-1
369,1,STEP,716659274500,716678504000,19229500,-1
370,1,STEP,716678550700,716697838600,19287900,-1
371,1,STEP,716697894100,716716530100,18636000,-1
372,1,STEP,716716567300,716736113600,19546300,-1
373,1,STEP,716736154000,716755248200,19094200,-1
374,1,STEP,716755287000,716775060700,19773700,-1
375,1,STEP,716775104800,716793708800,18604000,-1
376,1,STEP,716793749600,716812802300,19052700,-1
377,1,STEP,716812844100,716832378300,19534200,-1
378,1,STEP,716832418300,716851674100,19255800,-1
379,1,STEP,716851711000,716870893900,19182900,-1
380,1,STEP,716870931700,716890017200,19085500,-1
381,1,STEP,716890052500,716909372700,19320200,-1
382,1,STEP,716909426700,716927819600,18392900,-1
383,1,STEP,716927859100,716946649900,18790800,-1
384,1,STEP,716946685500,716966447500,19762000,-1
385,1,STEP,716966488300,716986040900,19552600,-1
386,1,STEP,716986091900,717004428800,18336900,-1
387,1,STEP,717004483600,717022771700,18288100,-1
388,1,STEP,717022821500,717042444600,19623100,-1
389,1,STEP,717042505100,717061885900,19380800,-1
390,1,STEP,717061921300,717081063200,19141900,-1
391,1,STEP,717081101400,717100228500,19127100,-1
392,1,STEP,717100272900,717119561600,19288700,-1
393,1,STEP,717119614000,717139393500,19779500,-1
394,1,STEP,717139443600,717158062300,18618700,-1
395,1,STEP,717158113300,717177333700,19220400,-1
396,1,STEP,717177375600,717197080500,19704900,-1
397,1,STEP,717197120600,717216630300,19509700,-1
398,1,STEP,717216678700,717236095600,19416900,-1
399,1,STEP,717236142400,717255852200,19709800,-1
400,1,STEP,717255895900,717275418300,19522400,-1
401,1,STEP,717275469600,717293996000,18526400,-1
402,1,STEP,717294036000,717313139200,19103200,-1
403,1,STEP,717313171100,717332825500,19654400,-1
404,1,STEP,717332877600,717352030800,19153200,-1
405,1,STEP,717352066700,717371326400,19259700,-1
406,1,STEP,717371366800,717390422100,19055300,-1
407,1,STEP,717390463100,717409576100,19113000,-1
408,1,STEP,717409618200,717428893400,19275200,-1
409,1,STEP,717428943500,717447474700,18531200,-1
410,1,STEP,717447511400,717466091900,18580500,-1
411,1,STEP,717466130200,717485373000,19242800,-1
412,1,STEP,717485409000,717503654800,18245800,-1
413,1,STEP,717503701500,717522490300,18788800,-1
414,1,STEP,717522534600,717541299900,18765300,-1
415,1,STEP,717541357500,717559651100,18293600,-1
416,1,STEP,717559701600,717578505900,18804300,-1
417,1,STEP,717578557000,717597130900,18573900,-1
418,1,STEP,717597179700,717616104500,18924800,-1
419,1,STEP,717616152900,717634958600,18805700,-1
420,1,STEP,717635003200,717654694800,19691600,-1
421,1,STEP,717654739500,717673708200,18968700,-1
422,1,STEP,717673740200,717692970400,19230200,-1
423,1,STEP,717693012400,717713267500,20255100,-1
424,1,STEP,717713305400,717734238000,20932600,-1
425,1,STEP,717734310300,717754734700,20424400,-1
426,1,STEP,717754784100,717774651000,19866900,-1
427,1,STEP,717774693100,717794281600,19588500,-1
428,1,STEP,717794322100,717813775800,19453700,-1
429,1,STEP,717813831200,717833959900,20128700,-1
430,1,STEP,717834007000,717853991300,19984300,-1
431,1,STEP,717854035900,717874772600,20736700,-1
432,1,STEP,717874821900,717895042800,20220900,-1
433,1,STEP,717895089900,717915172800,20082900,-1
434,1,STEP,717915224500,717935161600,19937100,-1
435,1,STEP,717935206000,717956234200,21028200,-1
436,1,STEP,717956296500,717976129300,19832800,-1
437,1,STEP,717976186200,717996235200,20049000,-1
438,1,STEP,717996276100,718015586000,19309900,-1
439,1,STEP,718015628900,718035679000,20050100,-1
440,1,STEP,718035726800,718055832400,20105600,-1
441,1,STEP,718055884600,718075422400,19537800,-1
442,1,STEP,718075470800,718095489500,20018700,-1
443,1,STEP,718095537100,718115579000,20041900,-1
444,1,STEP,718115630600,718135676400,20045800,-1
445,1,STEP,718135724800,718156250300,20525500,-1
446,1,STEP,718156315200,718175655800,19340600,-1
447,1,STEP,718175709900,718196113200,20403300,-1
448,1,STEP,718196167500,718215429200,19261700,-1
449,1,STEP,718215476900,718235878500,20401600,-1
450,1,STEP,718235928400,718256304100,20375700,-1
451,1,STEP,718256351200,718276600800,20249600,-1
452,1,STEP,718276651400,718296227000,19575600,-1
453,1,STEP,718296279300,718316507800,20228500,-1
454,1,STEP,718316555100,718336440100,19885000,-1
455,1,STEP,718336491600,718356667700,20176100,-1
456,1,STEP,718356723300,718376578700,19855400,-1
457,1,STEP,718376631400,718397222100,20590700,-1
458,1,STEP,718397384300,718418017900,20633600,-1
459,1,STEP,718418101000,718437812700,19711700,-1
460,1,STEP,718437896700,718457048300,19151600,-1
461,1,STEP,718457112800,718476716800,19604000,-1
462,1,STEP,718476791500,718497508800,20717300,-1
463,1,STEP,718497574800,718517259300,19684500,-1
464,1,STEP,718517323700,718536165600,18841900,-1
465,1,STEP,718536257300,718555396100,19138800,-1
466,1,STEP,718555473000,718575183300,19710300,-1
467,1,STEP,718575251400,718594943200,19691800,-1
468,1,STEP,718595037800,718614458100,19420300,-1
469,1,STEP,718614521300,718632816500,18295200,-1
470,1,STEP,718632879400,718652499200,19619800,-1
471,1,STEP,718652564500,718672055900,19491400,-1
472,1,STEP,718672111900,718690645100,18533200,-1
473,1,STEP,718690699300,718710183900,19484600,-1
474,1,STEP,718710233800,718730007000,19773200,-1
475,1,STEP,718730073600,718749000700,18927100,-1
476,1,STEP,718749067700,718768873200,19805500,-1
477,1,STEP,718768920800,718788538900,19618100,-1
478,1,STEP,718788592900,718807519000,18926100,-1
479,1,STEP,718807582300,718827511500,19929200,-1
480,1,STEP,718827567400,718847083100,19515700,-1
481,1,STEP,718847134100,718866960600,19826500,-1
482,1,STEP,718867006300,718886751400,19745100,-1
483,1,STEP,718886799600,718905848500,19048900,-1
484,1,STEP,718905931500,718925700000,19768500,-1
485,1,STEP,718925754500,718945543100,19788600,-1
486,1,STEP,718945601300,718964781800,19180500,-1
487,1,STEP,718964828300,718983822300,18994000,-1
488,1,STEP,718983866700,719003056600,19189900,-1
489,1,STEP,719003110900,719023390200,20279300,-1
490,1,STEP,719023454100,719043308200,19854100,-1
491,1,STEP,719043361300,719063105400,19744100,-1
492,1,STEP,719063144800,719082250700,19105900,-1
493,1,STEP,719082299200,719101311400,19012200,-1
494,1,STEP,719101363800,719120547400,19183600,-1
495,1,STEP,719120615400,719139244900,18629500,-1
496,1,STEP,719139290100,719158219200,18929100,-1
497,1,STEP,719158266500,719177887700,19621200,-1
498,1,STEP,719177939100,719197029700,19090600,-1
499,1,STEP,719197082000,719216264800,19182800,-1
500,1,STEP,719216315400,719235161200,18845800,-1
501,1,STEP,719235221600,719254318300,19096700,-1
502,1,STEP,719254382600,719273171100,18788500,-1
503,1,STEP,719273222700,719291886100,18663400,-1
504,1,STEP,719291935300,719311408100,19472800,-1
505,1,STEP,719311452100,719330958200,19506100,-1
506,1,STEP,719331006300,719351043200,20036900,-1
507,1,STEP,719351088900,719369857500,18768600,-1
508,1,STEP,719369916700,719389808600,19891900,-1
509,1,STEP,719389851200,719409112400,19261200,-1
510,1,STEP,719409158900,719428240100,19081200,-1
511,1,STEP,719428286900,719446876000,18589100,-1
512,1,STEP,719446923100,719466557300,19634200,-1
513,1,STEP,719466606800,719486246900,19640100,-1
514,1,STEP,719486295800,719505718200,19422400,-1
515,1,STEP,719505765700,719525670300,19904600,-1
516,1,STEP,719525724000,719544579800,18855800,-1
517,1,STEP,719544629700,719563869300,19239600,-1
518,1,STEP,719563941900,719584105900,20164000,-1
519,1,STEP,719584177100,719603476600,19299500,-1
520,1,STEP,719603551700,719623548000,19996300,-1
521,1,STEP,719623608500,719643088500,19480000,-1
522,1,STEP,719643142100,719661959400,18817300,-1
523,1,STEP,719662012600,719681150400,19137800,-1
524,1,STEP,719681208300,719701026700,19818400,-1
525,1,STEP,719701083100,719720618700,19535600,-1
526,1,STEP,719720676300,719740367300,19691000,-1
527,1,STEP,719740421100,719760338000,19916900,-1
528,1,STEP,719760385000,719780155200,19770200,-1
529,1,STEP,719780196100,719799003500,18807400,-1
530,1,STEP,719799040500,719818047400,19006900,-1
531,1,STEP,719818095500,719837984500,19889000,-1
532,1,STEP,719838037200,719858178700,20141500,-1
533,1,STEP,719858237600,719878762100,20524500,-1
534,1,STEP,719878802900,719897665800,18862900,-1
535,1,STEP,719897707500,719917395800,19688300,-1
536,1,STEP,719917439200,719937124600,19685400,-1
537,1,STEP,719937173300,719957308500,20135200,-1
538,1,STEP,719957359400,719976966100,19606700,-1
539,1,STEP,719977011700,719997119500,20107800,-1
540,1,STEP,719997162400,720016710300,19547900,-1
541,1,STEP,720016754100,720035695300,18941200,-1
542,1,STEP,720035749300,720056354200,20604900,-1
543,1,STEP,720056404800,720076320800,19916000,-1
544,1,STEP,720076368200,720096375600,20007400,-1
545,1,STEP,720096422300,720115926200,19503900,-1
546,1,STEP,720115968300,720135345500,19377200,-1
547,1,STEP,720135402200,720155037400,19635200,-1
548,1,STEP,720155166900,720175555100,20388200,-1
549,1,STEP,720175638900,720195017700,19378800,-1
550,1,STEP,720195074000,720214865300,19791300,-1
551,1,STEP,720214929900,720235076400,20146500,-1
552,1,STEP,720235131600,720254335000,19203400,-1
553,1,STEP,720254434100,720274618300,20184200,-1
554,1,STEP,720274675500,720294771600,20096100,-1
555,1,STEP,720294834700,720314547200,19712500,-1
556,1,STEP,720314634400,720334103600,19469200,-1
557,1,STEP,720334158500,720353863300,19704800,-1
558,1,STEP,720353919400,720373802200,19882800,-1
559,1,STEP,720373853800,720393074800,19221000,-1
560,1,STEP,720393127700,720413382800,20255100,-1
561,1,STEP,720413454500,720433226500,19772000,-1
562,1,STEP,720433280000,720452700400,19420400,-1
563,1,STEP,720452757200,720472577000,19819800,-1
564,1,STEP,720472653000,720492360600,19707600,-1
565,1,STEP,720492409200,720511128100,18718900,-1
566,1,STEP,720511175800,720530468500,19292700,-1
567,1,STEP,720530517600,720550022800,19505200,-1
568,1,STEP,720550081800,720569090500,19008700,-1
569,1,STEP,720569136200,720589281600,20145400,-1
570,1,STEP,720589322600,720608765600,19443000,-1
571,1,STEP,720608827500,720628230900,19403400,-1
572,1,STEP,720628324900,720647544200,19219300,-1
573,1,STEP,720647588000,720667551100,19963100,-1
574,1,STEP,720667615300,720687320000,19704700,-1
575,1,STEP,720687373900,720706615000,19241100,-1
576,1,STEP,720706671200,720726774400,20103200,-1
577,1,STEP,720726831000,720746620300,19789300,-1
578,1,STEP,720746675800,720766415000,19739200,-1
579,1,STEP,720766460000,720786862100,20402100,-1
580,1,STEP,720786928000,720806543300,19615300,-1
581,1,STEP,720806596500,720826017800,19421300,-1
582,1,STEP,720826070600,720844979200,18908600,-1
583,1,STEP,720845042200,720864161200,19119000,-1
584,1,STEP,720864224500,720883463200,19238700,-1
585,1,STEP,720883525200,720903435700,19910500,-1
586,1,STEP,720903516300,720922861900,19345600,-1
587,1,STEP,720922915800,720942957400,20041600,-1
588,1,STEP,720943010600,720962525500,19514900,-1
589,1,STEP,720962591200,720981833700,19242500,-1
590,1,STEP,720981876600,721001214000,19337400,-1
591,1,STEP,721001252300,721021349100,20096800,-1
592,1,STEP,721021415200,721040389000,18973800,-1
593,1,STEP,721040431900,721060341100,19909200,-1
594,1,STEP,721060379900,721080436400,20056500,-1
595,1,STEP,721080485900,721100489400,20003500,-1
596,1,STEP,721100531000,721119898600,19367600,-1
597,1,STEP,721119942800,721139743700,19800900,-1
598,1,STEP,721139797000,721159163000,19366000,-1
599,1,STEP,721159202700,721178767000,19564300,-1
600,1,STEP,721178817400,721198251900,19434500,-1
601,1,STEP,721198302800,721218164900,19862100,-1
602,1,STEP,721218211400,721237452500,19241100,-1
603,1,STEP,721237506300,721257616500,20110200,-1
604,1,STEP,721257670700,721277582100,19911400,-1
605,1,STEP,721277631800,721297826600,20194800,-1
606,1,STEP,721297889900,721317978400,20088500,-1
607,1,STEP,721318012700,721338169600,20156900,-1
608,1,STEP,721338224800,721358401200,20176400,-1
609,1,STEP,721358454700,721377828200,19373500,-1
610,1,STEP,721377883100,721397167600,19284500,-1
611,1,STEP,721397217500,721416748600,19531100,-1
612,1,STEP,721416793600,721436273100,19479500,-1
613,1,STEP,721436314800,721456311300,19996500,-1
614,1,STEP,721456347900,721476068600,19720700,-1
615,1,STEP,721476106000,721495999700,19893700,-1
616,1,STEP,721496039800,721516093700,20053900,-1
617,1,STEP,721516141400,721536101500,19960100,-1
618,1,STEP,721536139100,721556121700,19982600,-1
619,1,STEP,721556159700,721575986500,19826800,-1
620,1,STEP,721576025600,721595247700,19222100,-1
621,1,STEP,721595297200,721614678500,19381300,-1
622,1,STEP,721614728500,721634831800,20103300,-1
623,1,STEP,721634883600,721654855000,19971400,-1
624,1,STEP,721654894600,721674636600,19742000,-1
625,1,STEP,721674683100,721693882300,19199200,-1
626,1,STEP,721693933200,721712453800,18520600,-1
627,1,STEP,721712500800,721732250000,19749200,-1
628,1,STEP,721732291500,721752340000,20048500,-1
629,1,STEP,721752398900,721771926600,19527700,-1
630,1,STEP,721771960400,721791854300,19893900,-1
631,1,STEP,721791897000,721813172700,21275700,-1
632,1,STEP,721813211800,721833744500,20532700,-1
633,1,STEP,721833788700,721854082400,20293700,-1
634,1,STEP,721854123800,721874562800,20439000,-1
635,1,STEP,721874605100,721895744200,21139100,-1
636,1,STEP,721895786900,721917052600,21265700,-1
637,1,STEP,721917092700,721938389600,21296900,-1
638,1,STEP,721938443400,721959626000,21182600,-1
639,1,STEP,721959667400,721980646200,20978800,-1
640,1,STEP,721980688500,722001044000,20355500,-1
641,1,STEP,722001086700,722021095500,20008800,-1
642,1,STEP,722021133600,722041933300,20799700,-1
643,1,STEP,722041984700,722062576800,20592100,-1
644,1,STEP,722062613400,722083456000,20842600,-1
645,1,STEP,722083497200,722104458800,20961600,-1
646,1,STEP,722104506400,722125816600,21310200,-1
647,1,STEP,722125854500,722147047500,21193000,-1
648,1,STEP,722147089900,722168314600,21224700,-1
649,1,STEP,722168352300,722188754000,20401700,-1
650,1,STEP,722188804200,722209386700,20582500,-1
651,1,STEP,722209433600,722229879700,20446100,-1
652,1,STEP,722229921300,722250987100,21065800,-1
653,1,STEP,722251035800,722271363200,20327400,-1
654,1,STEP,722271413900,722291699400,20285500,-1
655,1,STEP,722291739700,722311741200,20001500,-1
656,1,STEP,722311796600,722331978200,20181600,-1
657,1,STEP,722332024900,722353120600,21095700,-1
658,1,STEP,722353172000,722373778200,20606200,-1
659,1,STEP,722373816800,722395366800,21550000,-1
660,1,STEP,722395418300,722416245900,20827600,-1
661,1,STEP,722416310100,722436112000,19801900,-1
662,1,STEP,722436162100,722457380000,21217900,-1
663,1,STEP,722457433800,722478542600,21108800,-1
664,1,STEP,722478583600,722499710800,21127200,-1
665,1,STEP,722499748700,722520441900,20693200,-1
666,1,STEP,722520484200,722540937900,20453700,-1
667,1,STEP,722540976900,722561713200,20736300,-1
668,1,STEP,722561758600,722582809500,21050900,-1
669,1,STEP,722582851300,722603118900,20267600,-1
670,1,STEP,722603157100,722623274600,20117500,-1
671,1,STEP,722623310300,722644237800,20927500,-1
672,1,STEP,722644283500,722664784000,20500500,-1
673,1,STEP,722664833500,722685582600,20749100,-1
674,1,STEP,722685634500,722706045700,20411200,-1
675,1,STEP,722706086100,722726700900,20614800,-1
676,1,STEP,722726745600,722747602700,20857100,-1
677,1,STEP,722747637900,722767996100,20358200,-1
678,1,STEP,722768036000,722788562500,20526500,-1
679,1,STEP,722788607600,722809104200,20496600,-1
680,1,STEP,722809158700,722829592800,20434100,-1
681,1,STEP,722829628900,722849859900,20231000,-1
682,1,STEP,722849901300,722870129700,20228400,-1
683,1,STEP,722870179300,722890450300,20271000,-1
684,1,STEP,722890493400,722911433200,20939800,-1
685,1,STEP,722911478100,722932197900,20719800,-1
686,1,STEP,722932251300,722952428100,20176800,-1
687,1,STEP,722952467300,722974214400,21747100,-1
688,1,STEP,722974265700,722994375900,20110200,-1
689,1,STEP,722994427100,723014480400,20053300,-1
690,1,STEP,723014536600,723035550200,21013600,-1
691,1,STEP,723035604200,723055145700,19541500,-1
692,1,STEP,723055214600,723076007300,20792700,-1
693,1,STEP,723076068000,723096581400,20513400,-1
694,1,STEP,723096637800,723116968800,20331000,-1
695,1,STEP,723117023600,723137442400,20418800,-1
696,1,STEP,723137499100,723158544100,21045000,-1
697,1,STEP,723158601200,723178784800,20183600,-1
698,1,STEP,723179055300,723199693900,20638600,-1
699,1,STEP,723199762400,723220211900,20449500,-1
700,1,STEP,723220269100,723240936500,20667400,-1
701,1,STEP,723240983300,723261665300,20682000,-1
702,1,STEP,723261711700,723282250300,20538600,-1
703,1,STEP,723282300500,723302969400,20668900,-1
704,1,STEP,723303018400,723323827700,20809300,-1
705,1,STEP,723323866700,723344368600,20501900,-1
706,1,STEP,723344420200,723364921000,20500800,-1
707,1,STEP,723364977200,723385406100,20428900,-1
708,1,STEP,723385461200,723405724800,20263600,-1
709,1,STEP,723405780600,723425688800,19908200,-1
710,1,STEP,723425741400,723445455700,19714300,-1
711,1,STEP,723445500600,723465557300,20056700,-1
712,1,STEP,723465608200,723486278300,20670100,-1
713,1,STEP,723486335900,723506412900,20077000,-1
714,1,STEP,723506463600,723526008500,19544900,-1
715,1,STEP,723526053400,723546382900,20329500,-1
716,1,STEP,723546425700,723566504100,20078400,-1
717,1,STEP,723566560900,723587133900,20573000,-1
718,1,STEP,723587199700,723607197200,19997500,-1
719,1,STEP,723607256200,723627311800,20055600,-1
720,1,STEP,723627384700,723648229800,20845100,-1
721,1,STEP,723648310400,723668451600,20141200,-1
722,1,STEP,723668523000,723688650600,20127600,-1
723,1,STEP,723688705800,723708874100,20168300,-1
724,1,STEP,723708914000,723728937600,20023600,-1
725,1,STEP,723728988700,723749187400,20198700,-1
726,1,STEP,723749271500,723769453700,20182200,-1
727,1,STEP,723769498500,723789557400,20058900,-1
728,1,STEP,723789628200,723809163400,19535200,-1
729,1,STEP,723809215300,723828719300,19504000,-1
730,1,STEP,723828782000,723848979700,20197700,-1
731,1,STEP,723849036300,723869220700,20184400,-1
732,1,STEP,723869269900,723888860100,19590200,-1
733,1,STEP,723888912800,723909003600,20090800,-1
734,1,STEP,723909050600,723929292300,20241700,-1
735,1,STEP,723929330200,723949471800,20141600,-1
736,1,STEP,723949516100,723969707600,20191500,-1
737,1,STEP,723969749600,723989222100,19472500,-1
738,1,STEP,723989269500,724009339900,20070400,-1
739,1,STEP,724009386700,724029455900,20069200,-1
740,1,STEP,724029506700,724049522700,20016000,-1
741,1,STEP,724049574800,724069616500,20041700,-1
742,1,STEP,724069670300,724090255300,20585000,-1
743,1,STEP,724090314900,724109806100,19491200,-1
744,1,STEP,724109869300,724129280600,19411300,-1
745,1,STEP,724129329000,724149646700,20317700,-1
746,1,STEP,724149716800,724169449700,19732900,-1
747,1,STEP,724169505900,724189075400,19569500,-1
748,1,STEP,724189136100,724209415300,20279200,-1
749,1,STEP,724209464200,724229114700,19650500,-1
750,1,STEP,724229203400,724248239700,19036300,-1
751,1,STEP,724248311600,724268598000,20286400,-1
752,1,STEP,724268656800,724287968000,19311200,-1
753,1,STEP,724288029800,724307282300,19252500,-1
754,1,STEP,724307354800,724327706300,20351500,-1
755,1,STEP,724327848800,724347207300,19358500,-1
756,1,STEP,724347266900,724366861100,19594200,-1
757,1,STEP,724366929700,724386458400,19528700,-1
758,1,STEP,724386513100,724405955000,19441900,-1
759,1,STEP,724406023400,724425706800,19683400,-1
760,1,STEP,724425770800,724445203700,19432900,-1
761,1,STEP,724445259400,724465108500,19849100,-1
762,1,STEP,724465214300,724485172100,19957800,-1
763,1,STEP,724485241200,724504978400,19737200,-1
764,1,STEP,724505037900,724524791500,19753600,-1
765,1,STEP,724524885200,724545226600,20341400,-1
766,1,STEP,724545304500,724564684300,19379800,-1
767,1,STEP,724564741000,724584931500,20190500,-1
768,1,STEP,724585000300,724604224000,19223700,-1
769,1,STEP,724604276100,724624452000,20175900,-1
770,1,STEP,724624522000,724644844500,20322500,-1
771,1,STEP,724644910000,724665147600,20237600,-1
772,1,STEP,724665202300,724685534400,20332100,-1
773,1,STEP,724685610300,724705621600,20011300,-1
774,1,STEP,724705691700,724725245300,19553600,-1
775,1,STEP,724725334700,724745573400,20238700,-1
776,1,STEP,724745625500,724765628700,20003200,-1
777,1,STEP,724765698900,724785267000,19568100,-1
778,1,STEP,724785331500,724804864200,19532700,-1
779,1,STEP,724804915900,724824935000,20019100,-1
780,1,STEP,724825022100,724845269500,20247400,-1
781,1,STEP,724845330800,724866209800,20879000,-1
782,1,STEP,724866271800,724886520000,20248200,-1
783,1,STEP,724886567000,724908154000,21587000,-1
784,1,STEP,724908209200,724929188600,20979400,-1
785,1,STEP,724929240700,724950057100,20816400,-1
786,1,STEP,724950174700,724971599800,21425100,-1
787,1,STEP,724971659100,724991829200,20170100,-1
788,1,STEP,724991973100,725012722900,20749800,-1
789,1,STEP,725012798100,725033723000,20924900,-1
790,1,STEP,725033810800,725054204000,20393200,-1
791,1,STEP,725054268700,725075339500,21070800,-1
792,1,STEP,725075410700,725096512000,21101300,-1
793,1,STEP,725096564500,725116930500,20366000,-1
794,1,STEP,725116983200,725137829100,20845900,-1
795,1,STEP,725137883000,725158669600,20786600,-1
796,1,STEP,725158719400,725179031500,20312100,-1
797,1,STEP,725179083500,725200520500,21437000,-1
798,1,STEP,725200571900,725221313100,20741200,-1
799,1,STEP,725221364900,725243057100,21692200,-1
800,1,STEP,725243114500,725264193200,21078700,-1
801,1,STEP,725264246900,725284798000,20551100,-1
802,1,STEP,725284853300,725305974300,21121000,-1
803,1,STEP,725306038700,725326189400,20150700,-1
804,1,STEP,725326313100,725346924500,20611400,-1
805,1,STEP,725346980700,725367616300,20635600,-1
806,1,STEP,725367667700,725388224900,20557200,-1
807,1,STEP,725388326500,725409872500,21546000,-1
808,1,STEP,725409923900,725430417100,20493200,-1
809,1,STEP,725430466800,725451776300,21309500,-1
810,1,STEP,725451834900,725472693300,20858400,-1
811,1,STEP,725472741600,725493534200,20792600,-1
812,1,STEP,725493589300,725514389200,20799900,-1
813,1,STEP,725514438500,725535046200,20607700,-1
814,1,STEP,725535094000,725556629000,21535000,-1
815,1,STEP,725556682100,725578814800,22132700,-1
816,1,STEP,725578871300,725599834000,20962700,-1
817,1,STEP,725599883000,725621388900,21505900,-1
818,1,STEP,725621440500,725642216100,20775600,-1
819,1,STEP,725642264000,725663220300,20956300,-1
820,1,STEP,725663272100,725684096600,20824500,-1
821,1,STEP,725684137300,725704012000,19874700,-1
822,1,STEP,725704060500,725723967600,19907100,-1
823,1,STEP,725724012400,725744307000,20294600,-1
824,1,STEP,725744346800,725764511000,20164200,-1
825,1,STEP,725764551100,725784199100,19648000,-1
826,1,STEP,725784237800,725803505200,19267400,-1
827,1,STEP,725803547600,725822764700,19217100,-1
828,1,STEP,725822804300,725842303600,19499300,-1
829,1,STEP,725842349400,725861728800,19379400,-1
830,1,STEP,725861779000,725881653800,19874800,-1
831,1,STEP,725881702400,725900962300,19259900,-1
832,1,STEP,725901014300,725921611100,20596800,-1
833,1,STEP,725921657800,725941695900,20038100,-1
834,1,STEP,725941738500,725961073200,19334700,-1
835,1,STEP,725961120300,725980725500,19605200,-1
836,1,STEP,725980782800,726000486800,19704000,-1
837,1,STEP,726000536000,726020114900,19578900,-1
838,1,STEP,726020191700,726040083800,19892100,-1
839,1,STEP,726040133400,726059800900,19667500,-1
840,1,STEP,726059855400,726079535300,19679900,-1
841,1,STEP,726079586400,726099345600,19759200,-1
842,1,STEP,726099402300,726119712900,20310600,-1
843,1,STEP,726119756000,726139870300,20114300,-1
844,1,STEP,726139913300,726159435000,19521700,-1
845,1,STEP,726159489800,726179823500,20333700,-1
846,1,STEP,726179879100,726199314300,19435200,-1
847,1,STEP,726199363000,726219274800,19911800,-1
848,1,STEP,726219323400,726238810800,19487400,-1
849,1,STEP,726238854600,726258926700,20072100,-1
850,1,STEP,726258964200,726279462600,20498400,-1
851,1,STEP,726279515400,726299079200,19563800,-1
852,1,STEP,726299127800,726318599300,19471500,-1
853,1,STEP,726318638600,726337996300,19357700,-1
854,1,STEP,726338035600,726357732700,19697100,-1
855,1,STEP,726357771900,726377387900,19616000,-1
856,1,STEP,726377428900,726397080700,19651800,-1
857,1,STEP,726397132800,726417193700,20060900,-1
858,1,STEP,726417245400,726436907900,19662500,-1
859,1,STEP,726436953100,726456401500,19448400,-1
860,1,STEP,726456439100,726475588400,19149300,-1
861,1,STEP,726475631800,726495149600,19517800,-1
862,1,STEP,726495204000,726514812300,19608300,-1
863,1,STEP,726514852800,726534994800,20142000,-1
864,1,STEP,726535042600,726554438500,19395900,-1
865,1,STEP,726554495900,726574557800,20061900,-1
866,1,STEP,726574613100,726594155500,19542400,-1
867,1,STEP,726594206100,726614142900,19936800,-1
868,1,STEP,726614187500,726633937500,19750000,-1
869,1,STEP,726633994700,726653738200,19743500,-1
870,1,STEP,726653794800,726673801100,20006300,-1
871,1,STEP,726673853700,726694287800,20434100,-1
872,1,STEP,726694330700,726715211500,20880800,-1
873,1,STEP,726715278900,726735539700,20260800,-1
874,1,STEP,726735590600,726755336400,19745800,-1
875,1,STEP,726755374700,726775132600,19757900,-1
876,1,STEP,726775175300,726795338300,20163000,-1
877,1,STEP,726795385300,726815133600,19748300,-1
878,1,STEP,726815184000,726834765800,19581800,-1
879,1,STEP,726834812400,726854217600,19405200,-1
880,1,STEP,726854253700,726873809800,19556100,-1
881,1,STEP,726873850000,726893232900,19382900,-1
882,1,STEP,726893278000,726913626300,20348300,-1
883,1,STEP,726913677800,726933894400,20216600,-1
884,1,STEP,726933942300,726954162400,20220100,-1
885,1,STEP,726954201600,726974799500,20597900,-1
886,1,STEP,726974838800,726994343800,19505000,-1
887,1,STEP,726994385700,727014546400,20160700,-1
888,1,STEP,727014582900,727034816000,20233100,-1
889,1,STEP,727034861400,727055062300,20200900,-1
890,1,STEP,727055105900,727074698700,19592800,-1
891,1,STEP,727074744800,727095312300,20567500,-1
892,1,STEP,727095358100,727114847100,19489000,-1
893,1,STEP,727114895900,727134412300,19516400,-1
894,1,STEP,727134459700,727154000100,19540400,-1
895,1,STEP,727154037800,727173956400,19918600,-1
896,1,STEP,727173993100,727193462300,19469200,-1
897,1,STEP,727193500800,727214288700,20787900,-1
898,1,STEP,727214334000,727234102600,19768600,-1
899,1,STEP,727234158900,727253529900,19371000,-1
900,1,STEP,727253577700,727273417800,19840100,-1
901,1,STEP,727273463600,727293085200,19621600,-1
902,1,STEP,727293126800,727313392600,20265800,-1
903,1,STEP,727313429800,727332864900,19435100,-1
904,1,STEP,727332906900,727353082100,20175200,-1
905,1,STEP,727353124800,727372715600,19590800,-1
906,1,STEP,727372752800,727392335400,19582600,-1
907,1,STEP,727392395400,727412630400,20235000,-1
908,1,STEP,727412679300,727432673000,19993700,-1
909,1,STEP,727432723000,727451902400,19179400,-1
910,1,STEP,727451952800,727471173800,19221000,-1
911,1,STEP,727471217000,727491168700,19951700,-1
912,1,STEP,727491215500,727511222600,20007100,-1
913,1,STEP,727511288000,727531415800,20127800,-1
914,1,STEP,727531456100,727551089100,19633000,-1
915,1,STEP,727551142600,727571350000,20207400,-1
916,1,STEP,727571388500,727591540100,20151600,-1
917,1,STEP,727591575200,727611762200,20187000,-1
918,1,STEP,727611814600,727631974600,20160000,-1
919,1,STEP,727632027500,727652286000,20258500,-1
920,1,STEP,727652379300,727672548000,20168700,-1
921,1,STEP,727672600300,727692780000,20179700,-1
922,1,STEP,727692841300,727712733300,19892000,-1
923,1,STEP,727712782400,727732697400,19915000,-1
924,1,STEP,727732751700,727751941600,19189900,-1
925,1,STEP,727751982300,727772004400,20022100,-1
926,1,STEP,727772040600,727792239500,20198900,-1
927,1,STEP,727792278500,727811856300,19577800,-1
928,1,STEP,727811897800,727831341500,19443700,-1
929,1,STEP,727831379300,727850795400,19416100,-1
930,1,STEP,727850843200,727871051500,20208300,-1
931,1,STEP,727871124100,727890610900,19486800,-1
932,1,STEP,727890648700,727910310900,19662200,-1
933,1,STEP,727910359400,727930956800,20597400,-1
934,1,STEP,727931010300,727950451700,19441400,-1
935,1,STEP,727950490700,727971376800,20886100,-1
936,1,STEP,727971425300,727991701200,20275900,-1
937,1,STEP,727991741400,728012000800,20259400,-1
938,1,STEP,728012043500,728032201500,20158000,-1
939,1,STEP,728032249300,728051840700,19591400,-1
940,1,STEP,728051938900,728071341000,19402100,-1
941,1,STEP,728071392200,728091371300,19979100,-1
942,1,STEP,728091417000,728111062000,19645000,-1
943,1,STEP,728111103000,728130587500,19484500,-1
944,1,STEP,728130633700,728151141300,20507600,-1
945,1,STEP,728151190500,728171154700,19964200,-1
946,1,STEP,728171199200,728191331800,20132600,-1
947,1,STEP,728191377400,728210872700,19495300,-1
948,1,STEP,728210906300,728230469200,19562900,-1
949,1,STEP,728230516700,728250179100,19662400,-1
950,1,STEP,728250221800,728269833700,19611900,-1
951,1,STEP,728269871600,728290030400,20158800,-1
952,1,STEP,728290079700,728310326400,20246700,-1
953,1,STEP,728310383700,728330186800,19803100,-1
954,1,STEP,728330235100,728349816600,19581500,-1
955,1,STEP,728349860700,728370937000,21076300,-1
956,1,STEP,728370978100,728390370600,19392500,-1
957,1,STEP,728390416200,728410692700,20276500,-1
958,1,STEP,728410740700,728431078000,20337300,-1
959,1,STEP,728431119100,728451181700,20062600,-1
960,1,STEP,728451227900,728472050400,20822500,-1
961,1,STEP,728472087200,728491789500,19702300,-1
962,1,STEP,728491829900,728513413500,21583600,-1
963,1,STEP,728513461000,728533738400,20277400,-1
964,1,STEP,728533784400,728554069200,20284800,-1
965,1,STEP,728554119400,728574556500,20437100,-1
966,1,STEP,728574594800,728594519200,19924400,-1
967,1,STEP,728594562100,728614684300,20122200,-1
968,1,STEP,728614726900,728634907400,20180500,-1
969,1,STEP,728634960900,728655015000,20054100,-1
970,1,STEP,728655064900,728675841700,20776800,-1
971,1,STEP,728675893000,728696640300,20747300,-1
972,1,STEP,728696691200,728716509600,19818400,-1
973,1,STEP,728716561400,728736814200,20252800,-1
974,1,STEP,728736877100,728757358300,20481200,-1
975,1,STEP,728757414500,728776907800,19493300,-1
976,1,STEP,728776959600,728797040900,20081300,-1
977,1,STEP,728797085800,728817341700,20255900,-1
978,1,STEP,728817386400,728838155000,20768600,-1
979,1,STEP,728838202100,728858476600,20274500,-1
980,1,STEP,728858517000,728878848200,20331200,-1
981,1,STEP,728878888100,728898580600,19692500,-1
982,1,STEP,728898621800,728919265400,20643600,-1
983,1,STEP,728919316300,728938821500,19505200,-1
984,1,STEP,728938875500,728958461500,19586000,-1
985,1,STEP,728958514700,728978773100,20258400,-1
986,1,STEP,728978813400,728998616000,19802600,-1
987,1,STEP,728998654000,729019036100,20382100,-1
988,1,STEP,729019080300,729038676000,19595700,-1
989,1,STEP,729038720700,729059537300,20816600,-1
990,1,STEP,729059577900,729080006100,20428200,-1
991,1,STEP,729080051600,729099319000,19267400,-1
992,1,STEP,729099357400,729118780900,19423500,-1
993,1,STEP,729118821100,729138078300,19257200,-1
994,1,STEP,729138130100,729158111900,19981800,-1
995,1,STEP,729158157500,729178186500,20029000,-1
996,1,STEP,729178224400,729197906900,19682500,-1
997,1,STEP,729197951500,729217825900,19874400,-1
998,1,STEP,729217872300,729238183600,20311300,-1
999,1,STEP,729238252200,729258403600,20151400,-1
