Gen,Resource,Stamp,TimeStamp_Start,TimeStamp_End,Duration,Indiv_id
0,1,FirstEvaluation,444393155400,454263345200,9870189800,-1
0,1,STEP,454263495000,454324168500,60673500,-1
1,1,STEP,454325364400,454381424700,56060300,-1
2,1,STEP,454382921600,454434627400,51705800,-1
3,1,STEP,454436142500,454485900900,49758400,-1
4,1,STEP,454487355700,454534867500,47511800,-1
5,1,STEP,454536351500,454585433800,49082300,-1
6,1,STEP,454586868400,454635689200,48820800,-1
7,1,STEP,454637130800,454689254000,52123200,-1
8,1,STEP,454690920200,454736609200,45689000,-1
9,1,STEP,454738193100,454788264000,50070900,-1
10,1,STEP,454789858000,454842241600,52383600,-1
11,1,STEP,454843837100,454897049200,53212100,-1
12,1,STEP,454898689900,454954348400,55658500,-1
13,1,STEP,454956939700,455010874100,53934400,-1
14,1,STEP,455012442100,455066154100,53712000,-1
15,1,STEP,455067876700,455125051300,57174600,-1
16,1,STEP,455127039500,455188919700,61880200,-1
17,1,STEP,455190657700,455244401200,53743500,-1
18,1,STEP,455246078900,455302689900,56611000,-1
19,1,STEP,455304449100,455354144900,49695800,-1
20,1,STEP,455355815000,455407110900,51295900,-1
21,1,STEP,455408877700,455460076100,51198400,-1
22,1,STEP,455461726300,455508055900,46329600,-1
23,1,STEP,455509519500,455556038900,46519400,-1
24,1,STEP,455557451200,455601238200,43787000,-1
25,1,STEP,455602827300,455657206000,54378700,-1
26,1,STEP,455658877800,455706415200,47537400,-1
27,1,STEP,455707828400,455754462200,46633800,-1
28,1,STEP,455756022500,455803318500,47296000,-1
29,1,STEP,455804841400,455852102100,47260700,-1
30,1,STEP,455853488000,455903456000,49968000,-1
31,1,STEP,455905386100,455960661400,55275300,-1
32,1,STEP,455962883400,456018763100,55879700,-1
33,1,STEP,456020330800,456074586000,54255200,-1
34,1,STEP,456076255600,456146213100,69957500,-1
35,1,STEP,456150065800,456220708300,70642500,-1
36,1,STEP,456222504900,456297462000,74957100,-1
37,1,STEP,456300492900,456357177500,56684600,-1
38,1,STEP,456359043500,456415083500,56040000,-1
39,1,STEP,456416835600,456470896500,54060900,-1
40,1,STEP,456472511300,456524085200,51573900,-1
41,1,STEP,456528219100,456586826800,58607700,-1
42,1,STEP,456588601800,456637753900,49152100,-1
43,1,STEP,456639416700,456692058000,52641300,-1
44,1,STEP,456693640100,456742628600,48988500,-1
45,1,STEP,456744312100,456794326700,50014600,-1
46,1,STEP,456795974400,456842210900,46236500,-1
47,1,STEP,456843778100,456898051000,54272900,-1
48,1,STEP,456901874300,456964164100,62289800,-1
49,1,STEP,456966411700,457017314600,50902900,-1
50,1,STEP,457018811600,457064621400,45809800,-1
51,1,STEP,457066190500,457118802400,52611900,-1
52,1,STEP,457120300900,457164007900,43707000,-1
53,1,STEP,457165378700,457212333400,46954700,-1
54,1,STEP,457213712400,457258774100,45061700,-1
55,1,STEP,457260263100,457301824200,41561100,-1
56,1,STEP,457303140600,457347151600,44011000,-1
57,1,STEP,457348741600,457399835300,51093700,-1
58,1,STEP,457401613900,457453063700,51449800,-1
59,1,STEP,457455862100,457503542500,47680400,-1
60,1,STEP,457504991300,457546749200,41757900,-1
61,1,STEP,457548080800,457592632400,44551600,-1
62,1,STEP,457593977900,457640366700,46388800,-1
63,1,STEP,457641832000,457688956900,47124900,-1
64,1,STEP,457690580000,457738561200,47981200,-1
65,1,STEP,457740150500,457786329400,46178900,-1
66,1,STEP,457787732200,457833492300,45760100,-1
67,1,STEP,457835170400,457879706200,44535800,-1
68,1,STEP,457880980000,457923201200,42221200,-1
69,1,STEP,457924484800,457971306400,46821600,-1
70,1,STEP,457972827000,458018561600,45734600,-1
71,1,STEP,458020142100,458063014700,42872600,-1
72,1,STEP,458064400800,458112303300,47902500,-1
73,1,STEP,458113899300,458159039100,45139800,-1
74,1,STEP,458160374900,458209860700,49485800,-1
75,1,STEP,458211681400,458259868700,48187300,-1
76,1,STEP,458261211400,458314692200,53480800,-1
77,1,STEP,458317090200,458364763000,47672800,-1
78,1,STEP,458366207700,458415060000,48852300,-1
79,1,STEP,458416488200,458460652600,44164400,-1
80,1,STEP,458461931900,458509562100,47630200,-1
81,1,STEP,458511159800,458561931400,50771600,-1
82,1,STEP,458563523700,458613289400,49765700,-1
83,1,STEP,458614743100,458661627400,46884300,-1
84,1,STEP,458663108300,458711129400,48021100,-1
85,1,STEP,458712587000,458761171300,48584300,-1
86,1,STEP,458762732900,458811841300,49108400,-1
87,1,STEP,458813199300,458860076700,46877400,-1
88,1,STEP,458861686600,458909842100,48155500,-1
89,1,STEP,458911226300,458958790700,47564400,-1
90,1,STEP,458960238700,459012686000,52447300,-1
91,1,STEP,459015921200,459066167400,50246200,-1
92,1,STEP,459067713400,459115197900,47484500,-1
93,1,STEP,459116776400,459169788600,53012200,-1
94,1,STEP,459171405700,459226871900,55466200,-1
95,1,STEP,459228751800,459274868600,46116800,-1
96,1,STEP,459276211100,459322009400,45798300,-1
97,1,STEP,459323491800,459369585200,46093400,-1
98,1,STEP,459371203800,459425162700,53958900,-1
99,1,STEP,459428671300,459487307900,58636600,-1
100,1,STEP,459489087400,459544152600,55065200,-1
101,1,STEP,459546184400,459597914300,51729900,-1
102,1,STEP,459599669400,459649713800,50044400,-1
103,1,STEP,459651525700,459702776600,51250900,-1
104,1,STEP,459704433100,459752832400,48399300,-1
105,1,STEP,459754404300,459798704100,44299800,-1
106,1,STEP,459800093200,459846540800,46447600,-1
107,1,STEP,459847953400,459896089000,48135600,-1
108,1,STEP,459897701400,459947594500,49893100,-1
109,1,STEP,459949083500,459996460600,47377100,-1
110,1,STEP,459998082400,460043664200,45581800,-1
111,1,STEP,460045027200,460088309900,43282700,-1
112,1,STEP,460089681300,460131599500,41918200,-1
113,1,STEP,460132933700,460173791600,40857900,-1
114,1,STEP,460175233900,460217242100,42008200,-1
115,1,STEP,460218559400,460266347000,47787600,-1
116,1,STEP,460267886600,460316593800,48707200,-1
117,1,STEP,460318263800,460360438200,42174400,-1
118,1,STEP,460361850800,460402097300,40246500,-1
119,1,STEP,460403456300,460448509700,45053400,-1
120,1,STEP,460449842700,460494366600,44523900,-1
121,1,STEP,460495768800,460539732500,43963700,-1
122,1,STEP,460540958000,460582806200,41848200,-1
123,1,STEP,460584206900,460636688200,52481300,-1
124,1,STEP,460638789800,460687355300,48565500,-1
125,1,STEP,460689117800,460746144800,57027000,-1
126,1,STEP,460748020000,460802849200,54829200,-1
127,1,STEP,460804859800,460860540100,55680300,-1
128,1,STEP,460863056200,460920992100,57935900,-1
129,1,STEP,460923917100,461001064100,77147000,-1
130,1,STEP,461004483000,461101734200,97251200,-1
131,1,STEP,461104932300,461175904100,70971800,-1
132,1,STEP,461177549900,461226125000,48575100,-1
133,1,STEP,461227578700,461278965000,51386300,-1
134,1,STEP,461280662500,461329282500,48620000,-1
135,1,STEP,461330995700,461379173900,48178200,-1
136,1,STEP,461381108900,461440044500,58935600,-1
137,1,STEP,461441759400,461503142100,61382700,-1
138,1,STEP,461506071800,461563518100,57446300,-1
139,1,STEP,461565783600,461630026500,64242900,-1
140,1,STEP,461632244600,461702752500,70507900,-1
141,1,STEP,461706260100,461765016400,58756300,-1
142,1,STEP,461766975800,461816144100,49168300,-1
143,1,STEP,461817944300,461865616400,47672100,-1
144,1,STEP,461867667200,461919081900,51414700,-1
145,1,STEP,461920995600,461971815700,50820100,-1
146,1,STEP,461973520500,462020323200,46802700,-1
147,1,STEP,462021818500,462068325100,46506600,-1
148,1,STEP,462069837700,462120614100,50776400,-1
149,1,STEP,462122505700,462182357500,59851800,-1
150,1,STEP,462184308200,462239038700,54730500,-1
151,1,STEP,462240889900,462289400300,48510400,-1
152,1,STEP,462290967700,462338318700,47351000,-1
153,1,STEP,462339841500,462385929800,46088300,-1
154,1,STEP,462387504300,462435196500,47692200,-1
155,1,STEP,462436810800,462485485500,48674700,-1
156,1,STEP,462487043800,462532668000,45624200,-1
157,1,STEP,462534252700,462580759600,46506900,-1
158,1,STEP,462582191300,462628750800,46559500,-1
159,1,STEP,462630285700,462672904500,42618800,-1
160,1,STEP,462674342300,462723195100,48852800,-1
161,1,STEP,462724682900,462770683000,46000100,-1
162,1,STEP,462772614400,462835086300,62471900,-1
163,1,STEP,462836739200,462880217400,43478200,-1
164,1,STEP,462881718200,462929585000,47866800,-1
165,1,STEP,462931217600,462980079700,48862100,-1
166,1,STEP,462981656600,463030345000,48688400,-1
167,1,STEP,463032031600,463084762000,52730400,-1
168,1,STEP,463086716400,463140131200,53414800,-1
169,1,STEP,463141885900,463190679300,48793400,-1
170,1,STEP,463192478900,463244296500,51817600,-1
171,1,STEP,463246447500,463305189700,58742200,-1
172,1,STEP,463308689500,463360296000,51606500,-1
173,1,STEP,463362064400,463410795100,48730700,-1
174,1,STEP,463412391000,463457282000,44891000,-1
175,1,STEP,463458696100,463504825100,46129000,-1
176,1,STEP,463506355700,463552294900,45939200,-1
177,1,STEP,463553796400,463601058400,47262000,-1
178,1,STEP,463602707400,463649534500,46827100,-1
179,1,STEP,463651034600,463700982500,49947900,-1
180,1,STEP,463702499500,463749571200,47071700,-1
181,1,STEP,463751002400,463794441000,43438600,-1
182,1,STEP,463796174700,463843836900,47662200,-1
183,1,STEP,463845270700,463891287900,46017200,-1
184,1,STEP,463893000600,463938937900,45937300,-1
185,1,STEP,463940548800,463989317600,48768800,-1
186,1,STEP,463990886600,464038125900,47239300,-1
187,1,STEP,464039792300,464090162200,50369900,-1
188,1,STEP,464091943600,464140328000,48384400,-1
189,1,STEP,464141848800,464188795000,46946200,-1
190,1,STEP,464190349200,464245804300,55455100,-1
191,1,STEP,464249091500,464306204300,57112800,-1
192,1,STEP,464308141000,464354417800,46276800,-1
193,1,STEP,464356189700,464404901800,48712100,-1
194,1,STEP,464407711900,464458367000,50655100,-1
195,1,STEP,464460129700,464509512500,49382800,-1
196,1,STEP,464511186700,464560555600,49368900,-1
197,1,STEP,464562039100,464609112100,47073000,-1
198,1,STEP,464610839000,464654097100,43258100,-1
199,1,STEP,464655597700,464707504900,51907200,-1
200,1,STEP,464709336300,464757961400,48625100,-1
201,1,STEP,464759725300,464807823200,48097900,-1
202,1,STEP,464810239200,464863035700,52796500,-1
203,1,STEP,464865265100,464918881000,53615900,-1
204,1,STEP,464920664500,464970632200,49967700,-1
205,1,STEP,464972303900,465025523300,53219400,-1
206,1,STEP,465027543500,465076436400,48892900,-1
207,1,STEP,465078001900,465125810300,47808400,-1
208,1,STEP,465127252100,465172352500,45100400,-1
209,1,STEP,465173781900,465224251600,50469700,-1
210,1,STEP,465226862300,465291282200,64419900,-1
211,1,STEP,465294548100,465370486500,75938400,-1
212,1,STEP,465373431800,465455300700,81868900,-1
213,1,STEP,465458700100,465522501500,63801400,-1
214,1,STEP,465524557500,465584177000,59619500,-1
215,1,STEP,465586990800,465643996800,57006000,-1
216,1,STEP,465645997300,465706120000,60122700,-1
217,1,STEP,465708015900,465762302400,54286500,-1
218,1,STEP,465764414800,465825759700,61344900,-1
219,1,STEP,465828042000,465886096500,58054500,-1
220,1,STEP,465888901300,465950310100,61408800,-1
221,1,STEP,465952048500,466029152500,77104000,-1
222,1,STEP,466031067800,466087937100,56869300,-1
223,1,STEP,466089813600,466144316300,54502700,-1
224,1,STEP,466146163700,466205919500,59755800,-1
225,1,STEP,466207787400,466277672800,69885400,-1
226,1,STEP,466280317000,466353426900,73109900,-1
227,1,STEP,466356576200,466434276500,77700300,-1
228,1,STEP,466437352700,466512935500,75582800,-1
229,1,STEP,466515919500,466582885800,66966300,-1
230,1,STEP,466584985700,466648925500,63939800,-1
231,1,STEP,466652252900,466729309500,77056600,-1
232,1,STEP,466731072100,466783098400,52026300,-1
233,1,STEP,466784902100,466839062700,54160600,-1
234,1,STEP,466840699200,466890670200,49971000,-1
235,1,STEP,466892200300,466940265800,48065500,-1
236,1,STEP,466941728900,466996688000,54959100,-1
237,1,STEP,466998575000,467055375200,56800200,-1
238,1,STEP,467058334000,467112629500,54295500,-1
239,1,STEP,467114379100,467175585600,61206500,-1
240,1,STEP,467178038100,467251085500,73047400,-1
241,1,STEP,467254270000,467319387500,65117500,-1
242,1,STEP,467321273500,467378062000,56788500,-1
243,1,STEP,467379831000,467434469700,54638700,-1
244,1,STEP,467436446900,467495528000,59081100,-1
245,1,STEP,467497287500,467550404700,53117200,-1
246,1,STEP,467552555100,467609846700,57291600,-1
247,1,STEP,467611844400,467671895400,60051000,-1
248,1,STEP,467673904800,467728023200,54118400,-1
249,1,STEP,467730046100,467796531100,66485000,-1
250,1,STEP,467798359600,467855623000,57263400,-1
251,1,STEP,467857561100,467916200200,58639100,-1
252,1,STEP,467918258200,467988067600,69809400,-1
253,1,STEP,467990830200,468052460800,61630600,-1
254,1,STEP,468054547200,468106124000,51576800,-1
255,1,STEP,468107855500,468157793900,49938400,-1
256,1,STEP,468160054400,468208269000,48214600,-1
257,1,STEP,468209790200,468260387500,50597300,-1
258,1,STEP,468262137600,468314130300,51992700,-1
259,1,STEP,468316031400,468372281900,56250500,-1
260,1,STEP,468374291500,468438185900,63894400,-1
261,1,STEP,468440078700,468494179300,54100600,-1
262,1,STEP,468496023500,468557087600,61064100,-1
263,1,STEP,468558746400,468624323100,65576700,-1
264,1,STEP,468626059100,468687510800,61451700,-1
265,1,STEP,468689503800,468746282500,56778700,-1
266,1,STEP,468749054500,468809428000,60373500,-1
267,1,STEP,468811130200,468882629200,71499000,-1
268,1,STEP,468884541300,468935552300,51011000,-1
269,1,STEP,468937376700,468995167600,57790900,-1
270,1,STEP,468996974700,469053208700,56234000,-1
271,1,STEP,469055414400,469115633800,60219400,-1
272,1,STEP,469117504200,469181651600,64147400,-1
273,1,STEP,469183477400,469238371500,54894100,-1
274,1,STEP,469240421100,469296016500,55595400,-1
275,1,STEP,469297885200,469359084500,61199300,-1
276,1,STEP,469362111800,469438566600,76454800,-1
277,1,STEP,469440498500,469504351200,63852700,-1
278,1,STEP,469506062100,469559661500,53599400,-1
279,1,STEP,469561434000,469612256000,50822000,-1
280,1,STEP,469613929600,469664194700,50265100,-1
281,1,STEP,469665889300,469715553900,49664600,-1
282,1,STEP,469717219800,469765728800,48509000,-1
283,1,STEP,469767248600,469817456000,50207400,-1
284,1,STEP,469819285800,469875024100,55738300,-1
285,1,STEP,469877121400,469937402400,60281000,-1
286,1,STEP,469939645000,469998089400,58444400,-1
287,1,STEP,470000964700,470060847600,59882900,-1
288,1,STEP,470062668700,470120326700,57658000,-1
289,1,STEP,470122123900,470176312000,54188100,-1
290,1,STEP,470178243500,470250195300,71951800,-1
291,1,STEP,470253475700,470320068800,66593100,-1
292,1,STEP,470321895700,470375204600,53308900,-1
293,1,STEP,470377239700,470431368900,54129200,-1
294,1,STEP,470433280200,470496278400,62998200,-1
295,1,STEP,470498068200,470557356400,59288200,-1
296,1,STEP,470559234800,470613740400,54505600,-1
297,1,STEP,470615809400,470673327300,57517900,-1
298,1,STEP,470676493800,470733170000,56676200,-1
299,1,STEP,470735268100,470791260000,55991900,-1
300,1,STEP,470793231300,470852083500,58852200,-1
301,1,STEP,470854036200,470921097000,67060800,-1
302,1,STEP,470923392200,470984084400,60692200,-1
303,1,STEP,470986120100,471076245800,90125700,-1
304,1,STEP,471078231900,471138077300,59845400,-1
305,1,STEP,471139818200,471198760500,58942300,-1
306,1,STEP,471200776200,471259745500,58969300,-1
307,1,STEP,471261953100,471322337100,60384000,-1
308,1,STEP,471324545000,471386283300,61738300,-1
309,1,STEP,471390267900,471449898800,59630900,-1
310,1,STEP,471451623100,471504080700,52457600,-1
311,1,STEP,471506121300,471569626000,63504700,-1
312,1,STEP,471572621700,471634561300,61939600,-1
313,1,STEP,471636587600,471695153700,58566100,-1
314,1,STEP,471697055900,471755747700,58691800,-1
315,1,STEP,471757926200,471811166000,53239800,-1
316,1,STEP,471812944800,471865162600,52217800,-1
317,1,STEP,471867124000,471913785100,46661100,-1
318,1,STEP,471915450900,471962728700,47277800,-1
319,1,STEP,471964232400,472013582900,49350500,-1
320,1,STEP,472015422000,472063088000,47666000,-1
321,1,STEP,472064955600,472123409200,58453600,-1
322,1,STEP,472125350800,472192537700,67186900,-1
323,1,STEP,472194324800,472247269700,52944900,-1
324,1,STEP,472249095000,472302775800,53680800,-1
325,1,STEP,472304663800,472362783200,58119400,-1
326,1,STEP,472365514800,472421182700,55667900,-1
327,1,STEP,472423020700,472477785100,54764400,-1
328,1,STEP,472479471100,472534083800,54612700,-1
329,1,STEP,472536341900,472594138700,57796800,-1
330,1,STEP,472596204200,472651312600,55108400,-1
331,1,STEP,472653063700,472704853300,51789600,-1
332,1,STEP,472706859800,472761812000,54952200,-1
333,1,STEP,472763671300,472816953200,53281900,-1
334,1,STEP,472818970000,472868620300,49650300,-1
335,1,STEP,472870523200,472930023800,59500600,-1
336,1,STEP,472931701800,472990145200,58443400,-1
337,1,STEP,472992119500,473045692900,53573400,-1
338,1,STEP,473047601200,473118696300,71095100,-1
339,1,STEP,473120761000,473179941100,59180100,-1
340,1,STEP,473182026800,473245758200,63731400,-1
341,1,STEP,473247786200,473324714900,76928700,-1
342,1,STEP,473328770800,473403211500,74440700,-1
343,1,STEP,473405194800,473469883300,64688500,-1
344,1,STEP,473472057700,473537067400,65009700,-1
345,1,STEP,473539092400,473601343000,62250600,-1
346,1,STEP,473603176000,473662352200,59176200,-1
347,1,STEP,473664284700,473724373000,60088300,-1
348,1,STEP,473726654900,473790592900,63938000,-1
349,1,STEP,473792595600,473850943600,58348000,-1
350,1,STEP,473852998400,473909072300,56073900,-1
351,1,STEP,473911157700,473972007600,60849900,-1
352,1,STEP,473973943400,474030451900,56508500,-1
353,1,STEP,474032517400,474093341800,60824400,-1
354,1,STEP,474095449100,474154898000,59448900,-1
355,1,STEP,474156819400,474207785400,50966000,-1
356,1,STEP,474209675800,474265893600,56217800,-1
357,1,STEP,474267889000,474319758000,51869000,-1
358,1,STEP,474321813400,474375832600,54019200,-1
359,1,STEP,474378080700,474433803500,55722800,-1
360,1,STEP,474435774300,474491539200,55764900,-1
361,1,STEP,474493340600,474551792500,58451900,-1
362,1,STEP,474553638300,474607538300,53900000,-1
363,1,STEP,474609553200,474665323000,55769800,-1
364,1,STEP,474667225800,474721685800,54460000,-1
365,1,STEP,474723754100,474789934200,66180100,-1
366,1,STEP,474792172600,474867146000,74973400,-1
367,1,STEP,474871112700,474943450500,72337800,-1
368,1,STEP,474946955200,475014453100,67497900,-1
369,1,STEP,475017598500,475095206000,77607500,-1
370,1,STEP,475097821000,475165970200,68149200,-1
371,1,STEP,475168220900,475237623400,69402500,-1
372,1,STEP,475240954600,475311442700,70488100,-1
373,1,STEP,475313557200,475382047000,68489800,-1
374,1,STEP,475385416400,475454016100,68599700,-1
375,1,STEP,475457172300,475528506000,71333700,-1
376,1,STEP,475532333300,475600202400,67869100,-1
377,1,STEP,475602964700,475672872900,69908200,-1
378,1,STEP,475675475300,475748424400,72949100,-1
379,1,STEP,475751400000,475824492600,73092600,-1
380,1,STEP,475826920100,475896352100,69432000,-1
381,1,STEP,475899390800,475975483400,76092600,-1
382,1,STEP,475978259500,476047782500,69523000,-1
383,1,STEP,476049772400,476117397100,67624700,-1
384,1,STEP,476120089100,476191757900,71668800,-1
385,1,STEP,476194123000,476268844200,74721200,-1
386,1,STEP,476271083900,476337910600,66826700,-1
387,1,STEP,476340654600,476412664000,72009400,-1
388,1,STEP,476415401800,476491725700,76323900,-1
389,1,STEP,476494042700,476570692300,76649600,-1
390,1,STEP,476574197900,476643196200,68998300,-1
391,1,STEP,476645707100,476716789700,71082600,-1
392,1,STEP,476720679200,476792461900,71782700,-1
393,1,STEP,476795226500,476859395300,64168800,-1
394,1,STEP,476861507000,476928875100,67368100,-1
395,1,STEP,476930869300,476991292200,60422900,-1
396,1,STEP,476993257500,477051651200,58393700,-1
397,1,STEP,477053928100,477110562400,56634300,-1
398,1,STEP,477112477800,477168747100,56269300,-1
399,1,STEP,477170730800,477229560200,58829400,-1
400,1,STEP,477231310100,477287192700,55882600,-1
401,1,STEP,477289167800,477344675600,55507800,-1
402,1,STEP,477346499500,477402759700,56260200,-1
403,1,STEP,477404867900,477471452700,66584800,-1
404,1,STEP,477473435200,477546067800,72632600,-1
405,1,STEP,477548477300,477616997900,68520600,-1
406,1,STEP,477619216500,477686531100,67314600,-1
407,1,STEP,477688488500,477759987800,71499300,-1
408,1,STEP,477763388600,477837447300,74058700,-1
409,1,STEP,477840200400,477911090900,70890500,-1
410,1,STEP,477915275100,477986068100,70793000,-1
411,1,STEP,477988987300,478061327000,72339700,-1
412,1,STEP,478065809400,478143847700,78038300,-1
413,1,STEP,478146046000,478217471300,71425300,-1
414,1,STEP,478220997300,478291092500,70095200,-1
415,1,STEP,478293033700,478362772000,69738300,-1
416,1,STEP,478366141000,478431153100,65012100,-1
417,1,STEP,478435178100,478501109300,65931200,-1
418,1,STEP,478504817800,478582863900,78046100,-1
419,1,STEP,478586060200,478656984600,70924400,-1
420,1,STEP,478659059600,478714874300,55814700,-1
421,1,STEP,478716793700,478781698200,64904500,-1
422,1,STEP,478784111100,478846734800,62623700,-1
423,1,STEP,478850873000,478916727200,65854200,-1
424,1,STEP,478919405000,478994124900,74719900,-1
425,1,STEP,478997141400,479062109500,64968100,-1
426,1,STEP,479064354800,479121964600,57609800,-1
427,1,STEP,479123699500,479176258800,52559300,-1
428,1,STEP,479178273200,479241114500,62841300,-1
429,1,STEP,479243082000,479301178800,58096800,-1
430,1,STEP,479303194000,479358456500,55262500,-1
431,1,STEP,479360162000,479410461000,50299000,-1
432,1,STEP,479412590000,479463765600,51175600,-1
433,1,STEP,479465537900,479518157300,52619400,-1
434,1,STEP,479520016100,479574489700,54473600,-1
435,1,STEP,479576118300,479632997200,56878900,-1
436,1,STEP,479635080200,479687481500,52401300,-1
437,1,STEP,479689408800,479744557900,55149100,-1
438,1,STEP,479746616300,479803679300,57063000,-1
439,1,STEP,479805720400,479880573400,74853000,-1
440,1,STEP,479883004600,479950276500,67271900,-1
441,1,STEP,479952706500,480021216900,68510400,-1
442,1,STEP,480023658100,480093339300,69681200,-1
443,1,STEP,480096337900,480169144000,72806100,-1
444,1,STEP,480171668300,480238753200,67084900,-1
445,1,STEP,480241239200,480312994500,71755300,-1
446,1,STEP,480315613600,480387805700,72192100,-1
447,1,STEP,480391162700,480461536600,70373900,-1
448,1,STEP,480463977000,480532910600,68933600,-1
449,1,STEP,480535168500,480603624100,68455600,-1
450,1,STEP,480606382000,480704217000,97835000,-1
451,1,STEP,480717271200,480924037700,206766500,-1
452,1,STEP,480930143100,481101624800,171481700,-1
453,1,STEP,481108179000,481259167000,150988000,-1
454,1,STEP,481273488000,481402634000,129146000,-1
455,1,STEP,481405710300,481519184000,113473700,-1
456,1,STEP,481521735500,481610617200,88881700,-1
457,1,STEP,481613825500,481702907900,89082400,-1
458,1,STEP,481706263800,481780864700,74600900,-1
459,1,STEP,481783454200,481878245800,94791600,-1
460,1,STEP,481890074400,482075833000,185758600,-1
461,1,STEP,482083259100,482198214500,114955400,-1
462,1,STEP,482204516100,482336488500,131972400,-1
463,1,STEP,482345165800,482439552800,94387000,-1
464,1,STEP,482443986200,482573897300,129911100,-1
465,1,STEP,482579136700,482722726800,143590100,-1
466,1,STEP,482729848700,482887395200,157546500,-1
467,1,STEP,482892359000,483049129700,156770700,-1
468,1,STEP,483059240300,483257457300,198217000,-1
469,1,STEP,483267652900,483449289500,181636600,-1
470,1,STEP,483454186900,483568568500,114381600,-1
471,1,STEP,483572373300,483703315100,130941800,-1
472,1,STEP,483710383100,483833762600,123379500,-1
473,1,STEP,483839978400,483977101400,137123000,-1
474,1,STEP,483982368500,484176082400,193713900,-1
475,1,STEP,484191783700,484313103700,121320000,-1
476,1,STEP,484318257600,484412692500,94434900,-1
477,1,STEP,484417092500,484512099200,95006700,-1
478,1,STEP,484514572200,484600058800,85486600,-1
479,1,STEP,484603405900,484674247600,70841700,-1
480,1,STEP,484677175400,484750117400,72942000,-1
481,1,STEP,484752716200,484823773700,71057500,-1
482,1,STEP,484825874900,484888755600,62880700,-1
483,1,STEP,484890931700,484950415000,59483300,-1
484,1,STEP,484952875900,485023026000,70150100,-1
485,1,STEP,485025305800,485094864300,69558500,-1
486,1,STEP,485098247100,485237206600,138959500,-1
487,1,STEP,485240514700,485338071500,97556800,-1
488,1,STEP,485340620100,485436767400,96147300,-1
489,1,STEP,485439932700,485531047500,91114800,-1
490,1,STEP,485533591400,485600219600,66628200,-1
491,1,STEP,485602567800,485670271600,67703800,-1
492,1,STEP,485672621000,485745599700,72978700,-1
493,1,STEP,485749195600,485825447100,76251500,-1
494,1,STEP,485827528100,485940659300,113131200,-1
495,1,STEP,485945721600,486039023800,93302200,-1
496,1,STEP,486042004000,486122109300,80105300,-1
497,1,STEP,486124444500,486211697300,87252800,-1
498,1,STEP,486215468100,486281518900,66050800,-1
499,1,STEP,486283853300,486355941800,72088500,-1
500,1,STEP,486359173300,486445214300,86041000,-1
501,1,STEP,486448525400,486530194600,81669200,-1
502,1,STEP,486542836200,486681861900,139025700,-1
503,1,STEP,486685722000,486770946900,85224900,-1
504,1,STEP,486774016200,486846024200,72008000,-1
505,1,STEP,486848236100,486928248500,80012400,-1
506,1,STEP,486930456900,486994132000,63675100,-1
507,1,STEP,486996853600,487068184300,71330700,-1
508,1,STEP,487070206900,487140873300,70666400,-1
509,1,STEP,487143059800,487210622600,67562800,-1
510,1,STEP,487212746600,487291139300,78392700,-1
511,1,STEP,487294782700,487372800900,78018200,-1
512,1,STEP,487376722500,487449769100,73046600,-1
513,1,STEP,487451822700,487514435700,62613000,-1
514,1,STEP,487516800400,487583351400,66551000,-1
515,1,STEP,487586193300,487654442900,68249600,-1
516,1,STEP,487656826800,487730497300,73670500,-1
517,1,STEP,487732943300,487804457300,71514000,-1
518,1,STEP,487807677500,487887688200,80010700,-1
519,1,STEP,487889863500,487958969100,69105600,-1
520,1,STEP,487962304700,488040361300,78056600,-1
521,1,STEP,488043549600,488117111300,73561700,-1
522,1,STEP,488119212000,488185741100,66529100,-1
523,1,STEP,488188664300,488258073400,69409100,-1
524,1,STEP,488260250200,488337012400,76762200,-1
525,1,STEP,488339302800,488405692500,66389700,-1
526,1,STEP,488407855400,488470182100,62326700,-1
527,1,STEP,488472365500,488543781500,71416000,-1
528,1,STEP,488546929000,488609914900,62985900,-1
529,1,STEP,488612030500,488676065400,64034900,-1
530,1,STEP,488679515600,488749822200,70306600,-1
531,1,STEP,488752015400,488820377500,68362100,-1
532,1,STEP,488822892600,488880390400,57497800,-1
533,1,STEP,488882350800,488939777100,57426300,-1
534,1,STEP,488942226900,489004523000,62296100,-1
535,1,STEP,489006609500,489067420800,60811300,-1
536,1,STEP,489069351100,489126367400,57016300,-1
537,1,STEP,489128382700,489184513400,56130700,-1
538,1,STEP,489187524500,489251735800,64211300,-1
539,1,STEP,489253881000,489321666700,67785700,-1
540,1,STEP,489324367800,489381137300,56769500,-1
541,1,STEP,489382755100,489436324100,53569000,-1
542,1,STEP,489438192300,489495028000,56835700,-1
543,1,STEP,489497230400,489559663800,62433400,-1
544,1,STEP,489561714800,489622567300,60852500,-1
545,1,STEP,489624480200,489684175700,59695500,-1
546,1,STEP,489686445100,489748018300,61573200,-1
547,1,STEP,489750113000,489812991000,62878000,-1
548,1,STEP,489816506200,489873630100,57123900,-1
549,1,STEP,489876779600,489947029400,70249800,-1
550,1,STEP,489948949500,490011773100,62823600,-1
551,1,STEP,490013557900,490070468100,56910200,-1
552,1,STEP,490072468500,490147393300,74924800,-1
553,1,STEP,490149731400,490212571000,62839600,-1
554,1,STEP,490214602900,490273926600,59323700,-1
555,1,STEP,490276030100,490340878400,64848300,-1
556,1,STEP,490342948300,490400824200,57875900,-1
557,1,STEP,490402709400,490459043800,56334400,-1
558,1,STEP,490461075200,490518515400,57440200,-1
559,1,STEP,490520488400,490578671000,58182600,-1
560,1,STEP,490580707700,490636659500,55951800,-1
561,1,STEP,490638530000,490695848100,57318100,-1
562,1,STEP,490698048000,490754237200,56189200,-1
563,1,STEP,490756035200,490811688700,55653500,-1
564,1,STEP,490813351000,490866173800,52822800,-1
565,1,STEP,490867985500,490923777000,55791500,-1
566,1,STEP,490925794700,490984497700,58703000,-1
567,1,STEP,490986372700,491053067500,66694800,-1
568,1,STEP,491055075400,491111644200,56568800,-1
569,1,STEP,491113527900,491172467800,58939900,-1
570,1,STEP,491174481000,491229437100,54956100,-1
571,1,STEP,491231717100,491294032900,62315800,-1
572,1,STEP,491296157400,491356768900,60611500,-1
573,1,STEP,491358773600,491419358500,60584900,-1
574,1,STEP,491421359700,491481344600,59984900,-1
575,1,STEP,491483463800,491547930600,64466800,-1
576,1,STEP,491550110000,491632201800,82091800,-1
577,1,STEP,491635438400,491694471100,59032700,-1
578,1,STEP,491696308800,491752880800,56572000,-1
579,1,STEP,491755521800,491815395800,59874000,-1
580,1,STEP,491817221200,491878021500,60800300,-1
581,1,STEP,491880028000,491938243400,58215400,-1
582,1,STEP,491940494100,492002504400,62010300,-1
583,1,STEP,492005428400,492074717400,69289000,-1
584,1,STEP,492076589200,492133911400,57322200,-1
585,1,STEP,492136776200,492194920500,58144300,-1
586,1,STEP,492197349800,492256754400,59404600,-1
587,1,STEP,492258951800,492317632000,58680200,-1
588,1,STEP,492319650000,492379012200,59362200,-1
589,1,STEP,492381202500,492442154600,60952100,-1
590,1,STEP,492444048500,492502915400,58866900,-1
591,1,STEP,492504817000,492560204800,55387800,-1
592,1,STEP,492562028300,492619693500,57665200,-1
593,1,STEP,492621751900,492683332200,61580300,-1
594,1,STEP,492685309500,492742610900,57301400,-1
595,1,STEP,492744545100,492799443000,54897900,-1
596,1,STEP,492801629500,492858456700,56827200,-1
597,1,STEP,492860458800,492924223900,63765100,-1
598,1,STEP,492926246700,492983399900,57153200,-1
599,1,STEP,492985060700,493037282400,52221700,-1
600,1,STEP,493039122600,493093294900,54172300,-1
601,1,STEP,493095067800,493151439200,56371400,-1
602,1,STEP,493153381300,493204475900,51094600,-1
603,1,STEP,493206212800,493256547800,50335000,-1
604,1,STEP,493258233700,493327404800,69171100,-1
605,1,STEP,493329241600,493378807800,49566200,-1
606,1,STEP,493380580500,493435533900,54953400,-1
607,1,STEP,493437213400,493490112700,52899300,-1
608,1,STEP,493491909900,493545612000,53702100,-1
609,1,STEP,493547482600,493601741200,54258600,-1
610,1,STEP,493603914600,493659379500,55464900,-1
611,1,STEP,493661244000,493715990300,54746300,-1
612,1,STEP,493718032300,493769820700,51788400,-1
613,1,STEP,493771577600,493828030900,56453300,-1
614,1,STEP,493830034100,493881769200,51735100,-1
615,1,STEP,493884113200,493937021200,52908000,-1
616,1,STEP,493938530200,493989942100,51411900,-1
617,1,STEP,493991687500,494042383500,50696000,-1
618,1,STEP,494044258900,494198636500,154377600,-1
619,1,STEP,494211394400,494361131600,149737200,-1
620,1,STEP,494364964600,494482344400,117379800,-1
621,1,STEP,494486506300,494575793300,89287000,-1
622,1,STEP,494577882500,494642477000,64594500,-1
623,1,STEP,494644897100,494712428500,67531400,-1
624,1,STEP,494714690800,494786130700,71439900,-1
625,1,STEP,494788267100,494852420700,64153600,-1
626,1,STEP,494854050300,494907386900,53336600,-1
627,1,STEP,494909255400,494962592100,53336700,-1
628,1,STEP,494964315200,495019203300,54888100,-1
629,1,STEP,495021006800,495077336800,56330000,-1
630,1,STEP,495079473100,495134039400,54566300,-1
631,1,STEP,495136013300,495188028500,52015200,-1
632,1,STEP,495190261100,495241839800,51578700,-1
633,1,STEP,495243562000,495298510700,54948700,-1
634,1,STEP,495300492900,495354567900,54075000,-1
635,1,STEP,495356356400,495415065100,58708700,-1
636,1,STEP,495416885600,495472474000,55588400,-1
637,1,STEP,495474473800,495527394900,52921100,-1
638,1,STEP,495529153300,495581272100,52118800,-1
639,1,STEP,495582955900,495635588900,52633000,-1
640,1,STEP,495637379600,495689193700,51814100,-1
641,1,STEP,495691147500,495748472700,57325200,-1
642,1,STEP,495751324600,495808965800,57641200,-1
643,1,STEP,495810756300,495862930000,52173700,-1
644,1,STEP,495867230500,495930583400,63352900,-1
645,1,STEP,495932383800,495990104500,57720700,-1
646,1,STEP,495992079300,496077004600,84925300,-1
647,1,STEP,496078993700,496147498200,68504500,-1
648,1,STEP,496150536900,496219552000,69015100,-1
649,1,STEP,496221619400,496308647000,87027600,-1
650,1,STEP,496311762700,496378284200,66521500,-1
651,1,STEP,496380301600,496440827900,60526300,-1
652,1,STEP,496442922000,496508066100,65144100,-1
653,1,STEP,496510257900,496572843900,62586000,-1
654,1,STEP,496574784500,496629892500,55108000,-1
655,1,STEP,496631765400,496686693900,54928500,-1
656,1,STEP,496688516400,496741653100,53136700,-1
657,1,STEP,496743610200,496805218200,61608000,-1
658,1,STEP,496806784400,496864962000,58177600,-1
659,1,STEP,496866927700,496923931200,57003500,-1
660,1,STEP,496926563700,496980327600,53763900,-1
661,1,STEP,496982426900,497039500800,57073900,-1
662,1,STEP,497041279900,497094902900,53623000,-1
663,1,STEP,497096724300,497148770100,52045800,-1
664,1,STEP,497150622800,497203471100,52848300,-1
665,1,STEP,497205327400,497257973000,52645600,-1
666,1,STEP,497260019500,497316258800,56239300,-1
667,1,STEP,497318001200,497365691800,47690600,-1
668,1,STEP,497367317000,497417500800,50183800,-1
669,1,STEP,497419305300,497474054300,54749000,-1
670,1,STEP,497476141400,497528289300,52147900,-1
671,1,STEP,497530059000,497580197500,50138500,-1
672,1,STEP,497581813700,497633002700,51189000,-1
673,1,STEP,497634928700,497684621700,49693000,-1
674,1,STEP,497686512800,497740347000,53834200,-1
675,1,STEP,497742628900,497799617600,56988700,-1
676,1,STEP,497801341500,497857314200,55972700,-1
677,1,STEP,497859194000,497918497200,59303200,-1
678,1,STEP,497920280700,497979413800,59133100,-1
679,1,STEP,497981319700,498034906600,53586900,-1
680,1,STEP,498036746800,498089592600,52845800,-1
681,1,STEP,498091342200,498144609900,53267700,-1
682,1,STEP,498146475100,498198421300,51946200,-1
683,1,STEP,498200340800,498252914300,52573500,-1
684,1,STEP,498254740000,498315813300,61073300,-1
685,1,STEP,498318295200,498373452700,55157500,-1
686,1,STEP,498375630500,498430755700,55125200,-1
687,1,STEP,498432518300,498483685700,51167400,-1
688,1,STEP,498485496700,498540588200,55091500,-1
689,1,STEP,498542416400,498592955900,50539500,-1
690,1,STEP,498594817700,498646362100,51544400,-1
691,1,STEP,498648257700,498697625500,49367800,-1
692,1,STEP,498699286600,498750323200,51036600,-1
693,1,STEP,498752256000,498814164700,61908700,-1
694,1,STEP,498816225900,498879339700,63113800,-1
695,1,STEP,498881203400,498939721300,58517900,-1
696,1,STEP,498942126400,498997765300,55638900,-1
697,1,STEP,498999589700,499054342600,54752900,-1
698,1,STEP,499056132100,499111792600,55660500,-1
699,1,STEP,499114551300,499170653300,56102000,-1
700,1,STEP,499172606100,499231695100,59089000,-1
701,1,STEP,499233931200,499292412700,58481500,-1
702,1,STEP,499295329800,499353699900,58370100,-1
703,1,STEP,499355617000,499414299500,58682500,-1
704,1,STEP,499416299700,499469421600,53121900,-1
705,1,STEP,499471163000,499537551600,66388600,-1
706,1,STEP,499540645500,499611493800,70848300,-1
707,1,STEP,499613947300,499675622400,61675100,-1
708,1,STEP,499677742400,499738799400,61057000,-1
709,1,STEP,499741323700,499803074600,61750900,-1
710,1,STEP,499805662900,499868114300,62451400,-1
711,1,STEP,499870276500,499923378500,53102000,-1
712,1,STEP,499925212600,499981082200,55869600,-1
713,1,STEP,499982921300,500037686800,54765500,-1
714,1,STEP,500039608500,500094015600,54407100,-1
715,1,STEP,500095788100,500145109100,49321000,-1
716,1,STEP,500146844400,500202700000,55855600,-1
717,1,STEP,500205848800,500272467000,66618200,-1
718,1,STEP,500275635000,500340628700,64993700,-1
719,1,STEP,500342722500,500402253400,59530900,-1
720,1,STEP,500404197300,500465517900,61320600,-1
721,1,STEP,500467468700,500528080200,60611500,-1
722,1,STEP,500529970000,500583735900,53765900,-1
723,1,STEP,500585628000,500642389200,56761200,-1
724,1,STEP,500644499500,500700617100,56117600,-1
725,1,STEP,500702356000,500755978600,53622600,-1
726,1,STEP,500757698100,500811005100,53307000,-1
727,1,STEP,500812834500,500868767500,55933000,-1
728,1,STEP,500871057500,500928861100,57803600,-1
729,1,STEP,500930656700,500986858900,56202200,-1
730,1,STEP,500989069800,501042026600,52956800,-1
731,1,STEP,501043879100,501104830700,60951600,-1
732,1,STEP,501106725300,501163888500,57163200,-1
733,1,STEP,501165725700,501219507300,53781600,-1
734,1,STEP,501221348600,501273626800,52278200,-1
735,1,STEP,501275436000,501326223800,50787800,-1
736,1,STEP,501327941500,501381653300,53711800,-1
737,1,STEP,501383670500,501437812200,54141700,-1
738,1,STEP,501439672000,501491366100,51694100,-1
739,1,STEP,501493133600,501544242600,51109000,-1
740,1,STEP,501546039300,501597391600,51352300,-1
741,1,STEP,501599198600,501657267900,58069300,-1
742,1,STEP,501659066100,501710514800,51448700,-1
743,1,STEP,501714067500,501769659200,55591700,-1
744,1,STEP,501771411300,501822945300,51534000,-1
745,1,STEP,501824816700,501883982100,59165400,-1
746,1,STEP,501885755300,501939795100,54039800,-1
747,1,STEP,501941829700,501995269200,53439500,-1
748,1,STEP,501996809300,502049151900,52342600,-1
749,1,STEP,502051002800,502103349600,52346800,-1
750,1,STEP,502105096800,502159473200,54376400,-1
751,1,STEP,502161239000,502217342300,56103300,-1
752,1,STEP,502219614700,502271251000,51636300,-1
753,1,STEP,502273062400,502325141200,52078800,-1
754,1,STEP,502327071200,502385264700,58193500,-1
755,1,STEP,502387087100,502437606000,50518900,-1
756,1,STEP,502439414300,502497157500,57743200,-1
757,1,STEP,502499139700,502553036000,53896300,-1
758,1,STEP,502554852600,502605419500,50566900,-1
759,1,STEP,502607595700,502661122200,53526500,-1
760,1,STEP,502662965500,502715691700,52726200,-1
761,1,STEP,502717664900,502771096700,53431800,-1
762,1,STEP,502773036200,502822658700,49622500,-1
763,1,STEP,502824395100,502877296800,52901700,-1
764,1,STEP,502879435900,502930810200,51374300,-1
765,1,STEP,502932583100,503000695000,68111900,-1
766,1,STEP,503002191800,503051577400,49385600,-1
767,1,STEP,503053256600,503103507400,50250800,-1
768,1,STEP,503105224200,503158028900,52804700,-1
769,1,STEP,503159789400,503209634400,49845000,-1
770,1,STEP,503212097700,503259842600,47744900,-1
771,1,STEP,503261364300,503308627500,47263200,-1
772,1,STEP,503310279100,503359995700,49716600,-1
773,1,STEP,503361923900,503418323400,56399500,-1
774,1,STEP,503422443100,503487854500,65411400,-1
775,1,STEP,503489553900,503539922000,50368100,-1
776,1,STEP,503541812800,503591616400,49803600,-1
777,1,STEP,503593295600,503642209100,48913500,-1
778,1,STEP,503644067300,503696432600,52365300,-1
779,1,STEP,503698342700,503753832400,55489700,-1
780,1,STEP,503755836400,503811268400,55432000,-1
781,1,STEP,503814269500,503869305100,55035600,-1
782,1,STEP,503871328700,503925317500,53988800,-1
783,1,STEP,503927357500,503981891700,54534200,-1
784,1,STEP,503983783000,504040210100,56427100,-1
785,1,STEP,504042210100,504098637200,56427100,-1
786,1,STEP,504100380900,504155513400,55132500,-1
787,1,STEP,504157429100,504215922400,58493300,-1
788,1,STEP,504217926600,504266863200,48936600,-1
789,1,STEP,504268608600,504317890500,49281900,-1
790,1,STEP,504319357700,504367576200,48218500,-1
791,1,STEP,504368996800,504418732500,49735700,-1
792,1,STEP,504420274300,504470890800,50616500,-1
793,1,STEP,504473087000,504543570400,70483400,-1
794,1,STEP,504545703500,504598551900,52848400,-1
795,1,STEP,504600251000,504655998500,55747500,-1
796,1,STEP,504657936100,504710215700,52279600,-1
797,1,STEP,504712027400,504764253600,52226200,-1
798,1,STEP,504766154000,504826673700,60519700,-1
799,1,STEP,504828703100,504887433500,58730400,-1
800,1,STEP,504889486500,504952513500,63027000,-1
801,1,STEP,504954642500,505010111100,55468600,-1
802,1,STEP,505012259200,505068290200,56031000,-1
803,1,STEP,505069975200,505118616200,48641000,-1
804,1,STEP,505120202000,505167592800,47390800,-1
805,1,STEP,505169349500,505220196200,50846700,-1
806,1,STEP,505222209500,505276652300,54442800,-1
807,1,STEP,505278438700,505329762700,51324000,-1
808,1,STEP,505331753300,505384489900,52736600,-1
809,1,STEP,505386114000,505436791400,50677400,-1
810,1,STEP,505438493400,505486942900,48449500,-1
811,1,STEP,505488502200,505537483300,48981100,-1
812,1,STEP,505539181400,505592428600,53247200,-1
813,1,STEP,505594345600,505656595000,62249400,-1
814,1,STEP,505659081700,505710763700,51682000,-1
815,1,STEP,505712885500,505766592500,53707000,-1
816,1,STEP,505768351100,505819939700,51588600,-1
817,1,STEP,505821716000,505875953600,54237600,-1
818,1,STEP,505877857400,505933859700,56002300,-1
819,1,STEP,505935757600,505986247300,50489700,-1
820,1,STEP,505988038600,506037151400,49112800,-1
821,1,STEP,506038895800,506087634700,48738900,-1
822,1,STEP,506089467100,506145672100,56205000,-1
823,1,STEP,506147773300,506197064500,49291200,-1
824,1,STEP,506198554300,506247325200,48770900,-1
825,1,STEP,506249052500,506351573500,102521000,-1
826,1,STEP,506354307900,506442686100,88378200,-1
827,1,STEP,506448089600,506520590500,72500900,-1
828,1,STEP,506522998300,506610141200,87142900,-1
829,1,STEP,506613212300,506690319600,77107300,-1
830,1,STEP,506693580000,506764300500,70720500,-1
831,1,STEP,506766471100,506830430500,63959400,-1
832,1,STEP,506832573600,506899077800,66504200,-1
833,1,STEP,506901230600,506968963200,67732600,-1
834,1,STEP,506971212900,507034570100,63357200,-1
835,1,STEP,507036757500,507111839900,75082400,-1
836,1,STEP,507114453200,507210115200,95662000,-1
837,1,STEP,507213704400,507309579400,95875000,-1
838,1,STEP,507312353900,507388632400,76278500,-1
839,1,STEP,507390842400,507457999800,67157400,-1
840,1,STEP,507460111600,507520913200,60801600,-1
841,1,STEP,507522649200,507578936200,56287000,-1
842,1,STEP,507580908700,507641496600,60587900,-1
843,1,STEP,507643649900,507695997300,52347400,-1
844,1,STEP,507697682300,507753205800,55523500,-1
845,1,STEP,507755152500,507814463600,59311100,-1
846,1,STEP,507816215600,507866798700,50583100,-1
847,1,STEP,507868567900,507921937400,53369500,-1
848,1,STEP,507923700400,507986044800,62344400,-1
849,1,STEP,507988050900,508052330900,64280000,-1
850,1,STEP,508054584500,508125263900,70679400,-1
851,1,STEP,508127356600,508192795600,65439000,-1
852,1,STEP,508194752600,508251784300,57031700,-1
853,1,STEP,508253865700,508312195100,58329400,-1
854,1,STEP,508314030700,508372845200,58814500,-1
855,1,STEP,508374933500,508434119700,59186200,-1
856,1,STEP,508436345100,508489084000,52738900,-1
857,1,STEP,508490930000,508545591600,54661600,-1
858,1,STEP,508547496400,508602474200,54977800,-1
859,1,STEP,508604251100,508657180900,52929800,-1
860,1,STEP,508658837900,508714686800,55848900,-1
861,1,STEP,508716661200,508773167300,56506100,-1
862,1,STEP,508775088500,508826420000,51331500,-1
863,1,STEP,508828107000,508878186800,50079800,-1
864,1,STEP,508879842800,508931704800,51862000,-1
865,1,STEP,508933836000,508986369600,52533600,-1
866,1,STEP,508990636300,509046966100,56329800,-1
867,1,STEP,509048837700,509103221600,54383900,-1
868,1,STEP,509105153700,509174693500,69539800,-1
869,1,STEP,509176347000,509235585600,59238600,-1
870,1,STEP,509237598500,509292128700,54530200,-1
871,1,STEP,509294058400,509351780600,57722200,-1
872,1,STEP,509353950800,509410507300,56556500,-1
873,1,STEP,509412619600,509464676500,52056900,-1
874,1,STEP,509466383600,509519996700,53613100,-1
875,1,STEP,509521940300,509582415400,60475100,-1
876,1,STEP,509585213000,509640382500,55169500,-1
877,1,STEP,509642294100,509699915500,57621400,-1
878,1,STEP,509701897000,509756708800,54811800,-1
879,1,STEP,509758626700,509810201100,51574400,-1
880,1,STEP,509811895700,509865126400,53230700,-1
881,1,STEP,509866955500,509920356100,53400600,-1
882,1,STEP,509922092700,509977851300,55758600,-1
883,1,STEP,509979729900,510031744000,52014100,-1
884,1,STEP,510033434100,510083464100,50030000,-1
885,1,STEP,510085285300,510140892900,55607600,-1
886,1,STEP,510143225400,510198416800,55191400,-1
887,1,STEP,510200402700,510261555100,61152400,-1
888,1,STEP,510265327900,510317223900,51896000,-1
889,1,STEP,510319375100,510376202600,56827500,-1
890,1,STEP,510380576100,510440744800,60168700,-1
891,1,STEP,510442699200,510497075800,54376600,-1
892,1,STEP,510498821500,510551192100,52370600,-1
893,1,STEP,510553116100,510606910400,53794300,-1
894,1,STEP,510608908900,510661847900,52939000,-1
895,1,STEP,510663898200,510724403500,60505300,-1
896,1,STEP,510726424400,510796905400,70481000,-1
897,1,STEP,510799094900,510848975400,49880500,-1
898,1,STEP,510850820100,510902761400,51941300,-1
899,1,STEP,510904462900,510955551100,51088200,-1
900,1,STEP,510957392100,511008076400,50684300,-1
901,1,STEP,511010364400,511059318600,48954200,-1
902,1,STEP,511061249000,511131285100,70036100,-1
903,1,STEP,511132807800,511189645600,56837800,-1
904,1,STEP,511192101100,511249414400,57313300,-1
905,1,STEP,511251414500,511316468200,65053700,-1
906,1,STEP,511318680300,511380663100,61982800,-1
907,1,STEP,511382651800,511442747800,60096000,-1
908,1,STEP,511444818300,511503803500,58985200,-1
909,1,STEP,511505848300,511564850400,59002100,-1
910,1,STEP,511566717200,511615397900,48680700,-1
911,1,STEP,511617006500,511668581400,51574900,-1
912,1,STEP,511670640600,511721885000,51244400,-1
913,1,STEP,511726096400,511784660300,58563900,-1
914,1,STEP,511786911200,511842288700,55377500,-1
915,1,STEP,511844141100,511901177700,57036600,-1
916,1,STEP,511903048100,511965250200,62202100,-1
917,1,STEP,511967501900,512037354900,69853000,-1
918,1,STEP,512040213400,512104454300,64240900,-1
919,1,STEP,512106438000,512163922700,57484700,-1
920,1,STEP,512165682900,512218627600,52944700,-1
921,1,STEP,512220435000,512272498400,52063400,-1
922,1,STEP,512274147400,512325561000,51413600,-1
923,1,STEP,512327483600,512381697600,54214000,-1
924,1,STEP,512383405200,512433999000,50593800,-1
925,1,STEP,512435705300,512482490900,46785600,-1
926,1,STEP,512484109400,512537659600,53550200,-1
927,1,STEP,512539559300,512592950800,53391500,-1
928,1,STEP,512594879000,512655425400,60546400,-1
929,1,STEP,512657614900,512715860100,58245200,-1
930,1,STEP,512718144500,512779454800,61310300,-1
931,1,STEP,512781311800,512838631800,57320000,-1
932,1,STEP,512840802700,512900175100,59372400,-1
933,1,STEP,512902197200,512956405800,54208600,-1
934,1,STEP,512958342600,513011496600,53154000,-1
935,1,STEP,513013519500,513064146900,50627400,-1
936,1,STEP,513066449100,513124419300,57970200,-1
937,1,STEP,513126771600,513180348200,53576600,-1
938,1,STEP,513182099200,513239189700,57090500,-1
939,1,STEP,513241163700,513293456700,52293000,-1
940,1,STEP,513295569200,513350495400,54926200,-1
941,1,STEP,513352523000,513410940700,58417700,-1
942,1,STEP,513412939700,513463997100,51057400,-1
943,1,STEP,513466053400,513517431700,51378300,-1
944,1,STEP,513519252600,513569737900,50485300,-1
945,1,STEP,513572116100,513623672000,51555900,-1
946,1,STEP,513625369500,513680874100,55504600,-1
947,1,STEP,513684539500,513744184100,59644600,-1
948,1,STEP,513745858800,513799624100,53765300,-1
949,1,STEP,513801518700,513860723800,59205100,-1
950,1,STEP,513862690300,513920367800,57677500,-1
951,1,STEP,513921979400,513973796300,51816900,-1
952,1,STEP,513976178200,514032005400,55827200,-1
953,1,STEP,514033802200,514099285600,65483400,-1
954,1,STEP,514101157700,514150395000,49237300,-1
955,1,STEP,514152283100,514206873600,54590500,-1
956,1,STEP,514208805300,514267897200,59091900,-1
957,1,STEP,514269783300,514327930100,58146800,-1
958,1,STEP,514329969500,514382549200,52579700,-1
959,1,STEP,514384483000,514442220600,57737600,-1
960,1,STEP,514444082400,514497482400,53400000,-1
961,1,STEP,514499180600,514553025200,53844600,-1
962,1,STEP,514554971300,514612439600,57468300,-1
963,1,STEP,514614326200,514669212000,54885800,-1
964,1,STEP,514671605300,514724988100,53382800,-1
965,1,STEP,514726940100,514785193900,58253800,-1
966,1,STEP,514787117700,514846275300,59157600,-1
967,1,STEP,514848404300,514916486200,68081900,-1
968,1,STEP,514919096400,514978481000,59384600,-1
969,1,STEP,514980437900,515039495600,59057700,-1
970,1,STEP,515041750200,515104610000,62859800,-1
971,1,STEP,515107152100,515166381800,59229700,-1
972,1,STEP,515168258400,515225677200,57418800,-1
973,1,STEP,515228461900,515284290600,55828700,-1
974,1,STEP,515286066900,515336780500,50713600,-1
975,1,STEP,515338650400,515388246700,49596300,-1
976,1,STEP,515389879400,515446407400,56528000,-1
977,1,STEP,515448502600,515501161200,52658600,-1
978,1,STEP,515503100800,515559699100,56598300,-1
979,1,STEP,515561793600,515611809900,50016300,-1
980,1,STEP,515613551200,515664401800,50850600,-1
981,1,STEP,515666409400,515715982300,49572900,-1
982,1,STEP,515717631400,515768827800,51196400,-1
983,1,STEP,515770851700,515828280500,57428800,-1
984,1,STEP,515830358400,515880584000,50225600,-1
985,1,STEP,515882340600,515934640500,52299900,-1
986,1,STEP,515936523900,515996455900,59932000,-1
987,1,STEP,515998243000,516062026000,63783000,-1
988,1,STEP,516064342700,516126911400,62568700,-1
989,1,STEP,516129109900,516181514500,52404600,-1
990,1,STEP,516183435100,516237562200,54127100,-1
991,1,STEP,516239559900,516298156600,58596700,-1
992,1,STEP,516300333500,516363947300,63613800,-1
993,1,STEP,516366470000,516421914700,55444700,-1
994,1,STEP,516423881000,516482084800,58203800,-1
995,1,STEP,516484335200,516541718500,57383300,-1
996,1,STEP,516543696600,516600557000,56860400,-1
997,1,STEP,516602590900,516659126400,56535500,-1
998,1,STEP,516660937100,516713584900,52647800,-1
999,1,STEP,516715557900,516775320200,59762300,-1
