Gen,Resource,Stamp,TimeStamp_Start,TimeStamp_End,Duration,Indiv_id
0,1,TransfertToDevice,457283919100,457640522700,356603600,-1
0,1,STEP,457773612400,457787084400,13472000,-1
1,1,STEP,457787150200,457800132700,12982500,-1
2,1,STEP,457800176000,457813238500,13062500,-1
3,1,STEP,457813284300,457826702100,13417800,-1
4,1,STEP,457826757300,457839934000,13176700,-1
5,1,STEP,457839981000,457853469000,13488000,-1
6,1,STEP,457853512300,457866799300,13287000,-1
7,1,STEP,457866851800,457880071700,13219900,-1
8,1,STEP,457880122100,457892997000,12874900,-1
9,1,STEP,457893042700,457906008100,12965400,-1
10,1,STEP,457906053400,457919351600,13298200,-1
11,1,STEP,457919396700,457932808200,13411500,-1
12,1,STEP,457932864300,457945932800,13068500,-1
13,1,STEP,457945981200,457959109700,13128500,-1
14,1,STEP,457959156500,457972405500,13249000,-1
15,1,STEP,457972453600,457985903700,13450100,-1
16,1,STEP,457985954700,457999162000,13207300,-1
17,1,STEP,457999210900,458012744300,13533400,-1
18,1,STEP,458012800000,458026476400,13676400,-1
19,1,STEP,458026527400,458040182800,13655400,-1
20,1,STEP,458040236000,458053677100,13441100,-1
21,1,STEP,458053730400,458066974900,13244500,-1
22,1,STEP,458067021200,458080182700,13161500,-1
23,1,STEP,458080229300,458093925000,13695700,-1
24,1,STEP,458093973800,458106936800,12963000,-1
25,1,STEP,458106979300,458120311100,13331800,-1
26,1,STEP,458120353300,458133784100,13430800,-1
27,1,STEP,458133834300,458147282100,13447800,-1
28,1,STEP,458147324100,458160886000,13561900,-1
29,1,STEP,458160927800,458174156700,13228900,-1
30,1,STEP,458174201400,458187259600,13058200,-1
31,1,STEP,458187310500,458200807500,13497000,-1
32,1,STEP,458200845700,458214088300,13242600,-1
33,1,STEP,458214138200,458226694200,12556000,-1
34,1,STEP,458226737300,458239833400,13096100,-1
35,1,STEP,458239881700,458253051400,13169700,-1
36,1,STEP,458253097100,458265942700,12845600,-1
37,1,STEP,458265991400,458279357500,13366100,-1
38,1,STEP,458279404800,458292835600,13430800,-1
39,1,STEP,458292884900,458306047400,13162500,-1
40,1,STEP,458306094900,458319343800,13248900,-1
41,1,STEP,458319389200,458332667000,13277800,-1
42,1,STEP,458332724300,458345941000,13216700,-1
43,1,STEP,458345995400,458359314300,13318900,-1
44,1,STEP,458359376800,458372712700,13335900,-1
45,1,STEP,458372761800,458386400100,13638300,-1
46,1,STEP,458386444700,458399785800,13341100,-1
47,1,STEP,458399840200,458413286200,13446000,-1
48,1,STEP,458413342200,458426918700,13576500,-1
49,1,STEP,458426966100,458440605100,13639000,-1
50,1,STEP,458440655500,458454177900,13522400,-1
51,1,STEP,458454225300,458467784500,13559200,-1
52,1,STEP,458467830700,458481405300,13574600,-1
53,1,STEP,458481458600,458495054000,13595400,-1
54,1,STEP,458495106300,458509028700,13922400,-1
55,1,STEP,458509075600,458523079500,14003900,-1
56,1,STEP,458523127700,458537240400,14112700,-1
57,1,STEP,458537290800,458551520200,14229400,-1
58,1,STEP,458551579000,458565900300,14321300,-1
59,1,STEP,458565942800,458580598200,14655400,-1
60,1,STEP,458580641400,458595398800,14757400,-1
61,1,STEP,458595444500,458609980300,14535800,-1
62,1,STEP,458610033300,458624345700,14312400,-1
63,1,STEP,458624413800,458638918000,14504200,-1
64,1,STEP,458638967200,458653564900,14597700,-1
65,1,STEP,458653603400,458667956300,14352900,-1
66,1,STEP,458668013200,458682405700,14392500,-1
67,1,STEP,458682458200,458696989100,14530900,-1
68,1,STEP,458697036500,458711905200,14868700,-1
69,1,STEP,458711953800,458726601200,14647400,-1
70,1,STEP,458726644700,458741889900,15245200,-1
71,1,STEP,458741933300,458756708900,14775600,-1
72,1,STEP,458756759000,458771405500,14646500,-1
73,1,STEP,458771450200,458786836400,15386200,-1
74,1,STEP,458786889600,458802287100,15397500,-1
75,1,STEP,458802335100,458817394600,15059500,-1
76,1,STEP,458817478600,458832459300,14980700,-1
77,1,STEP,458832508300,458847232500,14724200,-1
78,1,STEP,458847282800,458862168500,14885700,-1
79,1,STEP,458862213000,458877064200,14851200,-1
80,1,STEP,458877114400,458891935800,14821400,-1
81,1,STEP,458891985100,458907251200,15266100,-1
82,1,STEP,458907298500,458922297800,14999300,-1
83,1,STEP,458922353000,458937690800,15337800,-1
84,1,STEP,458937744800,458952834400,15089600,-1
85,1,STEP,458952889800,458967906300,15016500,-1
86,1,STEP,458967958100,458983256100,15298000,-1
87,1,STEP,458983302800,458998310700,15007900,-1
88,1,STEP,458998365100,459013691600,15326500,-1
89,1,STEP,459013740900,459028854300,15113400,-1
90,1,STEP,459028898200,459043743200,14845000,-1
91,1,STEP,459043822100,459058563100,14741000,-1
92,1,STEP,459058619500,459073973800,15354300,-1
93,1,STEP,459074024100,459088560900,14536800,-1
94,1,STEP,459088619500,459103853900,15234400,-1
95,1,STEP,459103908800,459118871500,14962700,-1
96,1,STEP,459118918100,459133505600,14587500,-1
97,1,STEP,459133555200,459147773600,14218400,-1
98,1,STEP,459147881300,459162505500,14624200,-1
99,1,STEP,459162558100,459176963800,14405700,-1
100,1,STEP,459177014700,459192009500,14994800,-1
101,1,STEP,459192057200,459206835400,14778200,-1
102,1,STEP,459206917600,459221604700,14687100,-1
103,1,STEP,459221662400,459236750900,15088500,-1
104,1,STEP,459236811200,459252243800,15432600,-1
105,1,STEP,459252304500,459267045800,14741300,-1
106,1,STEP,459267102000,459282209200,15107200,-1
107,1,STEP,459282259300,459297016100,14756800,-1
108,1,STEP,459297067600,459311905200,14837600,-1
109,1,STEP,459311987700,459327071900,15084200,-1
110,1,STEP,459327132100,459341825000,14692900,-1
111,1,STEP,459341903900,459357323300,15419400,-1
112,1,STEP,459357376700,459372000200,14623500,-1
113,1,STEP,459372043800,459387712200,15668400,-1
114,1,STEP,459387807400,459402837200,15029800,-1
115,1,STEP,459402922200,459417830300,14908100,-1
116,1,STEP,459417914800,459433393500,15478700,-1
117,1,STEP,459433444200,459448863600,15419400,-1
118,1,STEP,459448902900,459463807000,14904100,-1
119,1,STEP,459463915700,459478810400,14894700,-1
120,1,STEP,459478862000,459493872700,15010700,-1
121,1,STEP,459493924900,459508297800,14372900,-1
122,1,STEP,459508346600,459522844900,14498300,-1
123,1,STEP,459522905300,459537390600,14485300,-1
124,1,STEP,459537439400,459551975200,14535800,-1
125,1,STEP,459552020300,459567362700,15342400,-1
126,1,STEP,459567410100,459582582100,15172000,-1
127,1,STEP,459582636000,459597562000,14926000,-1
128,1,STEP,459597618900,459612728400,15109500,-1
129,1,STEP,459612775900,459627543300,14767400,-1
130,1,STEP,459627602400,459642244200,14641800,-1
131,1,STEP,459642299100,459657385200,15086100,-1
132,1,STEP,459657456300,459672660300,15204000,-1
133,1,STEP,459672747800,459687552300,14804500,-1
134,1,STEP,459687629100,459702240900,14611800,-1
135,1,STEP,459702298100,459717067200,14769100,-1
136,1,STEP,459717128000,459731706100,14578100,-1
137,1,STEP,459731753500,459746584800,14831300,-1
138,1,STEP,459746638700,459761862800,15224100,-1
139,1,STEP,459761952000,459777088600,15136600,-1
140,1,STEP,459777144900,459792500400,15355500,-1
141,1,STEP,459792544600,459807388500,14843900,-1
142,1,STEP,459807453200,459822502200,15049000,-1
143,1,STEP,459822551600,459837846200,15294600,-1
144,1,STEP,459837897600,459853420200,15522600,-1
145,1,STEP,459853456800,459869033000,15576200,-1
146,1,STEP,459869081500,459884092900,15011400,-1
147,1,STEP,459884139600,459899570400,15430800,-1
148,1,STEP,459899614600,459915019000,15404400,-1
149,1,STEP,459915067900,459930815300,15747400,-1
150,1,STEP,459930869100,459946011200,15142100,-1
151,1,STEP,459946099400,459961590700,15491300,-1
152,1,STEP,459961639700,459976740800,15101100,-1
153,1,STEP,459976799500,459991964800,15165300,-1
154,1,STEP,459992004400,460007426300,15421900,-1
155,1,STEP,460007470000,460023210900,15740900,-1
156,1,STEP,460023249400,460038885200,15635800,-1
157,1,STEP,460038934300,460054197700,15263400,-1
158,1,STEP,460054254000,460069013500,14759500,-1
159,1,STEP,460069072100,460084450700,15378600,-1
160,1,STEP,460084526300,460099971500,15445200,-1
161,1,STEP,460100023200,460115461700,15438500,-1
162,1,STEP,460115508500,460130695100,15186600,-1
163,1,STEP,460130752600,460145970400,15217800,-1
164,1,STEP,460146055600,460161275100,15219500,-1
165,1,STEP,460161320200,460177231700,15911500,-1
166,1,STEP,460177281800,460192574200,15292400,-1
167,1,STEP,460192622400,460208024700,15402300,-1
168,1,STEP,460208076000,460223998200,15922200,-1
169,1,STEP,460224043600,460239199600,15156000,-1
170,1,STEP,460239249800,460254692500,15442700,-1
171,1,STEP,460254738000,460269921900,15183900,-1
172,1,STEP,460269973300,460285628000,15654700,-1
173,1,STEP,460285679800,460301208900,15529100,-1
174,1,STEP,460301254300,460316735700,15481400,-1
175,1,STEP,460316780000,460332670500,15890500,-1
176,1,STEP,460332718400,460348351300,15632900,-1
177,1,STEP,460348399900,460364282000,15882100,-1
178,1,STEP,460364331000,460380092200,15761200,-1
179,1,STEP,460380147100,460395924800,15777700,-1
180,1,STEP,460395977400,460411460500,15483100,-1
181,1,STEP,460411515000,460427274600,15759600,-1
182,1,STEP,460427330400,460443385000,16054600,-1
183,1,STEP,460443446700,460459950400,16503700,-1
184,1,STEP,460460015300,460475592800,15577500,-1
185,1,STEP,460475687400,460491809000,16121600,-1
186,1,STEP,460492124600,460508317700,16193100,-1
187,1,STEP,460508426100,460524507900,16081800,-1
188,1,STEP,460524588900,460540648000,16059100,-1
189,1,STEP,460540901900,460556587000,15685100,-1
190,1,STEP,460556685300,460573446500,16761200,-1
191,1,STEP,460573518600,460589429300,15910700,-1
192,1,STEP,460589616800,460606280700,16663900,-1
193,1,STEP,460606349500,460622218900,15869400,-1
194,1,STEP,460622277200,460638385400,16108200,-1
195,1,STEP,460638631100,460654921800,16290700,-1
196,1,STEP,460654989300,460671081900,16092600,-1
197,1,STEP,460671138600,460687155900,16017300,-1
198,1,STEP,460687337500,460703526000,16188500,-1
199,1,STEP,460703652300,460720379500,16727200,-1
200,1,STEP,460720433900,460736339800,15905900,-1
201,1,STEP,460736420100,460752596300,16176200,-1
202,1,STEP,460752695000,460768964800,16269800,-1
203,1,STEP,460769037400,460786808100,17770700,-1
204,1,STEP,460786888100,460804239200,17351100,-1
205,1,STEP,460804410400,460821248400,16838000,-1
206,1,STEP,460821374600,460838317500,16942900,-1
207,1,STEP,460838391700,460854057800,15666100,-1
208,1,STEP,460854129400,460870434300,16304900,-1
209,1,STEP,460870591500,460886197500,15606000,-1
210,1,STEP,460886270400,460901798000,15527600,-1
211,1,STEP,460901970300,460917910900,15940600,-1
212,1,STEP,460918026000,460934119400,16093400,-1
213,1,STEP,460934438700,460951620700,17182000,-1
214,1,STEP,460951778600,460968382300,16603700,-1
215,1,STEP,460968443200,460984244200,15801000,-1
216,1,STEP,460984305400,460999958400,15653000,-1
217,1,STEP,461000062300,461016437900,16375600,-1
218,1,STEP,461016498200,461032349500,15851300,-1
219,1,STEP,461032405700,461048199100,15793400,-1
220,1,STEP,461048302500,461064561500,16259000,-1
221,1,STEP,461064616000,461080215200,15599200,-1
222,1,STEP,461080288600,461097021900,16733300,-1
223,1,STEP,461097116400,461112705900,15589500,-1
224,1,STEP,461112776800,461129583300,16806500,-1
225,1,STEP,461129642700,461145559400,15916700,-1
226,1,STEP,461145718400,461161914400,16196000,-1
227,1,STEP,461161979200,461178437800,16458600,-1
228,1,STEP,461178502300,461194744400,16242100,-1
229,1,STEP,461194834700,461210393200,15558500,-1
230,1,STEP,461210493000,461226156300,15663300,-1
231,1,STEP,461226224000,461242093900,15869900,-1
232,1,STEP,461242172000,461258003000,15831000,-1
233,1,STEP,461258059500,461273830100,15770600,-1
234,1,STEP,461273880400,461289651700,15771300,-1
235,1,STEP,461289732700,461307026200,17293500,-1
236,1,STEP,461307204200,461323108100,15903900,-1
237,1,STEP,461323258000,461338608900,15350900,-1
238,1,STEP,461338667400,461354508200,15840800,-1
239,1,STEP,461354634200,461370008700,15374500,-1
240,1,STEP,461370069100,461387662200,17593100,-1
241,1,STEP,461387826900,461404248800,16421900,-1
242,1,STEP,461404435900,461420823800,16387900,-1
243,1,STEP,461420940000,461437309800,16369800,-1
244,1,STEP,461437378600,461453984300,16605700,-1
245,1,STEP,461454188200,461469832200,15644000,-1
246,1,STEP,461469883200,461485463000,15579800,-1
247,1,STEP,461485534700,461501919500,16384800,-1
248,1,STEP,461501976100,461518381900,16405800,-1
249,1,STEP,461518440000,461534124900,15684900,-1
250,1,STEP,461534203600,461549644700,15441100,-1
251,1,STEP,461549714200,461565103400,15389200,-1
252,1,STEP,461565156800,461580395100,15238300,-1
253,1,STEP,461580509200,461596489600,15980400,-1
254,1,STEP,461596566600,461612061400,15494800,-1
255,1,STEP,461612200800,461627939400,15738600,-1
256,1,STEP,461628070700,461643556800,15486100,-1
257,1,STEP,461643616500,461659210200,15593700,-1
258,1,STEP,461659260800,461674986700,15725900,-1
259,1,STEP,461675036900,461690515000,15478100,-1
260,1,STEP,461690585400,461706792600,16207200,-1
261,1,STEP,461706866500,461722548300,15681800,-1
262,1,STEP,461722695100,461738657900,15962800,-1
263,1,STEP,461738818100,461754658400,15840300,-1
264,1,STEP,461754705800,461770439800,15734000,-1
265,1,STEP,461770523800,461786006300,15482500,-1
266,1,STEP,461786058600,461801450300,15391700,-1
267,1,STEP,461801526700,461818182900,16656200,-1
268,1,STEP,461818254600,461836094100,17839500,-1
269,1,STEP,461836170700,461853216900,17046200,-1
270,1,STEP,461853284600,461869953700,16669100,-1
271,1,STEP,461870004300,461887619500,17615200,-1
272,1,STEP,461887677900,461904759300,17081400,-1
273,1,STEP,461904808000,461922720000,17912000,-1
274,1,STEP,461922784100,461940640800,17856700,-1
275,1,STEP,461940749700,461959050600,18300900,-1
276,1,STEP,461959115700,461977563500,18447800,-1
277,1,STEP,461977636300,461993631200,15994900,-1
278,1,STEP,461993734100,462012075900,18341800,-1
279,1,STEP,462012128300,462030669100,18540800,-1
280,1,STEP,462030825700,462050298100,19472400,-1
281,1,STEP,462050349300,462069468200,19118900,-1
282,1,STEP,462069541900,462088350600,18808700,-1
283,1,STEP,462088400100,462106972700,18572600,-1
284,1,STEP,462107162700,462125672600,18509900,-1
285,1,STEP,462125729000,462145765500,20036500,-1
286,1,STEP,462145839200,462165028100,19188900,-1
287,1,STEP,462165092400,462183540200,18447800,-1
288,1,STEP,462183591500,462202130000,18538500,-1
289,1,STEP,462202379500,462221374200,18994700,-1
290,1,STEP,462221432100,462240834200,19402100,-1
291,1,STEP,462240880400,462261258800,20378400,-1
292,1,STEP,462261311900,462280379300,19067400,-1
293,1,STEP,462280433600,462299571000,19137400,-1
294,1,STEP,462299622400,462318835800,19213400,-1
295,1,STEP,462318894200,462338555200,19661000,-1
296,1,STEP,462338599100,462358511800,19912700,-1
297,1,STEP,462358560800,462378172100,19611300,-1
298,1,STEP,462378231400,462398081200,19849800,-1
299,1,STEP,462398147100,462418552700,20405600,-1
300,1,STEP,462418598700,462438667100,20068400,-1
301,1,STEP,462438719400,462459399400,20680000,-1
302,1,STEP,462459448400,462479159600,19711200,-1
303,1,STEP,462479202100,462499359700,20157600,-1
304,1,STEP,462499403300,462519198000,19794700,-1
305,1,STEP,462519252600,462538733000,19480400,-1
306,1,STEP,462538778600,462559363600,20585000,-1
307,1,STEP,462559413800,462579732700,20318900,-1
308,1,STEP,462579780800,462600019400,20238600,-1
309,1,STEP,462600078000,462619738800,19660800,-1
310,1,STEP,462619787100,462639587200,19800100,-1
311,1,STEP,462639637900,462659392100,19754200,-1
312,1,STEP,462659440500,462678932400,19491900,-1
313,1,STEP,462678984400,462698337200,19352800,-1
314,1,STEP,462698380500,462718065700,19685200,-1
315,1,STEP,462718115700,462738310600,20194900,-1
316,1,STEP,462738337300,462757946900,19609600,-1
317,1,STEP,462757990200,462777725900,19735700,-1
318,1,STEP,462777766800,462797689000,19922200,-1
319,1,STEP,462797731100,462817638900,19907800,-1
320,1,STEP,462817697100,462837671000,19973900,-1
321,1,STEP,462837710300,462857936200,20225900,-1
322,1,STEP,462857982300,462878673700,20691400,-1
323,1,STEP,462878718600,462898735100,20016500,-1
324,1,STEP,462898773700,462918832300,20058600,-1
325,1,STEP,462918865700,462939129100,20263400,-1
326,1,STEP,462939156200,462959060400,19904200,-1
327,1,STEP,462959091100,462979010400,19919300,-1
328,1,STEP,462979048000,462999054200,20006200,-1
329,1,STEP,462999085700,463019114000,20028300,-1
330,1,STEP,463019150200,463039735000,20584800,-1
331,1,STEP,463039771400,463059860600,20089200,-1
332,1,STEP,463059890300,463079810400,19920100,-1
333,1,STEP,463079851400,463099488400,19637000,-1
334,1,STEP,463099521900,463119222100,19700200,-1
335,1,STEP,463119268400,463140001000,20732600,-1
336,1,STEP,463140054600,463160160400,20105800,-1
337,1,STEP,463160254100,463180420300,20166200,-1
338,1,STEP,463180460400,463200927600,20467200,-1
339,1,STEP,463200966700,463221204000,20237300,-1
340,1,STEP,463221236400,463241165800,19929400,-1
341,1,STEP,463241205800,463261493100,20287300,-1
342,1,STEP,463261526000,463282207900,20681900,-1
343,1,STEP,463282250700,463301644100,19393400,-1
344,1,STEP,463301679500,463322422200,20742700,-1
345,1,STEP,463322450800,463342711900,20261100,-1
346,1,STEP,463342745500,463363686600,20941100,-1
347,1,STEP,463363723400,463383977000,20253600,-1
348,1,STEP,463384021200,463404512400,20491200,-1
349,1,STEP,463404550400,463424504300,19953900,-1
350,1,STEP,463424532400,463444813000,20280600,-1
351,1,STEP,463444851100,463464677000,19825900,-1
352,1,STEP,463464710600,463484354900,19644300,-1
353,1,STEP,463484387300,463504171900,19784600,-1
354,1,STEP,463504210700,463524531300,20320600,-1
355,1,STEP,463524560100,463544577200,20017100,-1
356,1,STEP,463544640300,463564427400,19787100,-1
357,1,STEP,463564456500,463584424300,19967800,-1
358,1,STEP,463584449700,463605760700,21311000,-1
359,1,STEP,463605794500,463625859900,20065400,-1
360,1,STEP,463625896200,463645898100,20001900,-1
361,1,STEP,463645921100,463666012900,20091800,-1
362,1,STEP,463666041500,463685958700,19917200,-1
363,1,STEP,463685998600,463705634300,19635700,-1
364,1,STEP,463705676800,463725794200,20117400,-1
365,1,STEP,463725846500,463745663200,19816700,-1
366,1,STEP,463745702300,463765692400,19990100,-1
367,1,STEP,463765724500,463785339800,19615300,-1
368,1,STEP,463785369600,463805163800,19794200,-1
369,1,STEP,463805201800,463824597600,19395800,-1
370,1,STEP,463824634000,463844221100,19587100,-1
371,1,STEP,463844250900,463864160200,19909300,-1
372,1,STEP,463864185300,463884840200,20654900,-1
373,1,STEP,463884876400,463904605500,19729100,-1
374,1,STEP,463904648800,463924467000,19818200,-1
375,1,STEP,463924510500,463944326500,19816000,-1
376,1,STEP,463944358400,463964666600,20308200,-1
377,1,STEP,463964693000,463984581700,19888700,-1
378,1,STEP,463984666200,464004746500,20080300,-1
379,1,STEP,464004796600,464024885100,20088500,-1
380,1,STEP,464024934400,464044898500,19964100,-1
381,1,STEP,464044949400,464065002000,20052600,-1
382,1,STEP,464065108700,464084693600,19584900,-1
383,1,STEP,464084750300,464104327100,19576800,-1
384,1,STEP,464104422600,464124268100,19845500,-1
385,1,STEP,464124328700,464144535200,20206500,-1
386,1,STEP,464144595400,464164281600,19686200,-1
387,1,STEP,464164333300,464183432500,19099200,-1
388,1,STEP,464183500300,464203182600,19682300,-1
389,1,STEP,464203236300,464224277900,21041600,-1
390,1,STEP,464224329900,464243739400,19409500,-1
391,1,STEP,464243794600,464263580500,19785900,-1
392,1,STEP,464263659100,464283357800,19698700,-1
393,1,STEP,464283428500,464303251300,19822800,-1
394,1,STEP,464303304600,464322615500,19310900,-1
395,1,STEP,464322670700,464342489200,19818500,-1
396,1,STEP,464342545300,464362126700,19581400,-1
397,1,STEP,464362187800,464381486400,19298600,-1
398,1,STEP,464381539000,464401148100,19609100,-1
399,1,STEP,464401196000,464421052900,19856900,-1
400,1,STEP,464421136700,464440390800,19254100,-1
401,1,STEP,464440471800,464460199600,19727800,-1
402,1,STEP,464460247200,464479499700,19252500,-1
403,1,STEP,464479580300,464499324600,19744300,-1
404,1,STEP,464499377800,464518896500,19518700,-1
405,1,STEP,464518972700,464538217400,19244700,-1
406,1,STEP,464538272400,464558541100,20268700,-1
407,1,STEP,464558625900,464578797300,20171400,-1
408,1,STEP,464578863000,464598444400,19581400,-1
409,1,STEP,464598530000,464618839500,20309500,-1
410,1,STEP,464618898200,464638356400,19458200,-1
411,1,STEP,464638428200,464657746100,19317900,-1
412,1,STEP,464657792000,464677691900,19899900,-1
413,1,STEP,464677783900,464697613000,19829100,-1
414,1,STEP,464697677800,464717935700,20257900,-1
415,1,STEP,464718025800,464738109200,20083400,-1
416,1,STEP,464738166600,464758660300,20493700,-1
417,1,STEP,464758777900,464778131400,19353500,-1
418,1,STEP,464778310900,464798457100,20146200,-1
419,1,STEP,464798569700,464818519800,19950100,-1
420,1,STEP,464818588500,464838970900,20382400,-1
421,1,STEP,464839037500,464858857800,19820300,-1
422,1,STEP,464858905300,464878543400,19638100,-1
423,1,STEP,464878650400,464898424100,19773700,-1
424,1,STEP,464898505800,464918095100,19589300,-1
425,1,STEP,464918148700,464937856500,19707800,-1
426,1,STEP,464937953900,464957663900,19710000,-1
427,1,STEP,464957726500,464977585200,19858700,-1
428,1,STEP,464977644800,464997715900,20071100,-1
429,1,STEP,464997766400,465017767100,20000700,-1
430,1,STEP,465017854500,465037810400,19955900,-1
431,1,STEP,465037890300,465057562300,19672000,-1
432,1,STEP,465057612000,465077253500,19641500,-1
433,1,STEP,465077321000,465096974900,19653900,-1
434,1,STEP,465097048900,465116964200,19915300,-1
435,1,STEP,465117019600,465136857700,19838100,-1
436,1,STEP,465137006300,465156377800,19371500,-1
437,1,STEP,465156432300,465177162100,20729800,-1
438,1,STEP,465177245100,465196626800,19381700,-1
439,1,STEP,465196677500,465217072900,20395400,-1
440,1,STEP,465217120000,465236882000,19762000,-1
441,1,STEP,465236958300,465257174100,20215800,-1
442,1,STEP,465257232400,465276911800,19679400,-1
443,1,STEP,465277046500,465297379900,20333400,-1
444,1,STEP,465297537900,465317566000,20028100,-1
445,1,STEP,465317617600,465337200300,19582700,-1
446,1,STEP,465337251000,465358261300,21010300,-1
447,1,STEP,465358313300,465378460700,20147400,-1
448,1,STEP,465378521500,465398305200,19783700,-1
449,1,STEP,465398358400,465418091900,19733500,-1
450,1,STEP,465418219900,465438001300,19781400,-1
451,1,STEP,465438072800,465458348400,20275600,-1
452,1,STEP,465458438900,465478707100,20268200,-1
453,1,STEP,465478775000,465498794800,20019800,-1
454,1,STEP,465498944800,465518458700,19513900,-1
455,1,STEP,465518522300,465538685400,20163100,-1
456,1,STEP,465538753700,465558554100,19800400,-1
457,1,STEP,465558618100,465578629100,20011000,-1
458,1,STEP,465578703400,465598366600,19663200,-1
459,1,STEP,465598418800,465618157200,19738400,-1
460,1,STEP,465618217700,465637964200,19746500,-1
461,1,STEP,465638017800,465658006600,19988800,-1
462,1,STEP,465658065400,465677739800,19674400,-1
463,1,STEP,465677808000,465697414700,19606700,-1
464,1,STEP,465697468200,465717107700,19639500,-1
465,1,STEP,465717157400,465736874500,19717100,-1
466,1,STEP,465737004700,465757411900,20407200,-1
467,1,STEP,465757475200,465776918300,19443100,-1
468,1,STEP,465777002400,465796556800,19554400,-1
469,1,STEP,465796613700,465816426700,19813000,-1
470,1,STEP,465816485700,465836176900,19691200,-1
471,1,STEP,465836240100,465857259500,21019400,-1
472,1,STEP,465857321500,465876842900,19521400,-1
473,1,STEP,465876897400,465897152500,20255100,-1
474,1,STEP,465897200800,465917353500,20152700,-1
475,1,STEP,465917405100,465936875000,19469900,-1
476,1,STEP,465936976300,465957411300,20435000,-1
477,1,STEP,465957562500,465977789900,20227400,-1
478,1,STEP,465978040000,465997921700,19881700,-1
479,1,STEP,465997982900,466017801600,19818700,-1
480,1,STEP,466017862800,466037956300,20093500,-1
481,1,STEP,466038015900,466058423800,20407900,-1
482,1,STEP,466058476500,466079063900,20587400,-1
483,1,STEP,466079119800,466099348500,20228700,-1
484,1,STEP,466099397800,466119587600,20189800,-1
485,1,STEP,466119681000,466140330600,20649600,-1
486,1,STEP,466140446800,466159699300,19252500,-1
487,1,STEP,466159794900,466179379300,19584400,-1
488,1,STEP,466179597300,466199607600,20010300,-1
489,1,STEP,466199690200,466219711100,20020900,-1
490,1,STEP,466219775600,466239707000,19931400,-1
491,1,STEP,466239785700,466259610300,19824600,-1
492,1,STEP,466259660100,466279837500,20177400,-1
493,1,STEP,466279886800,466299535400,19648600,-1
494,1,STEP,466299583500,466319072300,19488800,-1
495,1,STEP,466319145500,466339050900,19905400,-1
496,1,STEP,466339117700,466358234800,19117100,-1
497,1,STEP,466358314200,466377496800,19182600,-1
498,1,STEP,466377566600,466397163200,19596600,-1
499,1,STEP,466397213500,466416398900,19185400,-1
500,1,STEP,466416461500,466436225300,19763800,-1
501,1,STEP,466436304400,466457460300,21155900,-1
502,1,STEP,466457519400,466477724700,20205300,-1
503,1,STEP,466477782600,466498062100,20279500,-1
504,1,STEP,466498121700,466517168700,19047000,-1
505,1,STEP,466517238800,466536842700,19603900,-1
506,1,STEP,466536899100,466556592200,19693100,-1
507,1,STEP,466556680600,466575785600,19105000,-1
508,1,STEP,466575839800,466596005200,20165400,-1
509,1,STEP,466596062300,466615400600,19338300,-1
510,1,STEP,466615461900,466635021200,19559300,-1
511,1,STEP,466635094300,466654990200,19895900,-1
512,1,STEP,466655056000,466674814200,19758200,-1
513,1,STEP,466674879200,466694867100,19987900,-1
514,1,STEP,466694916500,466714723200,19806700,-1
515,1,STEP,466714763300,466734576700,19813400,-1
516,1,STEP,466734625800,466754710600,20084800,-1
517,1,STEP,466754747100,466774584100,19837000,-1
518,1,STEP,466774610600,466795097200,20486600,-1
519,1,STEP,466795142000,466814929500,19787500,-1
520,1,STEP,466814965400,466834512600,19547200,-1
521,1,STEP,466834544900,466854468600,19923700,-1
522,1,STEP,466854510700,466874457900,19947200,-1
523,1,STEP,466874502500,466894333500,19831000,-1
524,1,STEP,466894434400,466914113400,19679000,-1
525,1,STEP,466914155800,466933909800,19754000,-1
526,1,STEP,466933958400,466953731400,19773000,-1
527,1,STEP,466953776500,466974004200,20227700,-1
528,1,STEP,466974033300,466993889800,19856500,-1
529,1,STEP,466993922200,467013601200,19679000,-1
530,1,STEP,467013656600,467033674100,20017500,-1
531,1,STEP,467033735200,467053570500,19835300,-1
532,1,STEP,467053628800,467073211200,19582400,-1
533,1,STEP,467073291600,467093804700,20513100,-1
534,1,STEP,467093855200,467113621200,19766000,-1
535,1,STEP,467113738100,467133829000,20090900,-1
536,1,STEP,467133902600,467153193700,19291100,-1
537,1,STEP,467153263700,467172462800,19199100,-1
538,1,STEP,467172522600,467191977300,19454700,-1
539,1,STEP,467192032900,467211462200,19429300,-1
540,1,STEP,467211541400,467231150400,19609000,-1
541,1,STEP,467231204200,467250913600,19709400,-1
542,1,STEP,467250966400,467270508600,19542200,-1
543,1,STEP,467270564900,467290006800,19441900,-1
544,1,STEP,467290112000,467310078700,19966700,-1
545,1,STEP,467310151500,467329760500,19609000,-1
546,1,STEP,467329817800,467349082100,19264300,-1
547,1,STEP,467349166400,467369141400,19975000,-1
548,1,STEP,467369204900,467389513000,20308100,-1
549,1,STEP,467389578700,467409669500,20090800,-1
550,1,STEP,467409759400,467429197400,19438000,-1
551,1,STEP,467429252200,467449142600,19890400,-1
552,1,STEP,467449191100,467468997600,19806500,-1
553,1,STEP,467469045000,467489197400,20152400,-1
554,1,STEP,467489244500,467509661600,20417100,-1
555,1,STEP,467509718200,467528705400,18987200,-1
556,1,STEP,467528756600,467548758200,20001600,-1
557,1,STEP,467548816700,467568045500,19228800,-1
558,1,STEP,467568103800,467587705200,19601400,-1
559,1,STEP,467587754200,467607696700,19942500,-1
560,1,STEP,467607735800,467627446000,19710200,-1
561,1,STEP,467627494400,467647032200,19537800,-1
562,1,STEP,467647092400,467666563200,19470800,-1
563,1,STEP,467666640300,467686854100,20213800,-1
564,1,STEP,467686918900,467706348100,19429200,-1
565,1,STEP,467706400100,467726004400,19604300,-1
566,1,STEP,467726057500,467745567400,19509900,-1
567,1,STEP,467745617900,467765059500,19441600,-1
568,1,STEP,467765115200,467784490100,19374900,-1
569,1,STEP,467784551800,467804313300,19761500,-1
570,1,STEP,467804377900,467824603000,20225100,-1
571,1,STEP,467824644600,467844095800,19451200,-1
572,1,STEP,467844154300,467864093900,19939600,-1
573,1,STEP,467864125400,467884564700,20439300,-1
574,1,STEP,467884602300,467904535500,19933200,-1
575,1,STEP,467904578900,467924851100,20272200,-1
576,1,STEP,467924894300,467944255300,19361000,-1
577,1,STEP,467944318300,467963815100,19496800,-1
578,1,STEP,467963877700,467983264100,19386400,-1
579,1,STEP,467983317200,468002841400,19524200,-1
580,1,STEP,468002887600,468023183800,20296200,-1
581,1,STEP,468023263600,468043360500,20096900,-1
582,1,STEP,468043464500,468063626100,20161600,-1
583,1,STEP,468063678100,468082852800,19174700,-1
584,1,STEP,468082939800,468102560200,19620400,-1
585,1,STEP,468102621000,468122784900,20163900,-1
586,1,STEP,468122836100,468142472200,19636100,-1
587,1,STEP,468142529100,468162070800,19541700,-1
588,1,STEP,468162137000,468181903600,19766600,-1
589,1,STEP,468181971400,468202108300,20136900,-1
590,1,STEP,468202161300,468222232100,20070800,-1
591,1,STEP,468222290500,468241995400,19704900,-1
592,1,STEP,468242070400,468261732800,19662400,-1
593,1,STEP,468261790100,468281537700,19747600,-1
594,1,STEP,468281622400,468301676300,20053900,-1
595,1,STEP,468301736000,468322687500,20951500,-1
596,1,STEP,468322756500,468342943300,20186800,-1
597,1,STEP,468343080500,468363218800,20138300,-1
598,1,STEP,468363295400,468383042600,19747200,-1
599,1,STEP,468383097100,468402863500,19766400,-1
600,1,STEP,468402959600,468422960000,20000400,-1
601,1,STEP,468423021300,468442744400,19723100,-1
602,1,STEP,468442808300,468462124900,19316600,-1
603,1,STEP,468462176700,468482315200,20138500,-1
604,1,STEP,468482371800,468502453600,20081800,-1
605,1,STEP,468502509600,468521791900,19282300,-1
606,1,STEP,468521844400,468541312200,19467800,-1
607,1,STEP,468541393100,468561183000,19789900,-1
608,1,STEP,468561241100,468580639200,19398100,-1
609,1,STEP,468580687800,468600588200,19900400,-1
610,1,STEP,468600639400,468620361300,19721900,-1
611,1,STEP,468620426500,468640382200,19955700,-1
612,1,STEP,468640445900,468660478200,20032300,-1
613,1,STEP,468660685100,468680200500,19515400,-1
614,1,STEP,468680282000,468699635700,19353700,-1
615,1,STEP,468699690500,468719291000,19600500,-1
616,1,STEP,468719339300,468739366200,20026900,-1
617,1,STEP,468739414500,468758730500,19316000,-1
618,1,STEP,468758793200,468778305700,19512500,-1
619,1,STEP,468778394600,468798155200,19760600,-1
620,1,STEP,468798220000,468817836100,19616100,-1
621,1,STEP,468817900300,468837412600,19512300,-1
622,1,STEP,468837485400,468858071200,20585800,-1
623,1,STEP,468858115800,468878330300,20214500,-1
624,1,STEP,468878373800,468898237700,19863900,-1
625,1,STEP,468898308700,468917988900,19680200,-1
626,1,STEP,468918032200,468937741500,19709300,-1
627,1,STEP,468937766000,468957614600,19848600,-1
628,1,STEP,468957662300,468977183300,19521000,-1
629,1,STEP,468977218300,468997476700,20258400,-1
630,1,STEP,468997526000,469018135800,20609800,-1
631,1,STEP,469018182700,469037586600,19403900,-1
632,1,STEP,469037622600,469057716200,20093600,-1
633,1,STEP,469057746600,469077344600,19598000,-1
634,1,STEP,469077371100,469097285600,19914500,-1
635,1,STEP,469097328800,469117359300,20030500,-1
636,1,STEP,469117383700,469137086200,19702500,-1
637,1,STEP,469137110500,469157623500,20513000,-1
638,1,STEP,469157648400,469177594000,19945600,-1
639,1,STEP,469177621200,469197336500,19715300,-1
640,1,STEP,469197373500,469217421700,20048200,-1
641,1,STEP,469217448800,469237502200,20053400,-1
642,1,STEP,469237526100,469257769900,20243800,-1
643,1,STEP,469257803500,469277836700,20033200,-1
644,1,STEP,469277870300,469298022800,20152500,-1
645,1,STEP,469298065600,469317685600,19620000,-1
646,1,STEP,469317720400,469337142800,19422400,-1
647,1,STEP,469337168800,469358378500,21209700,-1
648,1,STEP,469358403100,469378038900,19635800,-1
649,1,STEP,469378073600,469397920100,19846500,-1
650,1,STEP,469397963400,469417398700,19435300,-1
651,1,STEP,469417447200,469437051500,19604300,-1
652,1,STEP,469437112700,469456372000,19259300,-1
653,1,STEP,469456417400,469475828800,19411400,-1
654,1,STEP,469475876100,469495605600,19729500,-1
655,1,STEP,469495651600,469515041400,19389800,-1
656,1,STEP,469515092700,469534344900,19252200,-1
657,1,STEP,469534394000,469553931200,19537200,-1
658,1,STEP,469553973800,469573660900,19687100,-1
659,1,STEP,469573698900,469593475600,19776700,-1
660,1,STEP,469593514800,469613410100,19895300,-1
661,1,STEP,469613451900,469633473600,20021700,-1
662,1,STEP,469633517900,469653491900,19974000,-1
663,1,STEP,469653533400,469673538300,20004900,-1
664,1,STEP,469673575500,469694198400,20622900,-1
665,1,STEP,469694249000,469713541100,19292100,-1
666,1,STEP,469713592800,469733553000,19960200,-1
667,1,STEP,469733590500,469753375700,19785200,-1
668,1,STEP,469753413700,469773258400,19844700,-1
669,1,STEP,469773313900,469793387900,20074000,-1
670,1,STEP,469793431600,469813410900,19979300,-1
671,1,STEP,469813453400,469833274200,19820800,-1
672,1,STEP,469833342300,469852737600,19395300,-1
673,1,STEP,469852786200,469872080700,19294500,-1
674,1,STEP,469872127100,469891754900,19627800,-1
675,1,STEP,469891801100,469911338200,19537100,-1
676,1,STEP,469911388100,469930459200,19071100,-1
677,1,STEP,469930509700,469949969300,19459600,-1
678,1,STEP,469950019400,469970304000,20284600,-1
679,1,STEP,469970345400,469990207600,19862200,-1
680,1,STEP,469990252300,470009610300,19358000,-1
681,1,STEP,470009665300,470028734100,19068800,-1
682,1,STEP,470028791400,470048016700,19225300,-1
683,1,STEP,470048081100,470067828800,19747700,-1
684,1,STEP,470067900600,470087220100,19319500,-1
685,1,STEP,470087268800,470107132600,19863800,-1
686,1,STEP,470107180500,470126748200,19567700,-1
687,1,STEP,470126797700,470146134500,19336800,-1
688,1,STEP,470146182100,470165738800,19556700,-1
689,1,STEP,470165797500,470185186400,19388900,-1
690,1,STEP,470185233800,470204675800,19442000,-1
691,1,STEP,470204724600,470224413500,19688900,-1
692,1,STEP,470224457200,470244325900,19868700,-1
693,1,STEP,470244362900,470263881600,19518700,-1
694,1,STEP,470263922900,470283882600,19959700,-1
695,1,STEP,470283934700,470303976900,20042200,-1
696,1,STEP,470304018800,470323400000,19381200,-1
697,1,STEP,470323443500,470343002500,19559000,-1
698,1,STEP,470343047400,470363050300,20002900,-1
699,1,STEP,470363093000,470383638800,20545800,-1
700,1,STEP,470383677500,470403674800,19997300,-1
701,1,STEP,470403771500,470423476800,19705300,-1
702,1,STEP,470423525500,470443603900,20078400,-1
703,1,STEP,470443633300,470463566200,19932900,-1
704,1,STEP,470463592000,470483687600,20095600,-1
705,1,STEP,470483725900,470503015300,19289400,-1
706,1,STEP,470503048000,470522270200,19222200,-1
707,1,STEP,470522326000,470542314600,19988600,-1
708,1,STEP,470542345600,470561997900,19652300,-1
709,1,STEP,470562041200,470581631200,19590000,-1
710,1,STEP,470581699900,470601634900,19935000,-1
711,1,STEP,470601662200,470621610500,19948300,-1
712,1,STEP,470621648000,470642006000,20358000,-1
713,1,STEP,470642048700,470661732200,19683500,-1
714,1,STEP,470661778700,470681757900,19979200,-1
715,1,STEP,470681801400,470701825400,20024000,-1
716,1,STEP,470701875600,470721308600,19433000,-1
717,1,STEP,470721358000,470741697200,20339200,-1
718,1,STEP,470741751200,470761510000,19758800,-1
719,1,STEP,470761555900,470780998600,19442700,-1
720,1,STEP,470781046100,470800297200,19251100,-1
721,1,STEP,470800340200,470819967300,19627100,-1
722,1,STEP,470820010500,470839299500,19289000,-1
723,1,STEP,470839350300,470859013500,19663200,-1
724,1,STEP,470859059900,470878008500,18948600,-1
725,1,STEP,470878067400,470898449100,20381700,-1
726,1,STEP,470898508400,470918005200,19496800,-1
727,1,STEP,470918063300,470938245800,20182500,-1
728,1,STEP,470938307100,470957464400,19157300,-1
729,1,STEP,470957514900,470977269100,19754200,-1
730,1,STEP,470977317200,470997283200,19966000,-1
731,1,STEP,470997330700,471017342700,20012000,-1
732,1,STEP,471017384600,471036941100,19556500,-1
733,1,STEP,471036987900,471055902900,18915000,-1
734,1,STEP,471055953800,471075201500,19247700,-1
735,1,STEP,471075261500,471094623600,19362100,-1
736,1,STEP,471094676900,471113927300,19250400,-1
737,1,STEP,471113975300,471133312700,19337400,-1
738,1,STEP,471133364700,471152621700,19257000,-1
739,1,STEP,471152663300,471172552900,19889600,-1
740,1,STEP,471172592400,471192466300,19873900,-1
741,1,STEP,471192503700,471213300600,20796900,-1
742,1,STEP,471213326600,471232853700,19527100,-1
743,1,STEP,471232892300,471253005300,20113000,-1
744,1,STEP,471253044200,471272793600,19749400,-1
745,1,STEP,471272886700,471292921200,20034500,-1
746,1,STEP,471292968600,471312878400,19909800,-1
747,1,STEP,471312909100,471332977500,20068400,-1
748,1,STEP,471333046700,471353621000,20574300,-1
749,1,STEP,471353677100,471373716800,20039700,-1
750,1,STEP,471373768600,471393757900,19989300,-1
751,1,STEP,471393801800,471413246100,19444300,-1
752,1,STEP,471413298400,471433364700,20066300,-1
753,1,STEP,471433414600,471453907300,20492700,-1
754,1,STEP,471453949600,471473815500,19865900,-1
755,1,STEP,471473846300,471493898300,20052000,-1
756,1,STEP,471493922700,471513535400,19612700,-1
757,1,STEP,471513562700,471534689000,21126300,-1
758,1,STEP,471534712800,471554083100,19370300,-1
759,1,STEP,471554114900,471574680100,20565200,-1
760,1,STEP,471574710300,471594681400,19971100,-1
761,1,STEP,471594719300,471614205800,19486500,-1
762,1,STEP,471614246600,471633649900,19403300,-1
763,1,STEP,471633689900,471654054100,20364200,-1
764,1,STEP,471654083700,471674137300,20053600,-1
765,1,STEP,471674180400,471694293400,20113000,-1
766,1,STEP,471694317100,471714443500,20126400,-1
767,1,STEP,471714500500,471735350000,20849500,-1
768,1,STEP,471735381300,471755097400,19716100,-1
769,1,STEP,471755124500,471775392500,20268000,-1
770,1,STEP,471775433200,471795799400,20366200,-1
771,1,STEP,471795826700,471815718400,19891700,-1
772,1,STEP,471815745800,471835853900,20108100,-1
773,1,STEP,471835901100,471856436400,20535300,-1
774,1,STEP,471856464100,471876025200,19561100,-1
775,1,STEP,471876049300,471895999300,19950000,-1
776,1,STEP,471896036500,471916320200,20283700,-1
777,1,STEP,471916345700,471937200100,20854400,-1
778,1,STEP,471937233500,471957699400,20465900,-1
779,1,STEP,471957729500,471977554800,19825300,-1
780,1,STEP,471977589600,471997626200,20036600,-1
781,1,STEP,471997670700,472017635500,19964800,-1
782,1,STEP,472017666300,472037325000,19658700,-1
783,1,STEP,472037353600,472057134500,19780900,-1
784,1,STEP,472057158000,472077912400,20754400,-1
785,1,STEP,472077953100,472098167300,20214200,-1
786,1,STEP,472098217800,472117925300,19707500,-1
787,1,STEP,472118006900,472138096700,20089800,-1
788,1,STEP,472138193400,472157701600,19508200,-1
789,1,STEP,472157750100,472178873000,21122900,-1
790,1,STEP,472178918800,472199389100,20470300,-1
791,1,STEP,472199427300,472219382100,19954800,-1
792,1,STEP,472219412000,472239391600,19979600,-1
793,1,STEP,472239415600,472258891400,19475800,-1
794,1,STEP,472258918300,472278763800,19845500,-1
795,1,STEP,472278787200,472298603100,19815900,-1
796,1,STEP,472298635700,472318649600,20013900,-1
797,1,STEP,472318689300,472338539200,19849900,-1
798,1,STEP,472338564500,472358294500,19730000,-1
799,1,STEP,472358349600,472378909600,20560000,-1
800,1,STEP,472378957100,472398985400,20028300,-1
801,1,STEP,472399029000,472418485700,19456700,-1
802,1,STEP,472418537900,472438663400,20125500,-1
803,1,STEP,472438708600,472459017100,20308500,-1
804,1,STEP,472459047900,472478678700,19630800,-1
805,1,STEP,472478707600,472497977300,19269700,-1
806,1,STEP,472498013500,472518583500,20570000,-1
807,1,STEP,472518631200,472539241400,20610200,-1
808,1,STEP,472539286400,472559124100,19837700,-1
809,1,STEP,472559151800,472578994500,19842700,-1
810,1,STEP,472579041100,472599056200,20015100,-1
811,1,STEP,472599099400,472619762200,20662800,-1
812,1,STEP,472619787800,472639721300,19933500,-1
813,1,STEP,472639751700,472659603300,19851600,-1
814,1,STEP,472659631700,472679298100,19666400,-1
815,1,STEP,472679322100,472699335500,20013400,-1
816,1,STEP,472699358700,472719171800,19813100,-1
817,1,STEP,472719221200,472738712800,19491600,-1
818,1,STEP,472738796200,472758866800,20070600,-1
819,1,STEP,472758968500,472778878400,19909900,-1
820,1,STEP,472778926900,472799027900,20101000,-1
821,1,STEP,472799078400,472818701900,19623500,-1
822,1,STEP,472818757200,472838606200,19849000,-1
823,1,STEP,472838666000,472857881800,19215800,-1
824,1,STEP,472857949700,472878347600,20397900,-1
825,1,STEP,472878472200,472897983900,19511700,-1
826,1,STEP,472898048600,472917311900,19263300,-1
827,1,STEP,472917374600,472936785000,19410400,-1
828,1,STEP,472936840100,472957131400,20291300,-1
829,1,STEP,472957203700,472976518600,19314900,-1
830,1,STEP,472976580100,472996426800,19846700,-1
831,1,STEP,472996497500,473016037700,19540200,-1
832,1,STEP,473016089300,473036193400,20104100,-1
833,1,STEP,473036294300,473055790500,19496200,-1
834,1,STEP,473055834000,473075061700,19227700,-1
835,1,STEP,473075147800,473094822900,19675100,-1
836,1,STEP,473094905600,473115155400,20249800,-1
837,1,STEP,473115208400,473134315600,19107200,-1
838,1,STEP,473134357100,473153813400,19456300,-1
839,1,STEP,473153879900,473173517200,19637300,-1
840,1,STEP,473173584900,473192915300,19330400,-1
841,1,STEP,473192981400,473212542800,19561400,-1
842,1,STEP,473212611100,473232107000,19495900,-1
843,1,STEP,473232154100,473251459500,19305400,-1
844,1,STEP,473251515600,473270717000,19201400,-1
845,1,STEP,473270767200,473289644600,18877400,-1
846,1,STEP,473289703700,473308911100,19207400,-1
847,1,STEP,473308956800,473327892500,18935700,-1
848,1,STEP,473327957800,473347262000,19304200,-1
849,1,STEP,473347307800,473366949100,19641300,-1
850,1,STEP,473366978100,473386982400,20004300,-1
851,1,STEP,473387010500,473406696600,19686100,-1
852,1,STEP,473406729700,473426821300,20091600,-1
853,1,STEP,473426863300,473446467900,19604600,-1
854,1,STEP,473446493800,473466130500,19636700,-1
855,1,STEP,473466154300,473485886100,19731800,-1
856,1,STEP,473485914700,473506169900,20255200,-1
857,1,STEP,473506197400,473526159100,19961700,-1
858,1,STEP,473526203800,473546758600,20554800,-1
859,1,STEP,473546801800,473566674000,19872200,-1
860,1,STEP,473566712600,473587321000,20608400,-1
861,1,STEP,473587411200,473609036000,21624800,-1
862,1,STEP,473609273500,473629118000,19844500,-1
863,1,STEP,473629199800,473649328900,20129100,-1
864,1,STEP,473649366700,473668374000,19007300,-1
865,1,STEP,473668409000,473687930900,19521900,-1
866,1,STEP,473687981700,473707584700,19603000,-1
867,1,STEP,473707639700,473726796000,19156300,-1
868,1,STEP,473726836400,473746345700,19509300,-1
869,1,STEP,473746388800,473766303600,19914800,-1
870,1,STEP,473766356300,473785922900,19566600,-1
871,1,STEP,473785956600,473805174200,19217600,-1
872,1,STEP,473805211000,473825016900,19805900,-1
873,1,STEP,473825053600,473845121500,20067900,-1
874,1,STEP,473845149300,473865009000,19859700,-1
875,1,STEP,473865051500,473884837300,19785800,-1
876,1,STEP,473884865500,473905437700,20572200,-1
877,1,STEP,473905467600,473925402500,19934900,-1
878,1,STEP,473925433000,473945917000,20484000,-1
879,1,STEP,473945941300,473966330900,20389600,-1
880,1,STEP,473966377300,473986874700,20497400,-1
881,1,STEP,473986909000,474006777800,19868800,-1
882,1,STEP,474006805600,474026839700,20034100,-1
883,1,STEP,474026874600,474046906400,20031800,-1
884,1,STEP,474046931800,474067075500,20143700,-1
885,1,STEP,474067132700,474086753400,19620700,-1
886,1,STEP,474086800100,474106794100,19994000,-1
887,1,STEP,474106836400,474126486800,19650400,-1
888,1,STEP,474126529400,474146307800,19778400,-1
889,1,STEP,474146332900,474165845000,19512100,-1
890,1,STEP,474165881400,474186114900,20233500,-1
891,1,STEP,474186145500,474205853500,19708000,-1
892,1,STEP,474205896900,474225829200,19932300,-1
893,1,STEP,474225874200,474245431500,19557300,-1
894,1,STEP,474245474300,474265264900,19790600,-1
895,1,STEP,474265307200,474285328900,20021700,-1
896,1,STEP,474285368600,474305673600,20305000,-1
897,1,STEP,474305714900,474325234200,19519300,-1
898,1,STEP,474325264200,474344992600,19728400,-1
899,1,STEP,474345040100,474364739400,19699300,-1
900,1,STEP,474364781700,474384963200,20181500,-1
901,1,STEP,474385042200,474404794200,19752000,-1
902,1,STEP,474404837400,474423776200,18938800,-1
903,1,STEP,474423802800,474443672000,19869200,-1
904,1,STEP,474443704300,474463904000,20199700,-1
905,1,STEP,474463927100,474483696800,19769700,-1
906,1,STEP,474483733500,474503550700,19817200,-1
907,1,STEP,474503590800,474523385900,19795100,-1
908,1,STEP,474523413100,474542586800,19173700,-1
909,1,STEP,474542611400,474562516500,19905100,-1
910,1,STEP,474562555800,474581956600,19400800,-1
911,1,STEP,474581983200,474601573200,19590000,-1
912,1,STEP,474601619700,474621154500,19534800,-1
913,1,STEP,474621188900,474641349100,20160200,-1
914,1,STEP,474641394600,474661317200,19922600,-1
915,1,STEP,474661347700,474681505400,20157700,-1
916,1,STEP,474681529700,474701562700,20033000,-1
917,1,STEP,474701602200,474722559500,20957300,-1
918,1,STEP,474722585600,474742676900,20091300,-1
919,1,STEP,474742700900,474762339600,19638700,-1
920,1,STEP,474762378400,474781915600,19537200,-1
921,1,STEP,474781981600,474801442200,19460600,-1
922,1,STEP,474801484600,474821332500,19847900,-1
923,1,STEP,474821374800,474841221000,19846200,-1
924,1,STEP,474841258200,474861156300,19898100,-1
925,1,STEP,474861182200,474881015400,19833200,-1
926,1,STEP,474881046300,474901123500,20077200,-1
927,1,STEP,474901168500,474921141000,19972500,-1
928,1,STEP,474921167600,474940867600,19700000,-1
929,1,STEP,474940897100,474961315300,20418200,-1
930,1,STEP,474961340900,474980762100,19421200,-1
931,1,STEP,474980791900,475000536300,19744400,-1
932,1,STEP,475000572300,475020291300,19719000,-1
933,1,STEP,475020334700,475040583400,20248700,-1
934,1,STEP,475040607200,475060078700,19471500,-1
935,1,STEP,475060105000,475079940200,19835200,-1
936,1,STEP,475080009900,475099914800,19904900,-1
937,1,STEP,475099959400,475119551700,19592300,-1
938,1,STEP,475119598400,475140462400,20864000,-1
939,1,STEP,475140490100,475160103700,19613600,-1
940,1,STEP,475160140200,475179786600,19646400,-1
941,1,STEP,475179849100,475199691700,19842600,-1
942,1,STEP,475199749400,475218927800,19178400,-1
943,1,STEP,475219000200,475238610900,19610700,-1
944,1,STEP,475238660800,475258261400,19600600,-1
945,1,STEP,475258316500,475277964800,19648300,-1
946,1,STEP,475278016500,475297353100,19336600,-1
947,1,STEP,475297393700,475316531400,19137700,-1
948,1,STEP,475316584200,475337077900,20493700,-1
949,1,STEP,475337117200,475356948800,19831600,-1
950,1,STEP,475356995600,475376883200,19887600,-1
951,1,STEP,475376908800,475396952500,20043700,-1
952,1,STEP,475396994900,475417546600,20551700,-1
953,1,STEP,475417581400,475437651600,20070200,-1
954,1,STEP,475437695800,475457606300,19910500,-1
955,1,STEP,475457635300,475477613900,19978600,-1
956,1,STEP,475477639300,475497847300,20208000,-1
957,1,STEP,475497871400,475517544000,19672600,-1
958,1,STEP,475517570600,475538774900,21204300,-1
959,1,STEP,475538808700,475558438600,19629900,-1
960,1,STEP,475558476100,475578367700,19891600,-1
961,1,STEP,475578398200,475598357000,19958800,-1
962,1,STEP,475598402000,475618189100,19787100,-1
963,1,STEP,475618233100,475638388800,20155700,-1
964,1,STEP,475638532100,475657840900,19308800,-1
965,1,STEP,475657889300,475678119500,20230200,-1
966,1,STEP,475678157400,475698111700,19954300,-1
967,1,STEP,475698157700,475718908300,20750600,-1
968,1,STEP,475718934900,475738808100,19873200,-1
969,1,STEP,475738845300,475759444800,20599500,-1
970,1,STEP,475759484600,475779268600,19784000,-1
971,1,STEP,475779314000,475799488200,20174200,-1
972,1,STEP,475799531400,475819411500,19880100,-1
973,1,STEP,475819455900,475838947200,19491300,-1
974,1,STEP,475838996900,475858560800,19563900,-1
975,1,STEP,475858605500,475878354500,19749000,-1
976,1,STEP,475878397500,475898118600,19721100,-1
977,1,STEP,475898159000,475918179200,20020200,-1
978,1,STEP,475918218800,475938467000,20248200,-1
979,1,STEP,475938525200,475958456200,19931000,-1
980,1,STEP,475958527400,475978378100,19850700,-1
981,1,STEP,475978549000,475998960300,20411300,-1
982,1,STEP,475999001000,476019401300,20400300,-1
983,1,STEP,476019445300,476039983300,20538000,-1
984,1,STEP,476040034200,476059612500,19578300,-1
985,1,STEP,476059653700,476079608100,19954400,-1
986,1,STEP,476079653400,476099973600,20320200,-1
987,1,STEP,476100069000,476120644000,20575000,-1
988,1,STEP,476120691300,476140333400,19642100,-1
989,1,STEP,476140377400,476160503200,20125800,-1
990,1,STEP,476160551700,476180137600,19585900,-1
991,1,STEP,476180188000,476200262900,20074900,-1
992,1,STEP,476200335700,476220755800,20420100,-1
993,1,STEP,476220808800,476240723000,19914200,-1
994,1,STEP,476240770500,476260122400,19351900,-1
995,1,STEP,476260170500,476279593200,19422700,-1
996,1,STEP,476279652200,476299130000,19477800,-1
997,1,STEP,476299185900,476319074300,19888400,-1
998,1,STEP,476319137800,476338117700,18979900,-1
999,1,STEP,476338165500,476358000100,19834600,-1
