Gen,Resource,Stamp,TimeStamp_Start,TimeStamp_End,Duration,Indiv_id
0,1,FirstEvaluation,760805427400,761559617200,754189800,-1
0,1,STEP,761560525400,761566161800,5636400,-1
1,1,STEP,761566258300,761571148600,4890300,-1
2,1,STEP,761571235800,761575853500,4617700,-1
3,1,STEP,761575931700,761580369300,4437600,-1
4,1,STEP,761580450700,761584738300,4287600,-1
5,1,STEP,761584826800,761588784900,3958100,-1
6,1,STEP,761588863700,761593199100,4335400,-1
7,1,STEP,761593283600,761597837800,4554200,-1
8,1,STEP,761597973700,761603375000,5401300,-1
9,1,STEP,761603457900,761606634200,3176300,-1
10,1,STEP,761606715400,761610548900,3833500,-1
11,1,STEP,761610642900,761615755700,5112800,-1
12,1,STEP,761615836800,761620220800,4384000,-1
13,1,STEP,761620299600,761623799600,3500000,-1
14,1,STEP,761623867000,761628250600,4383600,-1
15,1,STEP,761628331300,761631854500,3523200,-1
16,1,STEP,761631925700,761636563900,4638200,-1
17,1,STEP,761636639600,761640112500,3472900,-1
18,1,STEP,761640193500,761644393900,4200400,-1
19,1,STEP,761644467800,761648588900,4121100,-1
20,1,STEP,761648684700,761652303100,3618400,-1
21,1,STEP,761652397900,761656457400,4059500,-1
22,1,STEP,761656534600,761661206100,4671500,-1
23,1,STEP,761661339900,761664864400,3524500,-1
24,1,STEP,761664938700,761668379300,3440600,-1
25,1,STEP,761668458000,761672961800,4503800,-1
26,1,STEP,761673039700,761677246300,4206600,-1
27,1,STEP,761677332900,761681488500,4155600,-1
28,1,STEP,761681585200,761685153500,3568300,-1
29,1,STEP,761685229100,761689398700,4169600,-1
30,1,STEP,761689498100,761693773900,4275800,-1
31,1,STEP,761693861200,761697772000,3910800,-1
32,1,STEP,761697874900,761700914400,3039500,-1
33,1,STEP,761701009400,761705317900,4308500,-1
34,1,STEP,761705404400,761711024100,5619700,-1
35,1,STEP,761711180700,761717017400,5836700,-1
36,1,STEP,761717141700,761722363400,5221700,-1
37,1,STEP,761722504800,761726504200,3999400,-1
38,1,STEP,761726589900,761730477700,3887800,-1
39,1,STEP,761730590100,761735432500,4842400,-1
40,1,STEP,761735532300,761741042900,5510600,-1
41,1,STEP,761741150700,761745563300,4412600,-1
42,1,STEP,761745662900,761750221300,4558400,-1
43,1,STEP,761750349100,761754433700,4084600,-1
44,1,STEP,761754520700,761758650300,4129600,-1
45,1,STEP,761758744200,761763334600,4590400,-1
46,1,STEP,761763421300,761769727600,6306300,-1
47,1,STEP,761769927500,761774686900,4759400,-1
48,1,STEP,761774777500,761779498400,4720900,-1
49,1,STEP,761779620900,761783700600,4079700,-1
50,1,STEP,761783781400,761787435600,3654200,-1
51,1,STEP,761787529300,761792039300,4510000,-1
52,1,STEP,761792127800,761796187500,4059700,-1
53,1,STEP,761796262700,761800702900,4440200,-1
54,1,STEP,761800788500,761804002900,3214400,-1
55,1,STEP,761804070100,761808049500,3979400,-1
56,1,STEP,761808130100,761814097700,5967600,-1
57,1,STEP,761814219300,761819660200,5440900,-1
58,1,STEP,761819787700,761825912800,6125100,-1
59,1,STEP,761826044900,761830875200,4830300,-1
60,1,STEP,761831004200,761836715700,5711500,-1
61,1,STEP,761836846000,761841558400,4712400,-1
62,1,STEP,761841698700,761847682500,5983800,-1
63,1,STEP,761847833000,761852854200,5021200,-1
64,1,STEP,761852996000,761857757700,4761700,-1
65,1,STEP,761857836900,761860955200,3118300,-1
66,1,STEP,761861023900,761864494900,3471000,-1
67,1,STEP,761864584500,761868134500,3550000,-1
68,1,STEP,761868202900,761871861100,3658200,-1
69,1,STEP,761871957100,761876473000,4515900,-1
70,1,STEP,761876555400,761879830100,3274700,-1
71,1,STEP,761879899600,761884085000,4185400,-1
72,1,STEP,761884175400,761887722100,3546700,-1
73,1,STEP,761887810000,761891339700,3529700,-1
74,1,STEP,761891448700,761894742400,3293700,-1
75,1,STEP,761894854600,761898753500,3898900,-1
76,1,STEP,761898841900,761902949500,4107600,-1
77,1,STEP,761903032500,761906510300,3477800,-1
78,1,STEP,761906602100,761909761400,3159300,-1
79,1,STEP,761909830900,761913016800,3185900,-1
80,1,STEP,761913092400,761917007900,3915500,-1
81,1,STEP,761917086300,761920855600,3769300,-1
82,1,STEP,761920931800,761924737200,3805400,-1
83,1,STEP,761924820400,761928678200,3857800,-1
84,1,STEP,761928751100,761933124300,4373200,-1
85,1,STEP,761933213100,761936259100,3046000,-1
86,1,STEP,761936324400,761940410600,4086200,-1
87,1,STEP,761940505600,761944286300,3780700,-1
88,1,STEP,761944352600,761948208300,3855700,-1
89,1,STEP,761948284700,761952145700,3861000,-1
90,1,STEP,761952263100,761955817300,3554200,-1
91,1,STEP,761955888400,761959872800,3984400,-1
92,1,STEP,761959963800,761963822000,3858200,-1
93,1,STEP,761963895900,761968576600,4680700,-1
94,1,STEP,761968667700,761972588700,3921000,-1
95,1,STEP,761972707100,761976333900,3626800,-1
96,1,STEP,761976407400,761979102600,2695200,-1
97,1,STEP,761979167300,761984096500,4929200,-1
98,1,STEP,761984233500,761988826600,4593100,-1
99,1,STEP,761989013800,761993455300,4441500,-1
100,1,STEP,761993617900,761998344200,4726300,-1
101,1,STEP,761998459100,762002428800,3969700,-1
102,1,STEP,762002549000,762006529600,3980600,-1
103,1,STEP,762006622100,762010955900,4333800,-1
104,1,STEP,762011061600,762014410800,3349200,-1
105,1,STEP,762014585500,762017777600,3192100,-1
106,1,STEP,762017857900,762022011800,4153900,-1
107,1,STEP,762022109400,762026766300,4656900,-1
108,1,STEP,762026915400,762031685400,4770000,-1
109,1,STEP,762031846400,762035322300,3475900,-1
110,1,STEP,762035424900,762039932100,4507200,-1
111,1,STEP,762040013200,762043696500,3683300,-1
112,1,STEP,762043771000,762047717400,3946400,-1
113,1,STEP,762047788400,762050736800,2948400,-1
114,1,STEP,762050812300,762054465300,3653000,-1
115,1,STEP,762054533300,762058148700,3615400,-1
116,1,STEP,762058219500,762061649200,3429700,-1
117,1,STEP,762061717700,762068649300,6931600,-1
118,1,STEP,762068859900,762075101900,6242000,-1
119,1,STEP,762075183400,762079185400,4002000,-1
120,1,STEP,762079293200,762082990400,3697200,-1
121,1,STEP,762083077000,762086525800,3448800,-1
122,1,STEP,762086613800,762090301000,3687200,-1
123,1,STEP,762090388500,762094120100,3731600,-1
124,1,STEP,762094215100,762098340700,4125600,-1
125,1,STEP,762098449800,762101431300,2981500,-1
126,1,STEP,762101511500,762104592700,3081200,-1
127,1,STEP,762104672200,762108494900,3822700,-1
128,1,STEP,762108581200,762111727500,3146300,-1
129,1,STEP,762111826900,762115542200,3715300,-1
130,1,STEP,762115624600,762118961200,3336600,-1
131,1,STEP,762119055300,762122334900,3279600,-1
132,1,STEP,762122411500,762125467300,3055800,-1
133,1,STEP,762125539000,762129133400,3594400,-1
134,1,STEP,762129219000,762132913700,3694700,-1
135,1,STEP,762133049900,762136550700,3500800,-1
136,1,STEP,762136632700,762140643400,4010700,-1
137,1,STEP,762140782000,762145497300,4715300,-1
138,1,STEP,762145645800,762149695000,4049200,-1
139,1,STEP,762149773400,762154239600,4466200,-1
140,1,STEP,762154368900,762158468500,4099600,-1
141,1,STEP,762158540600,762162095200,3554600,-1
142,1,STEP,762162169400,762164941800,2772400,-1
143,1,STEP,762165011800,762168304100,3292300,-1
144,1,STEP,762168377700,762171344400,2966700,-1
145,1,STEP,762171411000,762175133000,3722000,-1
146,1,STEP,762175205600,762178393400,3187800,-1
147,1,STEP,762178463100,762182082900,3619800,-1
148,1,STEP,762182162100,762185525600,3363500,-1
149,1,STEP,762185592800,762188838800,3246000,-1
150,1,STEP,762188908200,762192028600,3120400,-1
151,1,STEP,762192099600,762195446900,3347300,-1
152,1,STEP,762195516700,762198570600,3053900,-1
153,1,STEP,762198640100,762201902900,3262800,-1
154,1,STEP,762201970600,762205390000,3419400,-1
155,1,STEP,762205462500,762208868800,3406300,-1
156,1,STEP,762208938000,762212600000,3662000,-1
157,1,STEP,762212671200,762216456400,3785200,-1
158,1,STEP,762216536100,762220011800,3475700,-1
159,1,STEP,762220081800,762223114100,3032300,-1
160,1,STEP,762223189100,762226600800,3411700,-1
161,1,STEP,762226671300,762230278500,3607200,-1
162,1,STEP,762230380500,762233803000,3422500,-1
163,1,STEP,762233870800,762237072400,3201600,-1
164,1,STEP,762237140500,762240372900,3232400,-1
165,1,STEP,762240442600,762243710000,3267400,-1
166,1,STEP,762243790100,762247529500,3739400,-1
167,1,STEP,762247603300,762251451100,3847800,-1
168,1,STEP,762251536200,762255049500,3513300,-1
169,1,STEP,762255120100,762258230900,3110800,-1
170,1,STEP,762258315800,762261655100,3339300,-1
171,1,STEP,762261736900,762264549100,2812200,-1
172,1,STEP,762264616300,762268850500,4234200,-1
173,1,STEP,762268921100,762271868000,2946900,-1
174,1,STEP,762271945500,762275305600,3360100,-1
175,1,STEP,762275374900,762278864400,3489500,-1
176,1,STEP,762278933800,762282126800,3193000,-1
177,1,STEP,762282194800,762285484600,3289800,-1
178,1,STEP,762285554400,762288830300,3275900,-1
179,1,STEP,762288913000,762292756400,3843400,-1
180,1,STEP,762292849800,762296333900,3484100,-1
181,1,STEP,762296404700,762299534800,3130100,-1
182,1,STEP,762299613100,762303169600,3556500,-1
183,1,STEP,762303243300,762306783000,3539700,-1
184,1,STEP,762306854000,762310548400,3694400,-1
185,1,STEP,762310616500,762313627100,3010600,-1
186,1,STEP,762313695100,762316947100,3252000,-1
187,1,STEP,762317014000,762320534000,3520000,-1
188,1,STEP,762320603000,762323593200,2990200,-1
189,1,STEP,762323659700,762326842000,3182300,-1
190,1,STEP,762326908400,762330239900,3331500,-1
191,1,STEP,762330308000,762333429900,3121900,-1
192,1,STEP,762333494500,762336608900,3114400,-1
193,1,STEP,762336675700,762340372300,3696600,-1
194,1,STEP,762340439500,762343651200,3211700,-1
195,1,STEP,762343718000,762346854500,3136500,-1
196,1,STEP,762346919300,762349437900,2518600,-1
197,1,STEP,762349503300,762352743800,3240500,-1
198,1,STEP,762352809700,762356041000,3231300,-1
199,1,STEP,762356114600,762359879400,3764800,-1
200,1,STEP,762359945700,762363250800,3305100,-1
201,1,STEP,762363318500,762366868300,3549800,-1
202,1,STEP,762366933800,762370371100,3437300,-1
203,1,STEP,762370441400,762373506400,3065000,-1
204,1,STEP,762373571000,762376829700,3258700,-1
205,1,STEP,762376897700,762380048200,3150500,-1
206,1,STEP,762380113400,762383793600,3680200,-1
207,1,STEP,762383862500,762387381100,3518600,-1
208,1,STEP,762387447300,762390915500,3468200,-1
209,1,STEP,762390983600,762394685100,3701500,-1
210,1,STEP,762394751600,762398166700,3415100,-1
211,1,STEP,762398247800,762401583000,3335200,-1
212,1,STEP,762401694100,762404986400,3292300,-1
213,1,STEP,762405110800,762408366400,3255600,-1
214,1,STEP,762408446700,762411591300,3144600,-1
215,1,STEP,762411724900,762415459500,3734600,-1
216,1,STEP,762415539300,762419126300,3587000,-1
217,1,STEP,762419207500,762422461800,3254300,-1
218,1,STEP,762422527600,762426116200,3588600,-1
219,1,STEP,762426186800,762429986000,3799200,-1
220,1,STEP,762430053000,762432962200,2909200,-1
221,1,STEP,762433033000,762435671900,2638900,-1
222,1,STEP,762435736700,762439026500,3289800,-1
223,1,STEP,762439093800,762442436600,3342800,-1
224,1,STEP,762442501800,762445410300,2908500,-1
225,1,STEP,762445475800,762448597900,3122100,-1
226,1,STEP,762448663100,762451723900,3060800,-1
227,1,STEP,762451832800,762454927600,3094800,-1
228,1,STEP,762454995800,762458195600,3199800,-1
229,1,STEP,762458271700,762461357100,3085400,-1
230,1,STEP,762461424000,762464926500,3502500,-1
231,1,STEP,762464994000,762467905500,2911500,-1
232,1,STEP,762467975300,762471613600,3638300,-1
233,1,STEP,762471685600,762475638300,3952700,-1
234,1,STEP,762475809400,762479368900,3559500,-1
235,1,STEP,762479492300,762483028800,3536500,-1
236,1,STEP,762483110100,762486144000,3033900,-1
237,1,STEP,762486211100,762490143500,3932400,-1
238,1,STEP,762490230000,762493431300,3201300,-1
239,1,STEP,762493591300,762497020300,3429000,-1
240,1,STEP,762497182900,762501475900,4293000,-1
241,1,STEP,762501645500,762505426500,3781000,-1
242,1,STEP,762505503300,762508708800,3205500,-1
243,1,STEP,762508860500,762512176700,3316200,-1
244,1,STEP,762512251200,762516189200,3938000,-1
245,1,STEP,762516322400,762520261000,3938600,-1
246,1,STEP,762520363700,762524341700,3978000,-1
247,1,STEP,762524423900,762527754900,3331000,-1
248,1,STEP,762527887900,762532079200,4191300,-1
249,1,STEP,762532160300,762534932700,2772400,-1
250,1,STEP,762535009200,762538560100,3550900,-1
251,1,STEP,762538637300,762542201300,3564000,-1
252,1,STEP,762542272000,762545559100,3287100,-1
253,1,STEP,762545627100,762549015400,3388300,-1
254,1,STEP,762549083100,762553148300,4065200,-1
255,1,STEP,762553222400,762556685300,3462900,-1
256,1,STEP,762556781000,762560137200,3356200,-1
257,1,STEP,762560205600,762563818800,3613200,-1
258,1,STEP,762563889100,762567260500,3371400,-1
259,1,STEP,762567327300,762570948600,3621300,-1
260,1,STEP,762571020500,762574540800,3520300,-1
261,1,STEP,762574614900,762577840500,3225600,-1
262,1,STEP,762577912600,762581686700,3774100,-1
263,1,STEP,762581755400,762585013800,3258400,-1
264,1,STEP,762585099900,762588936200,3836300,-1
265,1,STEP,762589009900,762592512300,3502400,-1
266,1,STEP,762592595400,762595803100,3207700,-1
267,1,STEP,762595874400,762598788700,2914300,-1
268,1,STEP,762598859300,762602284100,3424800,-1
269,1,STEP,762602351600,762605541200,3189600,-1
270,1,STEP,762605620800,762609102300,3481500,-1
271,1,STEP,762609172800,762612952700,3779900,-1
272,1,STEP,762613039200,762616034100,2994900,-1
273,1,STEP,762616105100,762619675500,3570400,-1
274,1,STEP,762619800400,762622807900,3007500,-1
275,1,STEP,762622879800,762625714300,2834500,-1
276,1,STEP,762625808600,762628999400,3190800,-1
277,1,STEP,762629068800,762632353300,3284500,-1
278,1,STEP,762632501500,762636150600,3649100,-1
279,1,STEP,762636218000,762639068000,2850000,-1
280,1,STEP,762639135200,762641993700,2858500,-1
281,1,STEP,762642061800,762645554800,3493000,-1
282,1,STEP,762645620200,762648962100,3341900,-1
283,1,STEP,762649030000,762652395600,3365600,-1
284,1,STEP,762652461700,762655941800,3480100,-1
285,1,STEP,762656009500,762658891700,2882200,-1
286,1,STEP,762658956900,762661936900,2980000,-1
287,1,STEP,762662005600,762665047200,3041600,-1
288,1,STEP,762665112400,762668511600,3399200,-1
289,1,STEP,762668582300,762671817600,3235300,-1
290,1,STEP,762671883300,762675088300,3205000,-1
291,1,STEP,762675160400,762678269800,3109400,-1
292,1,STEP,762678335600,762681160300,2824700,-1
293,1,STEP,762681329500,762684499400,3169900,-1
294,1,STEP,762684569600,762687580800,3011200,-1
295,1,STEP,762687646900,762690988600,3341700,-1
296,1,STEP,762691057600,762694056600,2999000,-1
297,1,STEP,762694121600,762697558200,3436600,-1
298,1,STEP,762697627200,762700461400,2834200,-1
299,1,STEP,762700526500,762703137000,2610500,-1
300,1,STEP,762703210800,762706023500,2812700,-1
301,1,STEP,762706088200,762708986600,2898400,-1
302,1,STEP,762709068300,762712740200,3671900,-1
303,1,STEP,762712807100,762716049000,3241900,-1
304,1,STEP,762716162700,762719287400,3124700,-1
305,1,STEP,762719358400,762722883700,3525300,-1
306,1,STEP,762723017700,762726547800,3530100,-1
307,1,STEP,762726615100,762730453100,3838000,-1
308,1,STEP,762730524400,762733668400,3144000,-1
309,1,STEP,762733733500,762736842900,3109400,-1
310,1,STEP,762736997800,762740268100,3270300,-1
311,1,STEP,762740334800,762743637900,3303100,-1
312,1,STEP,762743704300,762747448400,3744100,-1
313,1,STEP,762747516000,762750671400,3155400,-1
314,1,STEP,762750831700,762754303400,3471700,-1
315,1,STEP,762754369400,762757716700,3347300,-1
316,1,STEP,762757845000,762761192500,3347500,-1
317,1,STEP,762761260000,762764324800,3064800,-1
318,1,STEP,762764440500,762767430700,2990200,-1
319,1,STEP,762767497200,762770660300,3163100,-1
320,1,STEP,762770725900,762774336700,3610800,-1
321,1,STEP,762774404600,762778230800,3826200,-1
322,1,STEP,762778312500,762781594100,3281600,-1
323,1,STEP,762781660800,762785121000,3460200,-1
324,1,STEP,762785238900,762789308600,4069700,-1
325,1,STEP,762789386100,762792909100,3523000,-1
326,1,STEP,762792977900,762796628200,3650300,-1
327,1,STEP,762796695100,762800505500,3810400,-1
328,1,STEP,762800578600,762803847800,3269200,-1
329,1,STEP,762803913600,762807379300,3465700,-1
330,1,STEP,762807461200,762811955800,4494600,-1
331,1,STEP,762812033200,762815577400,3544200,-1
332,1,STEP,762815748300,762819652800,3904500,-1
333,1,STEP,762819722900,762823115600,3392700,-1
334,1,STEP,762823190000,762826532800,3342800,-1
335,1,STEP,762826599700,762830380600,3780900,-1
336,1,STEP,762830455800,762833993600,3537800,-1
337,1,STEP,762834062900,762837900600,3837700,-1
338,1,STEP,762837968200,762841660300,3692100,-1
339,1,STEP,762841769100,762844976400,3207300,-1
340,1,STEP,762845054800,762848441000,3386200,-1
341,1,STEP,762848512600,762851813600,3301000,-1
342,1,STEP,762851906100,762855268100,3362000,-1
343,1,STEP,762855347700,762858878800,3531100,-1
344,1,STEP,762858944300,762863158400,4214100,-1
345,1,STEP,762863231300,762867062400,3831100,-1
346,1,STEP,762867129500,762869906200,2776700,-1
347,1,STEP,762869979200,762873210900,3231700,-1
348,1,STEP,762873276900,762876757400,3480500,-1
349,1,STEP,762876827700,762880179500,3351800,-1
350,1,STEP,762880245300,762883544400,3299100,-1
351,1,STEP,762883612800,762886795800,3183000,-1
352,1,STEP,762886862200,762890708700,3846500,-1
353,1,STEP,762890797700,762894127300,3329600,-1
354,1,STEP,762894193300,762897851400,3658100,-1
355,1,STEP,762897921600,762901075400,3153800,-1
356,1,STEP,762901140700,762904763700,3623000,-1
357,1,STEP,762904833700,762908378600,3544900,-1
358,1,STEP,762908443900,762911196200,2752300,-1
359,1,STEP,762911264600,762914666200,3401600,-1
360,1,STEP,762914731900,762917815500,3083600,-1
361,1,STEP,762917914700,762921420100,3505400,-1
362,1,STEP,762921492000,762924865000,3373000,-1
363,1,STEP,762924939800,762928241900,3302100,-1
364,1,STEP,762928308100,762931931500,3623400,-1
365,1,STEP,762932003300,762934911600,2908300,-1
366,1,STEP,762934976900,762938760100,3783200,-1
367,1,STEP,762938830300,762941810600,2980300,-1
368,1,STEP,762941876000,762945768700,3892700,-1
369,1,STEP,762945935600,762949435500,3499900,-1
370,1,STEP,762949505800,762953195300,3689500,-1
371,1,STEP,762953288500,762955990000,2701500,-1
372,1,STEP,762956060400,762959916200,3855800,-1
373,1,STEP,762959996400,762963788300,3791900,-1
374,1,STEP,762963861200,762967125400,3264200,-1
375,1,STEP,762967218800,762970392100,3173300,-1
376,1,STEP,762970460800,762973963500,3502700,-1
377,1,STEP,762974051100,762977536300,3485200,-1
378,1,STEP,762977603600,762981471300,3867700,-1
379,1,STEP,762981559900,762984544700,2984800,-1
380,1,STEP,762984615700,762988417800,3802100,-1
381,1,STEP,762988496500,762991301600,2805100,-1
382,1,STEP,762991367600,762995543500,4175900,-1
383,1,STEP,762995629600,762999325000,3695400,-1
384,1,STEP,762999415400,763003462800,4047400,-1
385,1,STEP,763003542800,763006636600,3093800,-1
386,1,STEP,763006705900,763011368000,4662100,-1
387,1,STEP,763011449500,763015624000,4174500,-1
388,1,STEP,763015723600,763019290800,3567200,-1
389,1,STEP,763019371000,763023773200,4402200,-1
390,1,STEP,763023890100,763027623400,3733300,-1
391,1,STEP,763027706700,763032155600,4448900,-1
392,1,STEP,763032253700,763035846000,3592300,-1
393,1,STEP,763035974300,763039813800,3839500,-1
394,1,STEP,763039900500,763043058900,3158400,-1
395,1,STEP,763043195200,763046757300,3562100,-1
396,1,STEP,763046836300,763050216100,3379800,-1
397,1,STEP,763050319800,763054105200,3785400,-1
398,1,STEP,763054183400,763057716000,3532600,-1
399,1,STEP,763057837500,763061356700,3519200,-1
400,1,STEP,763061425800,763065138600,3712800,-1
401,1,STEP,763065211200,763068559200,3348000,-1
402,1,STEP,763068626200,763072764100,4137900,-1
403,1,STEP,763072840300,763076416100,3575800,-1
404,1,STEP,763076518300,763080178500,3660200,-1
405,1,STEP,763080272400,763083860500,3588100,-1
406,1,STEP,763083932400,763087047900,3115500,-1
407,1,STEP,763087119000,763090021300,2902300,-1
408,1,STEP,763090088100,763093669200,3581100,-1
409,1,STEP,763093745200,763097653600,3908400,-1
410,1,STEP,763097726800,763100729200,3002400,-1
411,1,STEP,763100799700,763104413900,3614200,-1
412,1,STEP,763104481500,763107829700,3348200,-1
413,1,STEP,763107924000,763111711900,3787900,-1
414,1,STEP,763111817800,763115050200,3232400,-1
415,1,STEP,763115133800,763118054500,2920700,-1
416,1,STEP,763118131200,763121694200,3563000,-1
417,1,STEP,763121796800,763125874700,4077900,-1
418,1,STEP,763125985100,763129726500,3741400,-1
419,1,STEP,763129822400,763133576700,3754300,-1
420,1,STEP,763133672400,763136382400,2710000,-1
421,1,STEP,763136461300,763140876100,4414800,-1
422,1,STEP,763140986100,763144359100,3373000,-1
423,1,STEP,763144464400,763147371700,2907300,-1
424,1,STEP,763147503500,763151063600,3560100,-1
425,1,STEP,763151136100,763155239100,4103000,-1
426,1,STEP,763155367600,763158911900,3544300,-1
427,1,STEP,763158996400,763162743900,3747500,-1
428,1,STEP,763162826300,763165510500,2684200,-1
429,1,STEP,763165580500,763168841300,3260800,-1
430,1,STEP,763168921900,763172155500,3233600,-1
431,1,STEP,763172229300,763175041300,2812000,-1
432,1,STEP,763175127700,763177762900,2635200,-1
433,1,STEP,763177834100,763181177500,3343400,-1
434,1,STEP,763181247900,763184742300,3494400,-1
435,1,STEP,763184814600,763188316800,3502200,-1
436,1,STEP,763188404900,763192018200,3613300,-1
437,1,STEP,763192088500,763195689200,3600700,-1
438,1,STEP,763195775400,763199371400,3596000,-1
439,1,STEP,763199467200,763202827300,3360100,-1
440,1,STEP,763202902900,763205731200,2828300,-1
441,1,STEP,763205802700,763208976900,3174200,-1
442,1,STEP,763209052200,763212026600,2974400,-1
443,1,STEP,763212094500,763215392700,3298200,-1
444,1,STEP,763215461000,763218333200,2872200,-1
445,1,STEP,763218403100,763221917900,3514800,-1
446,1,STEP,763221986500,763224783300,2796800,-1
447,1,STEP,763224854600,763228239700,3385100,-1
448,1,STEP,763228307800,763231632200,3324400,-1
449,1,STEP,763231712400,763235361800,3649400,-1
450,1,STEP,763235432400,763238501800,3069400,-1
451,1,STEP,763238572200,763242414400,3842200,-1
452,1,STEP,763242485800,763245625900,3140100,-1
453,1,STEP,763245699000,763249614700,3915700,-1
454,1,STEP,763249691300,763252265600,2574300,-1
455,1,STEP,763252359100,763255000600,2641500,-1
456,1,STEP,763255067800,763258573900,3506100,-1
457,1,STEP,763258654700,763262414900,3760200,-1
458,1,STEP,763262490700,763265759400,3268700,-1
459,1,STEP,763265846400,763269042500,3196100,-1
460,1,STEP,763269121800,763272800100,3678300,-1
461,1,STEP,763272881400,763276460000,3578600,-1
462,1,STEP,763276534200,763280277800,3743600,-1
463,1,STEP,763280395100,763283858500,3463400,-1
464,1,STEP,763283932200,763287024700,3092500,-1
465,1,STEP,763287101200,763290853700,3752500,-1
466,1,STEP,763290923100,763294100600,3177500,-1
467,1,STEP,763294171100,763297697000,3525900,-1
468,1,STEP,763297764700,763301076400,3311700,-1
469,1,STEP,763301150500,763304412700,3262200,-1
470,1,STEP,763304480000,763307442100,2962100,-1
471,1,STEP,763307510800,763310525800,3015000,-1
472,1,STEP,763310599300,763313989900,3390600,-1
473,1,STEP,763314060300,763317195200,3134900,-1
474,1,STEP,763317262200,763320634900,3372700,-1
475,1,STEP,763320705200,763324093100,3387900,-1
476,1,STEP,763324160900,763327392900,3232000,-1
477,1,STEP,763327478800,763331278600,3799800,-1
478,1,STEP,763331349800,763334378700,3028900,-1
479,1,STEP,763334452200,763337747600,3295400,-1
480,1,STEP,763337815800,763340809900,2994100,-1
481,1,STEP,763340878500,763344482200,3603700,-1
482,1,STEP,763344555600,763347979900,3424300,-1
483,1,STEP,763348083400,763351592900,3509500,-1
484,1,STEP,763351661500,763355072000,3410500,-1
485,1,STEP,763355142500,763358122300,2979800,-1
486,1,STEP,763358193900,763361446600,3252700,-1
487,1,STEP,763361534600,763364554400,3019800,-1
488,1,STEP,763364622100,763367692400,3070300,-1
489,1,STEP,763367759600,763371156000,3396400,-1
490,1,STEP,763371231100,763374900700,3669600,-1
491,1,STEP,763374968900,763377976200,3007300,-1
492,1,STEP,763378044600,763381290600,3246000,-1
493,1,STEP,763381369800,763384878800,3509000,-1
494,1,STEP,763384948400,763388644700,3696300,-1
495,1,STEP,763388747500,763392396600,3649100,-1
496,1,STEP,763392473400,763395822100,3348700,-1
497,1,STEP,763395890400,763399032800,3142400,-1
498,1,STEP,763399102800,763402154700,3051900,-1
499,1,STEP,763402221300,763405234500,3013200,-1
500,1,STEP,763405303200,763408134400,2831200,-1
501,1,STEP,763408201100,763411676500,3475400,-1
502,1,STEP,763411746800,763415429400,3682600,-1
503,1,STEP,763415516300,763418645500,3129200,-1
504,1,STEP,763418718100,763421682000,2963900,-1
505,1,STEP,763421755100,763425025500,3270400,-1
506,1,STEP,763425095800,763428162100,3066300,-1
507,1,STEP,763428228800,763432172700,3943900,-1
508,1,STEP,763432252200,763435016600,2764400,-1
509,1,STEP,763435082700,763438298400,3215700,-1
510,1,STEP,763438370700,763442165600,3794900,-1
511,1,STEP,763442241400,763445448600,3207200,-1
512,1,STEP,763445568800,763449041800,3473000,-1
513,1,STEP,763449110600,763452889700,3779100,-1
514,1,STEP,763452968500,763456502300,3533800,-1
515,1,STEP,763456570200,763460041000,3470800,-1
516,1,STEP,763460112300,763463745500,3633200,-1
517,1,STEP,763463812700,763467205300,3392600,-1
518,1,STEP,763467275300,763471497200,4221900,-1
519,1,STEP,763471567000,763475726800,4159800,-1
520,1,STEP,763475806900,763479579500,3772600,-1
521,1,STEP,763479703700,763483553500,3849800,-1
522,1,STEP,763483622000,763487441700,3819700,-1
523,1,STEP,763487514500,763490823500,3309000,-1
524,1,STEP,763490891100,763494610400,3719300,-1
525,1,STEP,763494685800,763498032400,3346600,-1
526,1,STEP,763498104900,763501719000,3614100,-1
527,1,STEP,763501796500,763505390400,3593900,-1
528,1,STEP,763505457800,763508773300,3315500,-1
529,1,STEP,763508842000,763512093000,3251000,-1
530,1,STEP,763512165800,763515608200,3442400,-1
531,1,STEP,763515679600,763518743600,3064000,-1
532,1,STEP,763518811900,763521776700,2964800,-1
533,1,STEP,763521854700,763524977800,3123100,-1
534,1,STEP,763525045300,763528762300,3717000,-1
535,1,STEP,763528833700,763531960800,3127100,-1
536,1,STEP,763532045300,763535975100,3929800,-1
537,1,STEP,763536078800,763540103800,4025000,-1
538,1,STEP,763540180100,763543889900,3709800,-1
539,1,STEP,763543967000,763546846200,2879200,-1
540,1,STEP,763546912800,763550801800,3889000,-1
541,1,STEP,763550876700,763553956000,3079300,-1
542,1,STEP,763554022900,763557153100,3130200,-1
543,1,STEP,763557224300,763559874400,2650100,-1
544,1,STEP,763559941500,763563426800,3485300,-1
545,1,STEP,763563514100,763566850600,3336500,-1
546,1,STEP,763566918900,763570127200,3208300,-1
547,1,STEP,763570196000,763573827300,3631300,-1
548,1,STEP,763573895900,763577103100,3207200,-1
549,1,STEP,763577196800,763580148300,2951500,-1
550,1,STEP,763580237100,763583365800,3128700,-1
551,1,STEP,763583433100,763586341100,2908000,-1
552,1,STEP,763586413700,763589401700,2988000,-1
553,1,STEP,763589470100,763592999700,3529600,-1
554,1,STEP,763593078200,763596568600,3490400,-1
555,1,STEP,763596636500,763600164300,3527800,-1
556,1,STEP,763600240300,763603722400,3482100,-1
557,1,STEP,763603789800,763607179300,3389500,-1
558,1,STEP,763607248800,763611241400,3992600,-1
559,1,STEP,763611311100,763615033700,3722600,-1
560,1,STEP,763615105400,763618217400,3112000,-1
561,1,STEP,763618285000,763621891700,3606700,-1
562,1,STEP,763621961900,763625034300,3072400,-1
563,1,STEP,763625101600,763627948400,2846800,-1
564,1,STEP,763628017300,763631488400,3471100,-1
565,1,STEP,763631556700,763635216200,3659500,-1
566,1,STEP,763635288300,763639208800,3920500,-1
567,1,STEP,763639278400,763643297500,4019100,-1
568,1,STEP,763643379100,763646060700,2681600,-1
569,1,STEP,763646128100,763649637200,3509100,-1
570,1,STEP,763649712600,763652867900,3155300,-1
571,1,STEP,763652936100,763656227600,3291500,-1
572,1,STEP,763656298400,763659468900,3170500,-1
573,1,STEP,763659541200,763662977900,3436700,-1
574,1,STEP,763663047500,763666024900,2977400,-1
575,1,STEP,763666091900,763669221000,3129100,-1
576,1,STEP,763669291200,763673237500,3946300,-1
577,1,STEP,763673310100,763676520700,3210600,-1
578,1,STEP,763676591700,763679844900,3253200,-1
579,1,STEP,763679912800,763683303200,3390400,-1
580,1,STEP,763683385900,763687283900,3898000,-1
581,1,STEP,763687352700,763690708100,3355400,-1
582,1,STEP,763690777600,763693441800,2664200,-1
583,1,STEP,763693508100,763696983600,3475500,-1
584,1,STEP,763697053600,763699808000,2754400,-1
585,1,STEP,763699874800,763704073100,4198300,-1
586,1,STEP,763704149300,763707610900,3461600,-1
587,1,STEP,763707678000,763710298800,2620800,-1
588,1,STEP,763710374100,763714087800,3713700,-1
589,1,STEP,763714155800,763717340500,3184700,-1
590,1,STEP,763717409400,763720740500,3331100,-1
591,1,STEP,763720808800,763723360200,2551400,-1
592,1,STEP,763723428500,763726316800,2888300,-1
593,1,STEP,763726382900,763729442100,3059200,-1
594,1,STEP,763729510000,763733066700,3556700,-1
595,1,STEP,763733133900,763736351400,3217500,-1
596,1,STEP,763736417600,763740184300,3766700,-1
597,1,STEP,763740273700,763743556300,3282600,-1
598,1,STEP,763743665700,763746540400,2874700,-1
599,1,STEP,763746610700,763750306800,3696100,-1
600,1,STEP,763750455600,763754195400,3739800,-1
601,1,STEP,763754342700,763758681400,4338700,-1
602,1,STEP,763758756200,763762041500,3285300,-1
603,1,STEP,763762110800,763766753400,4642600,-1
604,1,STEP,763766829300,763769784000,2954700,-1
605,1,STEP,763769849900,763773209200,3359300,-1
606,1,STEP,763773287000,763776624100,3337100,-1
607,1,STEP,763776692000,763780334300,3642300,-1
608,1,STEP,763780404000,763783974900,3570900,-1
609,1,STEP,763784040900,763787678900,3638000,-1
610,1,STEP,763787747300,763792100800,4353500,-1
611,1,STEP,763792305200,763795322600,3017400,-1
612,1,STEP,763795388900,763798506900,3118000,-1
613,1,STEP,763798586500,763802211600,3625100,-1
614,1,STEP,763802280400,763805664400,3384000,-1
615,1,STEP,763805729900,763809497000,3767100,-1
616,1,STEP,763809584800,763813787800,4203000,-1
617,1,STEP,763813929000,763817277500,3348500,-1
618,1,STEP,763817355200,763820772400,3417200,-1
619,1,STEP,763820841900,763824092400,3250500,-1
620,1,STEP,763824157800,763826820800,2663000,-1
621,1,STEP,763826947800,763830286200,3338400,-1
622,1,STEP,763830355600,763834238600,3883000,-1
623,1,STEP,763834310800,763837479400,3168600,-1
624,1,STEP,763837546800,763840857900,3311100,-1
625,1,STEP,763840931300,763844304000,3372700,-1
626,1,STEP,763844372200,763847788000,3415800,-1
627,1,STEP,763847863600,763851122200,3258600,-1
628,1,STEP,763851193300,763854960600,3767300,-1
629,1,STEP,763855062200,763859073100,4010900,-1
630,1,STEP,763859142200,763862229400,3087200,-1
631,1,STEP,763862299800,763865493500,3193700,-1
632,1,STEP,763865571900,763869006000,3434100,-1
633,1,STEP,763869078000,763872791000,3713000,-1
634,1,STEP,763872903700,763876160900,3257200,-1
635,1,STEP,763876232000,763879529000,3297000,-1
636,1,STEP,763879597700,763882592500,2994800,-1
637,1,STEP,763882660900,763885588900,2928000,-1
638,1,STEP,763885656800,763889587800,3931000,-1
639,1,STEP,763889685100,763893173700,3488600,-1
640,1,STEP,763893241900,763896497900,3256000,-1
641,1,STEP,763896570200,763900185300,3615100,-1
642,1,STEP,763900253700,763903752100,3498400,-1
643,1,STEP,763903824900,763907112800,3287900,-1
644,1,STEP,763907179800,763910966000,3786200,-1
645,1,STEP,763911036100,763914760700,3724600,-1
646,1,STEP,763914827300,763917923200,3095900,-1
647,1,STEP,763917996700,763921371600,3374900,-1
648,1,STEP,763921451400,763924773000,3321600,-1
649,1,STEP,763924842300,763928243900,3401600,-1
650,1,STEP,763928311700,763932216900,3905200,-1
651,1,STEP,763932287600,763936255000,3967400,-1
652,1,STEP,763936321800,763940083500,3761700,-1
653,1,STEP,763940153500,763943544800,3391300,-1
654,1,STEP,763943610900,763946990000,3379100,-1
655,1,STEP,763947060700,763950757700,3697000,-1
656,1,STEP,763950824800,763953886300,3061500,-1
657,1,STEP,763953960700,763957793900,3833200,-1
658,1,STEP,763957861200,763961252400,3391200,-1
659,1,STEP,763961322200,763964164000,2841800,-1
660,1,STEP,763964372000,763967603000,3231000,-1
661,1,STEP,763967671400,763971707900,4036500,-1
662,1,STEP,763971774700,763975443400,3668700,-1
663,1,STEP,763975511700,763978637200,3125500,-1
664,1,STEP,763978702600,763981578400,2875800,-1
665,1,STEP,763981648600,763984980100,3331500,-1
666,1,STEP,763985046000,763988898200,3852200,-1
667,1,STEP,763988980400,763992891200,3910800,-1
668,1,STEP,763992970500,763997477200,4506700,-1
669,1,STEP,763997548500,764001359300,3810800,-1
670,1,STEP,764001429400,764004609700,3180300,-1
671,1,STEP,764004675800,764008078900,3403100,-1
672,1,STEP,764008153800,764011545000,3391200,-1
673,1,STEP,764011613500,764015166800,3553300,-1
674,1,STEP,764015250900,764019067000,3816100,-1
675,1,STEP,764019133700,764022675700,3542000,-1
676,1,STEP,764022786500,764026015800,3229300,-1
677,1,STEP,764026086800,764029785500,3698700,-1
678,1,STEP,764029856000,764032754100,2898100,-1
679,1,STEP,764032819300,764035946700,3127400,-1
680,1,STEP,764036043100,764038869000,2825900,-1
681,1,STEP,764038934100,764042993500,4059400,-1
682,1,STEP,764043064800,764046666000,3601200,-1
683,1,STEP,764046760800,764050231600,3470800,-1
684,1,STEP,764050304500,764053672800,3368300,-1
685,1,STEP,764053739900,764057016600,3276700,-1
686,1,STEP,764057099800,764061085300,3985500,-1
687,1,STEP,764061158500,764065067600,3909100,-1
688,1,STEP,764065136900,764068398400,3261500,-1
689,1,STEP,764068464300,764071901500,3437200,-1
690,1,STEP,764071972400,764075457700,3485300,-1
691,1,STEP,764075523600,764079725300,4201700,-1
692,1,STEP,764079802400,764083223500,3421100,-1
693,1,STEP,764083289800,764086979800,3690000,-1
694,1,STEP,764087198800,764094965500,7766700,-1
695,1,STEP,764095137400,764100310500,5173100,-1
696,1,STEP,764100381200,764103743400,3362200,-1
697,1,STEP,764103810100,764107200800,3390700,-1
698,1,STEP,764107270700,764110325600,3054900,-1
699,1,STEP,764110393200,764114394800,4001600,-1
700,1,STEP,764114464200,764117645300,3181100,-1
701,1,STEP,764117711000,764122164200,4453200,-1
702,1,STEP,764122238000,764125864000,3626000,-1
703,1,STEP,764126048700,764129623900,3575200,-1
704,1,STEP,764129691300,764133517100,3825800,-1
705,1,STEP,764133814200,764136867400,3053200,-1
706,1,STEP,764136934000,764140420200,3486200,-1
707,1,STEP,764140493500,764143492300,2998800,-1
708,1,STEP,764143557300,764147052200,3494900,-1
709,1,STEP,764147187400,764150473700,3286300,-1
710,1,STEP,764150544800,764154991400,4446600,-1
711,1,STEP,764155074400,764158630300,3555900,-1
712,1,STEP,764158712500,764162572100,3859600,-1
713,1,STEP,764162658300,764166491500,3833200,-1
714,1,STEP,764166584500,764170898900,4314400,-1
715,1,STEP,764170982900,764174670000,3687100,-1
716,1,STEP,764174847200,764178553700,3706500,-1
717,1,STEP,764178675400,764183735000,5059600,-1
718,1,STEP,764183823200,764188027500,4204300,-1
719,1,STEP,764188167900,764192143800,3975900,-1
720,1,STEP,764192215400,764196105200,3889800,-1
721,1,STEP,764196224400,764199290900,3066500,-1
722,1,STEP,764199356700,764203210700,3854000,-1
723,1,STEP,764203362200,764205918200,2556000,-1
724,1,STEP,764205983600,764208787300,2803700,-1
725,1,STEP,764208886100,764212648200,3762100,-1
726,1,STEP,764212727500,764215376200,2648700,-1
727,1,STEP,764215441100,764219189600,3748500,-1
728,1,STEP,764219256800,764222539000,3282200,-1
729,1,STEP,764222642000,764226227000,3585000,-1
730,1,STEP,764226305300,764229051500,2746200,-1
731,1,STEP,764229116700,764232295900,3179200,-1
732,1,STEP,764232366900,764235391600,3024700,-1
733,1,STEP,764235458800,764238703500,3244700,-1
734,1,STEP,764238772800,764241936900,3164100,-1
735,1,STEP,764242005000,764245959100,3954100,-1
736,1,STEP,764246031100,764249764700,3733600,-1
737,1,STEP,764249833400,764253897700,4064300,-1
738,1,STEP,764253979400,764257373000,3393600,-1
739,1,STEP,764257440600,764261378300,3937700,-1
740,1,STEP,764261448900,764265235300,3786400,-1
741,1,STEP,764265319400,764269277300,3957900,-1
742,1,STEP,764269347900,764273048100,3700200,-1
743,1,STEP,764273125800,764276418600,3292800,-1
744,1,STEP,764276487000,764280473700,3986700,-1
745,1,STEP,764280551200,764284288100,3736900,-1
746,1,STEP,764284371400,764288297800,3926400,-1
747,1,STEP,764288368300,764291770600,3402300,-1
748,1,STEP,764291841900,764295338500,3496600,-1
749,1,STEP,764295409400,764299138300,3728900,-1
750,1,STEP,764299213900,764302120700,2906800,-1
751,1,STEP,764302189300,764305151600,2962300,-1
752,1,STEP,764305253000,764308886400,3633400,-1
753,1,STEP,764308956700,764312031500,3074800,-1
754,1,STEP,764312099700,764315397700,3298000,-1
755,1,STEP,764315480600,764319350700,3870100,-1
756,1,STEP,764319428000,764322808400,3380400,-1
757,1,STEP,764322878900,764326662500,3783600,-1
758,1,STEP,764326736100,764330163200,3427100,-1
759,1,STEP,764330238900,764334824800,4585900,-1
760,1,STEP,764334894000,764338868100,3974100,-1
761,1,STEP,764338935300,764342473300,3538000,-1
762,1,STEP,764342545600,764346129500,3583900,-1
763,1,STEP,764346255000,764349628200,3373200,-1
764,1,STEP,764349698600,764352818800,3120200,-1
765,1,STEP,764352884500,764356359200,3474700,-1
766,1,STEP,764356428100,764359452500,3024400,-1
767,1,STEP,764359522000,764363545100,4023100,-1
768,1,STEP,764363635100,764366936000,3300900,-1
769,1,STEP,764367004700,764370568500,3563800,-1
770,1,STEP,764370637700,764374004200,3366500,-1
771,1,STEP,764374069600,764377150100,3080500,-1
772,1,STEP,764377219600,764380802000,3582400,-1
773,1,STEP,764380873500,764384558200,3684700,-1
774,1,STEP,764384627100,764387234200,2607100,-1
775,1,STEP,764387298600,764390280400,2981800,-1
776,1,STEP,764390349600,764393391400,3041800,-1
777,1,STEP,764393457000,764397087300,3630300,-1
778,1,STEP,764397157300,764399952400,2795100,-1
779,1,STEP,764400017200,764403335200,3318000,-1
780,1,STEP,764403441300,764407371400,3930100,-1
781,1,STEP,764407438300,764411182100,3743800,-1
782,1,STEP,764411251400,764414412700,3161300,-1
783,1,STEP,764414477200,764418307800,3830600,-1
784,1,STEP,764418377600,764421913500,3535900,-1
785,1,STEP,764421979400,764425469400,3490000,-1
786,1,STEP,764425546900,764428848700,3301800,-1
787,1,STEP,764428913800,764433116000,4202200,-1
788,1,STEP,764433185600,764436139300,2953700,-1
789,1,STEP,764436204500,764439557200,3352700,-1
790,1,STEP,764439627700,764443207000,3579300,-1
791,1,STEP,764443272600,764446937500,3664900,-1
792,1,STEP,764447006400,764450218400,3212000,-1
793,1,STEP,764450295000,764454018300,3723300,-1
794,1,STEP,764454088200,764457943400,3855200,-1
795,1,STEP,764458009700,764461475100,3465400,-1
796,1,STEP,764461543800,764464949500,3405700,-1
797,1,STEP,764465014800,764468795600,3780800,-1
798,1,STEP,764468865800,764472223900,3358100,-1
799,1,STEP,764472290300,764476465900,4175600,-1
800,1,STEP,764476590300,764479532700,2942400,-1
801,1,STEP,764479645500,764482897100,3251600,-1
802,1,STEP,764482964100,764486203100,3239000,-1
803,1,STEP,764486268100,764489934300,3666200,-1
804,1,STEP,764490004000,764492999700,2995700,-1
805,1,STEP,764493068600,764496894900,3826300,-1
806,1,STEP,764496968100,764500723800,3755700,-1
807,1,STEP,764500876500,764504317900,3441400,-1
808,1,STEP,764504385900,764508059100,3673200,-1
809,1,STEP,764508175600,764512358800,4183200,-1
810,1,STEP,764512430800,764515933600,3502800,-1
811,1,STEP,764516004400,764519713600,3709200,-1
812,1,STEP,764519803800,764523983100,4179300,-1
813,1,STEP,764524068400,764527158500,3090100,-1
814,1,STEP,764527225500,764531589000,4363500,-1
815,1,STEP,764531671400,764534894100,3222700,-1
816,1,STEP,764534971400,764539146700,4175300,-1
817,1,STEP,764539230300,764542988000,3757700,-1
818,1,STEP,764543067800,764546971100,3903300,-1
819,1,STEP,764547044900,764550723900,3679000,-1
820,1,STEP,764550819100,764554247100,3428000,-1
821,1,STEP,764554318700,764557790500,3471800,-1
822,1,STEP,764557866500,764561692000,3825500,-1
823,1,STEP,764561786200,764564704700,2918500,-1
824,1,STEP,764564798400,764568486000,3687600,-1
825,1,STEP,764568564400,764572156400,3592000,-1
826,1,STEP,764572239300,764575488700,3249400,-1
827,1,STEP,764575563400,764579893300,4329900,-1
828,1,STEP,764579981300,764583172800,3191500,-1
829,1,STEP,764583244200,764586518000,3273800,-1
830,1,STEP,764586594100,764590174100,3580000,-1
831,1,STEP,764590247300,764594298000,4050700,-1
832,1,STEP,764594381000,764598169600,3788600,-1
833,1,STEP,764598243300,764601280600,3037300,-1
834,1,STEP,764601350800,764604695100,3344300,-1
835,1,STEP,764604783500,764608061600,3278100,-1
836,1,STEP,764608135200,764610977400,2842200,-1
837,1,STEP,764611053700,764614750200,3696500,-1
838,1,STEP,764614842300,764618058400,3216100,-1
839,1,STEP,764618131100,764621586400,3455300,-1
840,1,STEP,764621660100,764624367900,2707800,-1
841,1,STEP,764624437700,764627801700,3364000,-1
842,1,STEP,764627883900,764631879100,3995200,-1
843,1,STEP,764631968600,764635204800,3236200,-1
844,1,STEP,764635288600,764638853800,3565200,-1
845,1,STEP,764638926100,764642140400,3214300,-1
846,1,STEP,764642261000,764645762100,3501100,-1
847,1,STEP,764645850100,764650310600,4460500,-1
848,1,STEP,764650439400,764653707400,3268000,-1
849,1,STEP,764653803900,764657421400,3617500,-1
850,1,STEP,764657529900,764661354700,3824800,-1
851,1,STEP,764661470900,764664459400,2988500,-1
852,1,STEP,764664552700,764668575300,4022600,-1
853,1,STEP,764668704500,764672229600,3525100,-1
854,1,STEP,764672348600,764676715500,4366900,-1
855,1,STEP,764676818300,764680840800,4022500,-1
856,1,STEP,764680961100,764685276800,4315700,-1
857,1,STEP,764685452100,764689601500,4149400,-1
858,1,STEP,764689737700,764693190000,3452300,-1
859,1,STEP,764693284000,764696615100,3331100,-1
860,1,STEP,764696763400,764700634000,3870600,-1
861,1,STEP,764700733100,764704262900,3529800,-1
862,1,STEP,764704363500,764707586500,3223000,-1
863,1,STEP,764707681200,764710920700,3239500,-1
864,1,STEP,764711094800,764715287500,4192700,-1
865,1,STEP,764715367200,764719928900,4561700,-1
866,1,STEP,764720091500,764723775100,3683600,-1
867,1,STEP,764723877700,764726998800,3121100,-1
868,1,STEP,764727088300,764730741100,3652800,-1
869,1,STEP,764730846100,764734427300,3581200,-1
870,1,STEP,764734515500,764737745300,3229800,-1
871,1,STEP,764737850900,764741318700,3467800,-1
872,1,STEP,764741396600,764745080300,3683700,-1
873,1,STEP,764745204100,764748532100,3328000,-1
874,1,STEP,764748612100,764752711800,4099700,-1
875,1,STEP,764752802800,764756865500,4062700,-1
876,1,STEP,764756939300,764760386500,3447200,-1
877,1,STEP,764760478000,764763631300,3153300,-1
878,1,STEP,764763701500,764767275200,3573700,-1
879,1,STEP,764767366900,764770562400,3195500,-1
880,1,STEP,764770630700,764774164400,3533700,-1
881,1,STEP,764774249000,764778013600,3764600,-1
882,1,STEP,764778082300,764781633300,3551000,-1
883,1,STEP,764781717700,764784975500,3257800,-1
884,1,STEP,764785056800,764788920800,3864000,-1
885,1,STEP,764788999500,764792197300,3197800,-1
886,1,STEP,764792272600,764795335700,3063100,-1
887,1,STEP,764795430700,764798550800,3120100,-1
888,1,STEP,764798618400,764801682400,3064000,-1
889,1,STEP,764801760400,764804963900,3203500,-1
890,1,STEP,764805030900,764808406300,3375400,-1
891,1,STEP,764808484900,764811793100,3308200,-1
892,1,STEP,764811865600,764815147500,3281900,-1
893,1,STEP,764815224200,764818794000,3569800,-1
894,1,STEP,764818865800,764822275400,3409600,-1
895,1,STEP,764822353100,764825210500,2857400,-1
896,1,STEP,764825278000,764828455300,3177300,-1
897,1,STEP,764828538400,764831523000,2984600,-1
898,1,STEP,764831589200,764834612300,3023100,-1
899,1,STEP,764834682500,764837839200,3156700,-1
900,1,STEP,764837906800,764841520300,3613500,-1
901,1,STEP,764841664000,764845628800,3964800,-1
902,1,STEP,764845698400,764849232500,3534100,-1
903,1,STEP,764849313600,764852357300,3043700,-1
904,1,STEP,764852422900,764855550600,3127700,-1
905,1,STEP,764855623700,764859340500,3716800,-1
906,1,STEP,764859430600,764862516800,3086200,-1
907,1,STEP,764862586400,764866229600,3643200,-1
908,1,STEP,764866299100,764869663200,3364100,-1
909,1,STEP,764869736300,764873643100,3906800,-1
910,1,STEP,764873712400,764878065500,4353100,-1
911,1,STEP,764878149200,764881792200,3643000,-1
912,1,STEP,764881859700,764885234100,3374400,-1
913,1,STEP,764885319700,764888339100,3019400,-1
914,1,STEP,764888407400,764891876300,3468900,-1
915,1,STEP,764891965500,764894944700,2979200,-1
916,1,STEP,764895011100,764898640500,3629400,-1
917,1,STEP,764898717400,764902148700,3431300,-1
918,1,STEP,764902215800,764905636200,3420400,-1
919,1,STEP,764905712700,764909444700,3732000,-1
920,1,STEP,764909516800,764912968000,3451200,-1
921,1,STEP,764913061900,764916490100,3428200,-1
922,1,STEP,764916561500,764920266400,3704900,-1
923,1,STEP,764920345200,764923544200,3199000,-1
924,1,STEP,764923630300,764926887300,3257000,-1
925,1,STEP,764926973600,764930118300,3144700,-1
926,1,STEP,764930183800,764934637300,4453500,-1
927,1,STEP,764934715300,764937486400,2771100,-1
928,1,STEP,764937551000,764940773300,3222300,-1
929,1,STEP,764940858900,764943952900,3094000,-1
930,1,STEP,764944017600,764947785200,3767600,-1
931,1,STEP,764947862500,764951344300,3481800,-1
932,1,STEP,764951410700,764954543800,3133100,-1
933,1,STEP,764954618900,764958102400,3483500,-1
934,1,STEP,764958168500,764961515200,3346700,-1
935,1,STEP,764961601400,764964393100,2791700,-1
936,1,STEP,764964457200,764968248000,3790800,-1
937,1,STEP,764968343900,764971574200,3230300,-1
938,1,STEP,764971666200,764975001100,3334900,-1
939,1,STEP,764975095800,764977910600,2814800,-1
940,1,STEP,764977976200,764981516500,3540300,-1
941,1,STEP,764981616400,764984871100,3254700,-1
942,1,STEP,764984938400,764988605300,3666900,-1
943,1,STEP,764988701800,764992117200,3415400,-1
944,1,STEP,764992190500,764995785600,3595100,-1
945,1,STEP,764995866200,764999123900,3257700,-1
946,1,STEP,764999193600,765002730600,3537000,-1
947,1,STEP,765002813100,765006488200,3675100,-1
948,1,STEP,765006558500,765010104500,3546000,-1
949,1,STEP,765010196300,765013809700,3613400,-1
950,1,STEP,765013880100,765017399500,3519400,-1
951,1,STEP,765017479500,765020450800,2971300,-1
952,1,STEP,765020520000,765024243100,3723100,-1
953,1,STEP,765024332600,765028617800,4285200,-1
954,1,STEP,765028808200,765034013600,5205400,-1
955,1,STEP,765034115700,765038319200,4203500,-1
956,1,STEP,765038427600,765042908000,4480400,-1
957,1,STEP,765043060700,765047471100,4410400,-1
958,1,STEP,765047667500,765052596300,4928800,-1
959,1,STEP,765052727900,765056390600,3662700,-1
960,1,STEP,765056492200,765060252500,3760300,-1
961,1,STEP,765060358300,765065566600,5208300,-1
962,1,STEP,765065661800,765068902600,3240800,-1
963,1,STEP,765068984300,765073010700,4026400,-1
964,1,STEP,765073115600,765076961200,3845600,-1
965,1,STEP,765077057000,765081170800,4113800,-1
966,1,STEP,765081273500,765084906300,3632800,-1
967,1,STEP,765085016200,765089278300,4262100,-1
968,1,STEP,765089390900,765093636900,4246000,-1
969,1,STEP,765093818500,765097319500,3501000,-1
970,1,STEP,765097399000,765101539100,4140100,-1
971,1,STEP,765101669800,765106068100,4398300,-1
972,1,STEP,765106295900,765109709100,3413200,-1
973,1,STEP,765109808300,765114534600,4726300,-1
974,1,STEP,765114639700,765118033800,3394100,-1
975,1,STEP,765118105600,765122049000,3943400,-1
976,1,STEP,765122179500,765126276100,4096600,-1
977,1,STEP,765126431500,765130265600,3834100,-1
978,1,STEP,765130345800,765134209600,3863800,-1
979,1,STEP,765134322400,765137932800,3610400,-1
980,1,STEP,765138020100,765142816400,4796300,-1
981,1,STEP,765142937600,765146552200,3614600,-1
982,1,STEP,765146663000,765150621000,3958000,-1
983,1,STEP,765150720400,765155408900,4688500,-1
984,1,STEP,765155556900,765159517500,3960600,-1
985,1,STEP,765159604400,765163181200,3576800,-1
986,1,STEP,765163278700,765166679900,3401200,-1
987,1,STEP,765166760800,765170485300,3724500,-1
988,1,STEP,765170604700,765175236400,4631700,-1
989,1,STEP,765175465400,765179969000,4503600,-1
990,1,STEP,765180055000,765183938200,3883200,-1
991,1,STEP,765184144500,765187749500,3605000,-1
992,1,STEP,765187853800,765192369000,4515200,-1
993,1,STEP,765192480400,765196157700,3677300,-1
994,1,STEP,765196284300,765200183900,3899600,-1
995,1,STEP,765200281600,765204233200,3951600,-1
996,1,STEP,765204396200,765208486400,4090200,-1
997,1,STEP,765208592600,765212245800,3653200,-1
998,1,STEP,765212349400,765216421400,4072000,-1
999,1,STEP,765216583400,765223598900,7015500,-1
