Gen,Resource,Stamp,TimeStamp_Start,TimeStamp_End,Duration,Indiv_id
0,1,TransfertToDevice,520822289300,521286791000,464501700,-1
0,1,STEP,521426541200,521447405100,20863900,-1
1,1,STEP,521447457600,521467339000,19881400,-1
2,1,STEP,521467386300,521486961300,19575000,-1
3,1,STEP,521487029300,521503458600,16429300,-1
4,1,STEP,521503536900,521520295900,16759000,-1
5,1,STEP,521520341200,521537223300,16882100,-1
6,1,STEP,521537261700,521554174600,16912900,-1
7,1,STEP,521554213000,521570808200,16595200,-1
8,1,STEP,521570855800,521587644100,16788300,-1
9,1,STEP,521587698600,521604354200,16655600,-1
10,1,STEP,521604407500,521621377300,16969800,-1
11,1,STEP,521621420800,521638306900,16886100,-1
12,1,STEP,521638358300,521655016700,16658400,-1
13,1,STEP,521655068000,521671875000,16807000,-1
14,1,STEP,521671908800,521688503100,16594300,-1
15,1,STEP,521688545100,521705618200,17073100,-1
16,1,STEP,521705654700,521722510100,16855400,-1
17,1,STEP,521722553000,521739021100,16468100,-1
18,1,STEP,521739074400,521755493900,16419500,-1
19,1,STEP,521755535800,521772166200,16630400,-1
20,1,STEP,521772207300,521788550800,16343500,-1
21,1,STEP,521788602200,521805338100,16735900,-1
22,1,STEP,521805378700,521822213100,16834400,-1
23,1,STEP,521822255400,521839101500,16846100,-1
24,1,STEP,521839147500,521856233200,17085700,-1
25,1,STEP,521856275700,521872882600,16606900,-1
26,1,STEP,521872920600,521889571800,16651200,-1
27,1,STEP,521889622700,521906365600,16742900,-1
28,1,STEP,521906406300,521923099700,16693400,-1
29,1,STEP,521923135300,521940018000,16882700,-1
30,1,STEP,521940061800,521956817500,16755700,-1
31,1,STEP,521956857600,521973690200,16832600,-1
32,1,STEP,521973728100,521990996700,17268600,-1
33,1,STEP,521991036400,522008308400,17272000,-1
34,1,STEP,522008352600,522025868800,17516200,-1
35,1,STEP,522025907900,522043318500,17410600,-1
36,1,STEP,522043390100,522060560200,17170100,-1
37,1,STEP,522060594400,522078359700,17765300,-1
38,1,STEP,522078428100,522096410000,17981900,-1
39,1,STEP,522096458500,522114428900,17970400,-1
40,1,STEP,522114477600,522132183500,17705900,-1
41,1,STEP,522132227700,522150173200,17945500,-1
42,1,STEP,522150206400,522168364600,18158200,-1
43,1,STEP,522168401400,522186381700,17980300,-1
44,1,STEP,522186414900,522204387100,17972200,-1
45,1,STEP,522204435100,522222530900,18095800,-1
46,1,STEP,522222571900,522240912500,18340600,-1
47,1,STEP,522240955400,522259685400,18730000,-1
48,1,STEP,522259729000,522277898600,18169600,-1
49,1,STEP,522277945800,522296676800,18731000,-1
50,1,STEP,522296718000,522315976200,19258200,-1
51,1,STEP,522316024600,522335021900,18997300,-1
52,1,STEP,522335061000,522353897800,18836800,-1
53,1,STEP,522353947500,522372798800,18851300,-1
54,1,STEP,522372840900,522391524800,18683900,-1
55,1,STEP,522391569400,522410519100,18949700,-1
56,1,STEP,522410568400,522429191500,18623100,-1
57,1,STEP,522429234200,522448210700,18976500,-1
58,1,STEP,522448255600,522466780000,18524400,-1
59,1,STEP,522466819700,522485502300,18682600,-1
60,1,STEP,522485557600,522504576900,19019300,-1
61,1,STEP,522504617900,522523337400,18719500,-1
62,1,STEP,522523380700,522542212300,18831600,-1
63,1,STEP,522542254400,522561587700,19333300,-1
64,1,STEP,522561624200,522580310600,18686400,-1
65,1,STEP,522580344700,522599357000,19012300,-1
66,1,STEP,522599391400,522618195900,18804500,-1
67,1,STEP,522618246300,522637112000,18865700,-1
68,1,STEP,522637163600,522656379600,19216000,-1
69,1,STEP,522656425300,522675137500,18712200,-1
70,1,STEP,522675171600,522694076200,18904600,-1
71,1,STEP,522694129600,522712942500,18812900,-1
72,1,STEP,522712991000,522731941500,18950500,-1
73,1,STEP,522731985800,522751426800,19441000,-1
74,1,STEP,522751461800,522770324200,18862400,-1
75,1,STEP,522770363300,522789265200,18901900,-1
76,1,STEP,522789300300,522808156100,18855800,-1
77,1,STEP,522808213000,522827056700,18843700,-1
78,1,STEP,522827102600,522845980300,18877700,-1
79,1,STEP,522846020900,522864812000,18791100,-1
80,1,STEP,522864851200,522884558400,19707200,-1
81,1,STEP,522884599300,522903317700,18718400,-1
82,1,STEP,522903372400,522921733600,18361200,-1
83,1,STEP,522921789900,522940380500,18590600,-1
84,1,STEP,522940431400,522959280200,18848800,-1
85,1,STEP,522959330700,522978279800,18949100,-1
86,1,STEP,522978320000,522997207600,18887600,-1
87,1,STEP,522997249400,523016147900,18898500,-1
88,1,STEP,523016184200,523035248700,19064500,-1
89,1,STEP,523035288700,523054555800,19267100,-1
90,1,STEP,523054591100,523073430600,18839500,-1
91,1,STEP,523073464500,523092759200,19294700,-1
92,1,STEP,523092801800,523111665800,18864000,-1
93,1,STEP,523111704100,523130632700,18928600,-1
94,1,STEP,523130690100,523149794600,19104500,-1
95,1,STEP,523149829700,523168516800,18687100,-1
96,1,STEP,523168557000,523187731400,19174400,-1
97,1,STEP,523187774700,523206853100,19078400,-1
98,1,STEP,523206892100,523226022900,19130800,-1
99,1,STEP,523226062300,523245316600,19254300,-1
100,1,STEP,523245365500,523264552200,19186700,-1
101,1,STEP,523264596100,523283972100,19376000,-1
102,1,STEP,523284018700,523303060400,19041700,-1
103,1,STEP,523303100100,523322534500,19434400,-1
104,1,STEP,523322579600,523341755300,19175700,-1
105,1,STEP,523341826300,523361169100,19342800,-1
106,1,STEP,523361217000,523380372900,19155900,-1
107,1,STEP,523380419300,523400273000,19853700,-1
108,1,STEP,523400307900,523419485600,19177700,-1
109,1,STEP,523419532400,523438588800,19056400,-1
110,1,STEP,523438638800,523458067900,19429100,-1
111,1,STEP,523458122500,523477401600,19279100,-1
112,1,STEP,523477444300,523496939900,19495600,-1
113,1,STEP,523496975100,523516503400,19528300,-1
114,1,STEP,523516539100,523536885500,20346400,-1
115,1,STEP,523536926900,523556738000,19811100,-1
116,1,STEP,523556780900,523576138800,19357900,-1
117,1,STEP,523576173300,523595829100,19655800,-1
118,1,STEP,523595870800,523615551100,19680300,-1
119,1,STEP,523615598600,523635139000,19540400,-1
120,1,STEP,523635178700,523654804300,19625600,-1
121,1,STEP,523654850100,523674399000,19548900,-1
122,1,STEP,523674445900,523693601300,19155400,-1
123,1,STEP,523693657000,523713781200,20124200,-1
124,1,STEP,523713822800,523733774200,19951400,-1
125,1,STEP,523733835500,523754117700,20282200,-1
126,1,STEP,523754179100,523773911000,19731900,-1
127,1,STEP,523773961300,523793369800,19408500,-1
128,1,STEP,523793406900,523812835500,19428600,-1
129,1,STEP,523812870600,523832258300,19387700,-1
130,1,STEP,523832291500,523852143100,19851600,-1
131,1,STEP,523852188000,523871873200,19685200,-1
132,1,STEP,523871914300,523891576200,19661900,-1
133,1,STEP,523891611000,523911533800,19922800,-1
134,1,STEP,523911570700,523931072500,19501800,-1
135,1,STEP,523931116200,523950811900,19695700,-1
136,1,STEP,523950853500,523970591300,19737800,-1
137,1,STEP,523970639400,523990379100,19739700,-1
138,1,STEP,523990432400,524010426100,19993700,-1
139,1,STEP,524010460300,524029993500,19533200,-1
140,1,STEP,524030034500,524050015300,19980800,-1
141,1,STEP,524050048900,524069831600,19782700,-1
142,1,STEP,524069876900,524089626900,19750000,-1
143,1,STEP,524089660600,524109969900,20309300,-1
144,1,STEP,524110009700,524130071200,20061500,-1
145,1,STEP,524130119100,524150201400,20082300,-1
146,1,STEP,524150239300,524169855100,19615800,-1
147,1,STEP,524169897700,524189701000,19803300,-1
148,1,STEP,524189742300,524209390700,19648400,-1
149,1,STEP,524209428200,524229503000,20074800,-1
150,1,STEP,524229548800,524249553100,20004300,-1
151,1,STEP,524249589900,524269249000,19659100,-1
152,1,STEP,524269288600,524289558300,20269700,-1
153,1,STEP,524289603200,524309266700,19663500,-1
154,1,STEP,524309305000,524329332100,20027100,-1
155,1,STEP,524329374200,524348861900,19487700,-1
156,1,STEP,524348906200,524369077300,20171100,-1
157,1,STEP,524369119600,524389448200,20328600,-1
158,1,STEP,524389490900,524409705100,20214200,-1
159,1,STEP,524409739200,524429415800,19676600,-1
160,1,STEP,524429502400,524449747800,20245400,-1
161,1,STEP,524449786200,524469432600,19646400,-1
162,1,STEP,524469467500,524489096300,19628800,-1
163,1,STEP,524489143400,524509373200,20229800,-1
164,1,STEP,524509418800,524529392400,19973600,-1
165,1,STEP,524529427400,524548975500,19548100,-1
166,1,STEP,524549013100,524568904400,19891300,-1
167,1,STEP,524568964900,524588685400,19720500,-1
168,1,STEP,524588724700,524608513500,19788800,-1
169,1,STEP,524608547600,524628287000,19739400,-1
170,1,STEP,524628322000,524647917500,19595500,-1
171,1,STEP,524647952900,524668349900,20397000,-1
172,1,STEP,524668394900,524688411800,20016900,-1
173,1,STEP,524688456900,524708154600,19697700,-1
174,1,STEP,524708192700,524728210300,20017600,-1
175,1,STEP,524728299900,524748675900,20376000,-1
176,1,STEP,524748726900,524768360000,19633100,-1
177,1,STEP,524768409400,524787889800,19480400,-1
178,1,STEP,524787945400,524807239300,19293900,-1
179,1,STEP,524807297300,524826772900,19475600,-1
180,1,STEP,524826822700,524846583400,19760700,-1
181,1,STEP,524846631700,524867040400,20408700,-1
182,1,STEP,524867093700,524886397600,19303900,-1
183,1,STEP,524886445400,524906452100,20006700,-1
184,1,STEP,524906503600,524926476600,19973000,-1
185,1,STEP,524926526900,524946582700,20055800,-1
186,1,STEP,524946628000,524966919500,20291500,-1
187,1,STEP,524966970400,524986701600,19731200,-1
188,1,STEP,524986759500,525006424700,19665200,-1
189,1,STEP,525006493900,525025991200,19497300,-1
190,1,STEP,525026072200,525046370000,20297800,-1
191,1,STEP,525046416100,525066550000,20133900,-1
192,1,STEP,525066589600,525086979500,20389900,-1
193,1,STEP,525087018600,525106755200,19736600,-1
194,1,STEP,525106799200,525126487100,19687900,-1
195,1,STEP,525126537400,525146283700,19746300,-1
196,1,STEP,525146325500,525166513600,20188100,-1
197,1,STEP,525166549500,525186947400,20397900,-1
198,1,STEP,525186988900,525206919400,19930500,-1
199,1,STEP,525206960500,525227332400,20371900,-1
200,1,STEP,525227370100,525247270900,19900800,-1
201,1,STEP,525247317100,525267089700,19772600,-1
202,1,STEP,525267130000,525287086600,19956600,-1
203,1,STEP,525287127600,525307444400,20316800,-1
204,1,STEP,525307487300,525327862100,20374800,-1
205,1,STEP,525327900800,525348496900,20596100,-1
206,1,STEP,525348532900,525368881300,20348400,-1
207,1,STEP,525368928200,525389116800,20188600,-1
208,1,STEP,525389152500,525409161400,20008900,-1
209,1,STEP,525409207000,525429457600,20250600,-1
210,1,STEP,525429499400,525449815400,20316000,-1
211,1,STEP,525449857800,525469988300,20130500,-1
212,1,STEP,525470031100,525489712800,19681700,-1
213,1,STEP,525489746300,525509323500,19577200,-1
214,1,STEP,525509371200,525529298400,19927200,-1
215,1,STEP,525529337300,525548822500,19485200,-1
216,1,STEP,525548859100,525568419400,19560300,-1
217,1,STEP,525568467400,525588356000,19888600,-1
218,1,STEP,525588392500,525608357600,19965100,-1
219,1,STEP,525608397500,525628586000,20188500,-1
220,1,STEP,525628632600,525648387200,19754600,-1
221,1,STEP,525648425900,525669601200,21175300,-1
222,1,STEP,525669654400,525689487300,19832900,-1
223,1,STEP,525689530300,525709184000,19653700,-1
224,1,STEP,525709227200,525729029200,19802000,-1
225,1,STEP,525729074700,525749889300,20814600,-1
226,1,STEP,525749937900,525769696400,19758500,-1
227,1,STEP,525769743000,525789379300,19636300,-1
228,1,STEP,525789423200,525809826600,20403400,-1
229,1,STEP,525809877500,525830053800,20176300,-1
230,1,STEP,525830100300,525849858700,19758400,-1
231,1,STEP,525849907500,525869644300,19736800,-1
232,1,STEP,525869691500,525889595800,19904300,-1
233,1,STEP,525889652700,525909468700,19816000,-1
234,1,STEP,525909521900,525929983700,20461800,-1
235,1,STEP,525930031400,525949850300,19818900,-1
236,1,STEP,525949890500,525969608700,19718200,-1
237,1,STEP,525969695100,525989600300,19905200,-1
238,1,STEP,525989640700,526009916300,20275600,-1
239,1,STEP,526009960600,526029871300,19910700,-1
240,1,STEP,526029916000,526049921700,20005700,-1
241,1,STEP,526049963600,526070372800,20409200,-1
242,1,STEP,526070415000,526090349300,19934300,-1
243,1,STEP,526090396700,526110487800,20091100,-1
244,1,STEP,526110539900,526130379200,19839300,-1
245,1,STEP,526130432300,526151104400,20672100,-1
246,1,STEP,526151150700,526171416500,20265800,-1
247,1,STEP,526171461900,526191107100,19645200,-1
248,1,STEP,526191155800,526211013200,19857400,-1
249,1,STEP,526211056500,526231155800,20099300,-1
250,1,STEP,526231206500,526251621000,20414500,-1
251,1,STEP,526251674900,526272031800,20356900,-1
252,1,STEP,526272085700,526292420100,20334400,-1
253,1,STEP,526292528400,526314372300,21843900,-1
254,1,STEP,526314476700,526335512700,21036000,-1
255,1,STEP,526335569600,526357624400,22054800,-1
256,1,STEP,526357766200,526378312800,20546600,-1
257,1,STEP,526378356900,526398227500,19870600,-1
258,1,STEP,526398272200,526418351600,20079400,-1
259,1,STEP,526418405000,526438487200,20082200,-1
260,1,STEP,526438546000,526458126200,19580200,-1
261,1,STEP,526458168300,526478784600,20616300,-1
262,1,STEP,526478834100,526497877300,19043200,-1
263,1,STEP,526497926200,526517435900,19509700,-1
264,1,STEP,526517483700,526536992100,19508400,-1
265,1,STEP,526537043400,526556576900,19533500,-1
266,1,STEP,526556633500,526577300700,20667200,-1
267,1,STEP,526577357900,526596999800,19641900,-1
268,1,STEP,526597093700,526617311700,20218000,-1
269,1,STEP,526617366900,526636658800,19291900,-1
270,1,STEP,526636715200,526656290400,19575200,-1
271,1,STEP,526656342300,526676763500,20421200,-1
272,1,STEP,526676810200,526696615300,19805100,-1
273,1,STEP,526696658700,526717019900,20361200,-1
274,1,STEP,526717070900,526736865600,19794700,-1
275,1,STEP,526736939600,526757114500,20174900,-1
276,1,STEP,526757193300,526777447100,20253800,-1
277,1,STEP,526777515900,526797721000,20205100,-1
278,1,STEP,526797789200,526817940800,20151600,-1
279,1,STEP,526817992600,526837696500,19703900,-1
280,1,STEP,526837750300,526857606000,19855700,-1
281,1,STEP,526857658000,526877394700,19736700,-1
282,1,STEP,526877453300,526897230800,19777500,-1
283,1,STEP,526897288900,526917908400,20619500,-1
284,1,STEP,526917959900,526937800700,19840800,-1
285,1,STEP,526937847300,526957682900,19835600,-1
286,1,STEP,526957733300,526977711700,19978400,-1
287,1,STEP,526977765900,526997660000,19894100,-1
288,1,STEP,526997708100,527017143000,19434900,-1
289,1,STEP,527017189600,527036719600,19530000,-1
290,1,STEP,527036767800,527056178100,19410300,-1
291,1,STEP,527056226600,527075751300,19524700,-1
292,1,STEP,527075800900,527095420200,19619300,-1
293,1,STEP,527095468200,527115370300,19902100,-1
294,1,STEP,527115411900,527135471600,20059700,-1
295,1,STEP,527135515600,527155914600,20399000,-1
296,1,STEP,527155964100,527176212000,20247900,-1
297,1,STEP,527176251700,527196139100,19887400,-1
298,1,STEP,527196175600,527216030100,19854500,-1
299,1,STEP,527216065100,527236511000,20445900,-1
300,1,STEP,527236553700,527256279700,19726000,-1
301,1,STEP,527256328400,527276304600,19976200,-1
302,1,STEP,527276344900,527296235200,19890300,-1
303,1,STEP,527296273200,527316604800,20331600,-1
304,1,STEP,527316650600,527336604400,19953800,-1
305,1,STEP,527336655100,527356989600,20334500,-1
306,1,STEP,527357103700,527377298400,20194700,-1
307,1,STEP,527377341700,527397063800,19722100,-1
308,1,STEP,527397113300,527417376500,20263200,-1
309,1,STEP,527417417100,527437186900,19769800,-1
310,1,STEP,527437227000,527457605400,20378400,-1
311,1,STEP,527457687100,527477538800,19851700,-1
312,1,STEP,527477577200,527497735200,20158000,-1
313,1,STEP,527497773000,527518382400,20609400,-1
314,1,STEP,527518423100,527538817400,20394300,-1
315,1,STEP,527538851500,527559946100,21094600,-1
316,1,STEP,527559987500,527580011000,20023500,-1
317,1,STEP,527580053600,527600088300,20034700,-1
318,1,STEP,527600127700,527620472000,20344300,-1
319,1,STEP,527620517200,527640834800,20317600,-1
320,1,STEP,527640873700,527660470700,19597000,-1
321,1,STEP,527660508100,527680430100,19922000,-1
322,1,STEP,527680475100,527700316100,19841000,-1
323,1,STEP,527700372400,527720061900,19689500,-1
324,1,STEP,527720111200,527740523400,20412200,-1
325,1,STEP,527740562100,527760396400,19834300,-1
326,1,STEP,527760441800,527780374400,19932600,-1
327,1,STEP,527780430300,527800110500,19680200,-1
328,1,STEP,527800158200,527819859100,19700900,-1
329,1,STEP,527819903800,527839705900,19802100,-1
330,1,STEP,527839748200,527859400600,19652400,-1
331,1,STEP,527859451600,527879393600,19942000,-1
332,1,STEP,527879443400,527899311300,19867900,-1
333,1,STEP,527899364700,527918895100,19530400,-1
334,1,STEP,527918939600,527938992300,20052700,-1
335,1,STEP,527939052300,527959141600,20089300,-1
336,1,STEP,527959186900,527979452100,20265200,-1
337,1,STEP,527979499400,527999445300,19945900,-1
338,1,STEP,527999481000,528019841400,20360400,-1
339,1,STEP,528019889000,528040474800,20585800,-1
340,1,STEP,528040524100,528061246600,20722500,-1
341,1,STEP,528061306300,528081111700,19805400,-1
342,1,STEP,528081163100,528102485500,21322400,-1
343,1,STEP,528102530500,528122926300,20395800,-1
344,1,STEP,528122976600,528142638100,19661500,-1
345,1,STEP,528142680500,528162526600,19846100,-1
346,1,STEP,528162582100,528182770500,20188400,-1
347,1,STEP,528182833300,528203073800,20240500,-1
348,1,STEP,528203118700,528224107000,20988300,-1
349,1,STEP,528224220800,528244617100,20396300,-1
350,1,STEP,528244698200,528264405600,19707400,-1
351,1,STEP,528264458500,528284279300,19820800,-1
352,1,STEP,528284328800,528305114100,20785300,-1
353,1,STEP,528305165700,528325460100,20294400,-1
354,1,STEP,528325506900,528345198300,19691400,-1
355,1,STEP,528345246600,528364929100,19682500,-1
356,1,STEP,528364994300,528384934600,19940300,-1
357,1,STEP,528384997300,528404778800,19781500,-1
358,1,STEP,528404830200,528424490600,19660400,-1
359,1,STEP,528424552200,528445445100,20892900,-1
360,1,STEP,528445499300,528465032300,19533000,-1
361,1,STEP,528465090500,528484959800,19869300,-1
362,1,STEP,528485004000,528505115400,20111400,-1
363,1,STEP,528505161100,528525829100,20668000,-1
364,1,STEP,528525876000,528546187600,20311600,-1
365,1,STEP,528546242100,528566074000,19831900,-1
366,1,STEP,528566130200,528586612600,20482400,-1
367,1,STEP,528586695900,528606833000,20137100,-1
368,1,STEP,528606895900,528627234800,20338900,-1
369,1,STEP,528627282200,528647687600,20405400,-1
370,1,STEP,528647739900,528668021700,20281800,-1
371,1,STEP,528668076100,528688438300,20362200,-1
372,1,STEP,528688510200,528708972400,20462200,-1
373,1,STEP,528709044400,528728716000,19671600,-1
374,1,STEP,528728775300,528748397400,19622100,-1
375,1,STEP,528748444200,528769958700,21514500,-1
376,1,STEP,528770007500,528789958100,19950600,-1
377,1,STEP,528790005400,528809981800,19976400,-1
378,1,STEP,528810040800,528829906900,19866100,-1
379,1,STEP,528829990500,528850656900,20666400,-1
380,1,STEP,528850726000,528870542200,19816200,-1
381,1,STEP,528870601600,528890509900,19908300,-1
382,1,STEP,528890554100,528910830000,20275900,-1
383,1,STEP,528910898300,528930953000,20054700,-1
384,1,STEP,528931018200,528951002100,19983900,-1
385,1,STEP,528951054000,528970841800,19787800,-1
386,1,STEP,528970891900,528990928100,20036200,-1
387,1,STEP,528990979900,529010734600,19754700,-1
388,1,STEP,529010855600,529031071300,20215700,-1
389,1,STEP,529031195100,529051301300,20106200,-1
390,1,STEP,529051374300,529071407500,20033200,-1
391,1,STEP,529071458500,529091765500,20307000,-1
392,1,STEP,529091812700,529111869400,20056700,-1
393,1,STEP,529111937100,529131876900,19939800,-1
394,1,STEP,529131932500,529152604900,20672400,-1
395,1,STEP,529152659400,529172665100,20005700,-1
396,1,STEP,529172716500,529192632600,19916100,-1
397,1,STEP,529192675900,529212523900,19848000,-1
398,1,STEP,529212573400,529232742000,20168600,-1
399,1,STEP,529232784700,529253410500,20625800,-1
400,1,STEP,529253461800,529273530000,20068200,-1
401,1,STEP,529273596200,529295060400,21464200,-1
402,1,STEP,529295174000,529316807200,21633200,-1
403,1,STEP,529316944500,529337526200,20581700,-1
404,1,STEP,529337570700,529357606200,20035500,-1
405,1,STEP,529357690100,529377694400,20004300,-1
406,1,STEP,529377773700,529397737400,19963700,-1
407,1,STEP,529397784300,529417898700,20114400,-1
408,1,STEP,529417978700,529437832400,19853700,-1
409,1,STEP,529437887500,529457951500,20064000,-1
410,1,STEP,529458000900,529478162800,20161900,-1
411,1,STEP,529478239800,529498198600,19958800,-1
412,1,STEP,529498244700,529518338800,20094100,-1
413,1,STEP,529518384100,529538647700,20263600,-1
414,1,STEP,529538689500,529559331400,20641900,-1
415,1,STEP,529559379100,529579414100,20035000,-1
416,1,STEP,529579451800,529599524500,20072700,-1
417,1,STEP,529599587800,529619547700,19959900,-1
418,1,STEP,529619604100,529639343300,19739200,-1
419,1,STEP,529639398700,529659020900,19622200,-1
420,1,STEP,529659068800,529678704300,19635500,-1
421,1,STEP,529678740800,529698925500,20184700,-1
422,1,STEP,529698968900,529718828600,19859700,-1
423,1,STEP,529718875700,529738635600,19759900,-1
424,1,STEP,529738719500,529758974800,20255300,-1
425,1,STEP,529759038000,529779303200,20265200,-1
426,1,STEP,529779350800,529799290500,19939700,-1
427,1,STEP,529799349200,529819220900,19871700,-1
428,1,STEP,529819260600,529839288000,20027400,-1
429,1,STEP,529839337300,529860041600,20704300,-1
430,1,STEP,529860086300,529879731800,19645500,-1
431,1,STEP,529879773800,529899600200,19826400,-1
432,1,STEP,529899649200,529920183200,20534000,-1
433,1,STEP,529920296400,529942611000,22314600,-1
434,1,STEP,529942751000,529963625100,20874100,-1
435,1,STEP,529963679000,529983438800,19759800,-1
436,1,STEP,529983482200,530003691700,20209500,-1
437,1,STEP,530003736100,530023412500,19676400,-1
438,1,STEP,530023459400,530043004600,19545200,-1
439,1,STEP,530043054000,530062773600,19719600,-1
440,1,STEP,530062824600,530082734400,19909800,-1
441,1,STEP,530082774900,530103144600,20369700,-1
442,1,STEP,530103186400,530123449100,20262700,-1
443,1,STEP,530123503800,530143663200,20159400,-1
444,1,STEP,530143715300,530164125100,20409800,-1
445,1,STEP,530164178500,530183763000,19584500,-1
446,1,STEP,530183820600,530203593600,19773000,-1
447,1,STEP,530203640000,530224096700,20456700,-1
448,1,STEP,530224141600,530244591100,20449500,-1
449,1,STEP,530244645300,530264440100,19794800,-1
450,1,STEP,530264524200,530284321900,19797700,-1
451,1,STEP,530284376500,530304234900,19858400,-1
452,1,STEP,530304277400,530323955500,19678100,-1
453,1,STEP,530324001900,530343752000,19750100,-1
454,1,STEP,530343798900,530364351100,20552200,-1
455,1,STEP,530364399100,530384206300,19807200,-1
456,1,STEP,530384251800,530404785700,20533900,-1
457,1,STEP,530404841500,530424674800,19833300,-1
458,1,STEP,530424814500,530444891800,20077300,-1
459,1,STEP,530444945300,530465356300,20411000,-1
460,1,STEP,530465401500,530485202700,19801200,-1
461,1,STEP,530485249800,530505439100,20189300,-1
462,1,STEP,530505484600,530526085400,20600800,-1
463,1,STEP,530526187100,530547358700,21171600,-1
464,1,STEP,530547510400,530567304200,19793800,-1
465,1,STEP,530567351700,530587507300,20155600,-1
466,1,STEP,530587552400,530607426600,19874200,-1
467,1,STEP,530607478000,530627367900,19889900,-1
468,1,STEP,530627411100,530647388600,19977500,-1
469,1,STEP,530647431700,530667289500,19857800,-1
470,1,STEP,530667344000,530686966600,19622600,-1
471,1,STEP,530687038800,530707375800,20337000,-1
472,1,STEP,530707422900,530727463100,20040200,-1
473,1,STEP,530727511800,530747679100,20167300,-1
474,1,STEP,530747719800,530767677700,19957900,-1
475,1,STEP,530767724600,530787315400,19590800,-1
476,1,STEP,530787356600,530807131200,19774600,-1
477,1,STEP,530807177400,530826974300,19796900,-1
478,1,STEP,530827011500,530847958200,20946700,-1
479,1,STEP,530847999100,530868486700,20487600,-1
480,1,STEP,530868539100,530888197900,19658800,-1
481,1,STEP,530888240900,530908018100,19777200,-1
482,1,STEP,530908057200,530927734300,19677100,-1
483,1,STEP,530927775200,530947590900,19815700,-1
484,1,STEP,530947630900,530967386200,19755300,-1
485,1,STEP,530967431100,530987508000,20076900,-1
486,1,STEP,530987565400,531007455300,19889900,-1
487,1,STEP,531007532400,531028097200,20564800,-1
488,1,STEP,531028163700,531048218600,20054900,-1
489,1,STEP,531048267700,531068532000,20264300,-1
490,1,STEP,531068576200,531088077200,19501000,-1
491,1,STEP,531088126200,531108129300,20003100,-1
492,1,STEP,531108181100,531127879400,19698300,-1
493,1,STEP,531127941700,531147544300,19602600,-1
494,1,STEP,531147597300,531167400000,19802700,-1
495,1,STEP,531167450500,531187345800,19895300,-1
496,1,STEP,531187402800,531207764300,20361500,-1
497,1,STEP,531207962400,531228562800,20600400,-1
498,1,STEP,531228613300,531249044500,20431200,-1
499,1,STEP,531249096200,531269654100,20557900,-1
500,1,STEP,531269702200,531289200500,19498300,-1
501,1,STEP,531289249700,531309282700,20033000,-1
502,1,STEP,531309357400,531328847500,19490100,-1
503,1,STEP,531328895100,531348375500,19480400,-1
504,1,STEP,531348425500,531368050600,19625100,-1
505,1,STEP,531368104000,531387840100,19736100,-1
506,1,STEP,531387909500,531407421800,19512300,-1
507,1,STEP,531407475900,531427787900,20312000,-1
508,1,STEP,531427863800,531447720600,19856800,-1
509,1,STEP,531447790200,531467003700,19213500,-1
510,1,STEP,531467061600,531486599500,19537900,-1
511,1,STEP,531486657300,531506251500,19594200,-1
512,1,STEP,531506317100,531525955300,19638200,-1
513,1,STEP,531525993400,531545702000,19708600,-1
514,1,STEP,531545748900,531565755500,20006600,-1
515,1,STEP,531565804500,531585626500,19822000,-1
516,1,STEP,531585682000,531605508500,19826500,-1
517,1,STEP,531605551000,531625412500,19861500,-1
518,1,STEP,531625450500,531645294600,19844100,-1
519,1,STEP,531645337500,531665636600,20299100,-1
520,1,STEP,531665682200,531686095700,20413500,-1
521,1,STEP,531686136600,531706192200,20055600,-1
522,1,STEP,531706234500,531727336600,21102100,-1
523,1,STEP,531727377400,531747689800,20312400,-1
524,1,STEP,531747727100,531768772300,21045200,-1
525,1,STEP,531768813500,531789383100,20569600,-1
526,1,STEP,531789422800,531809826100,20403300,-1
527,1,STEP,531809868000,531830383000,20515000,-1
528,1,STEP,531830426800,531850328400,19901600,-1
529,1,STEP,531850365300,531870821400,20456100,-1
530,1,STEP,531870857400,531890753800,19896400,-1
531,1,STEP,531890798800,531910689500,19890700,-1
532,1,STEP,531910738100,531930999500,20261400,-1
533,1,STEP,531931064400,531951371300,20306900,-1
534,1,STEP,531951427000,531971445000,20018000,-1
535,1,STEP,531971490800,531991176000,19685200,-1
536,1,STEP,531991220000,532011118700,19898700,-1
537,1,STEP,532011160700,532031453200,20292500,-1
538,1,STEP,532031501300,532052003200,20501900,-1
539,1,STEP,532052062900,532072139000,20076100,-1
540,1,STEP,532072191700,532092167800,19976100,-1
541,1,STEP,532092218700,532112192600,19973900,-1
542,1,STEP,532112244800,532131401100,19156300,-1
543,1,STEP,532131466200,532151168300,19702100,-1
544,1,STEP,532151223400,532170481900,19258500,-1
545,1,STEP,532170533100,532190572700,20039600,-1
546,1,STEP,532190656100,532210705300,20049200,-1
547,1,STEP,532210764100,532231079600,20315500,-1
548,1,STEP,532231147100,532252196100,21049000,-1
549,1,STEP,532252241600,532272421800,20180200,-1
550,1,STEP,532272511100,532292681300,20170200,-1
551,1,STEP,532292736400,532313864500,21128100,-1
552,1,STEP,532313910100,532334367500,20457400,-1
553,1,STEP,532334412200,532355503600,21091400,-1
554,1,STEP,532355551000,532376624600,21073600,-1
555,1,STEP,532376672600,532396828100,20155500,-1
556,1,STEP,532396875800,532417314000,20438200,-1
557,1,STEP,532417360200,532437611700,20251500,-1
558,1,STEP,532437667900,532458293900,20626000,-1
559,1,STEP,532458375800,532478375100,19999300,-1
560,1,STEP,532478420400,532498934900,20514500,-1
561,1,STEP,532499003600,532519517400,20513800,-1
562,1,STEP,532519570200,532539841400,20271200,-1
563,1,STEP,532539890600,532560326600,20436000,-1
564,1,STEP,532560368300,532580838300,20470000,-1
565,1,STEP,532580883600,532601026500,20142900,-1
566,1,STEP,532601083000,532622112600,21029600,-1
567,1,STEP,532622170400,532643102600,20932200,-1
568,1,STEP,532643159100,532663775600,20616500,-1
569,1,STEP,532663830100,532684523900,20693800,-1
570,1,STEP,532684579600,532705153500,20573900,-1
571,1,STEP,532705205800,532726432000,21226200,-1
572,1,STEP,532726479900,532747627100,21147200,-1
573,1,STEP,532747670400,532768055900,20385500,-1
574,1,STEP,532768110200,532788713900,20603700,-1
575,1,STEP,532788771900,532809399400,20627500,-1
576,1,STEP,532809449600,532830049000,20599400,-1
577,1,STEP,532830099300,532850713400,20614100,-1
578,1,STEP,532850757700,532871407900,20650200,-1
579,1,STEP,532871452900,532892683800,21230900,-1
580,1,STEP,532892732400,532913889200,21156800,-1
581,1,STEP,532913942500,532934482800,20540300,-1
582,1,STEP,532934530200,532955070900,20540700,-1
583,1,STEP,532955119000,532975447000,20328000,-1
584,1,STEP,532975490500,532996169600,20679100,-1
585,1,STEP,532996221600,533016703800,20482200,-1
586,1,STEP,533016752400,533037225100,20472700,-1
587,1,STEP,533037272400,533057568000,20295600,-1
588,1,STEP,533057607000,533077905400,20298400,-1
589,1,STEP,533077957100,533098281800,20324700,-1
590,1,STEP,533098317700,533118453200,20135500,-1
591,1,STEP,533118552100,533138967200,20415100,-1
592,1,STEP,533139052500,533159604500,20552000,-1
593,1,STEP,533159673500,533180167400,20493900,-1
594,1,STEP,533180218700,533200891900,20673200,-1
595,1,STEP,533200953600,533222034600,21081000,-1
596,1,STEP,533222086100,533243058400,20972300,-1
597,1,STEP,533243105500,533263405700,20300200,-1
598,1,STEP,533263456600,533283804400,20347800,-1
599,1,STEP,533283856000,533304306800,20450800,-1
600,1,STEP,533304347000,533324089000,19742000,-1
601,1,STEP,533324132000,533344700600,20568600,-1
602,1,STEP,533344762500,533364725300,19962800,-1
603,1,STEP,533364771800,533385299800,20528000,-1
604,1,STEP,533385341700,533405278000,19936300,-1
605,1,STEP,533405331300,533425770900,20439600,-1
606,1,STEP,533425813800,533446588700,20774900,-1
607,1,STEP,533446637900,533467240600,20602700,-1
608,1,STEP,533467308500,533487676500,20368000,-1
609,1,STEP,533487792600,533509946700,22154100,-1
610,1,STEP,533510081100,533530826200,20745100,-1
611,1,STEP,533530877500,533551666400,20788900,-1
612,1,STEP,533551716400,533571852500,20136100,-1
613,1,STEP,533571898900,533592752400,20853500,-1
614,1,STEP,533592793300,533613965600,21172300,-1
615,1,STEP,533614013300,533634741200,20727900,-1
616,1,STEP,533634793200,533655381600,20588400,-1
617,1,STEP,533655429900,533676242700,20812800,-1
618,1,STEP,533676280200,533696534800,20254600,-1
619,1,STEP,533696596500,533717377400,20780900,-1
620,1,STEP,533717429200,533737017700,19588500,-1
621,1,STEP,533737086000,533757380400,20294400,-1
622,1,STEP,533757429700,533777750400,20320700,-1
623,1,STEP,533777817000,533798423400,20606400,-1
624,1,STEP,533798519400,533819415300,20895900,-1
625,1,STEP,533819465100,533839812200,20347100,-1
626,1,STEP,533839875400,533860861000,20985600,-1
627,1,STEP,533860927700,533880838100,19910400,-1
628,1,STEP,533880893100,533900879600,19986500,-1
629,1,STEP,533900924500,533921283900,20359400,-1
630,1,STEP,533921332400,533941187100,19854700,-1
631,1,STEP,533941235100,533961698000,20462900,-1
632,1,STEP,533961740700,533981978800,20238100,-1
633,1,STEP,533982018400,534002429700,20411300,-1
634,1,STEP,534002472400,534023760900,21288500,-1
635,1,STEP,534023808100,534043915400,20107300,-1
636,1,STEP,534043956500,534064498400,20541900,-1
637,1,STEP,534064542600,534084600800,20058200,-1
638,1,STEP,534084646400,534104492900,19846500,-1
639,1,STEP,534104549600,534124309800,19760200,-1
640,1,STEP,534124375400,534144123500,19748100,-1
641,1,STEP,534144161800,534164196500,20034700,-1
642,1,STEP,534164246600,534185220000,20973400,-1
643,1,STEP,534185266900,534205596000,20329100,-1
644,1,STEP,534205675300,534226357400,20682100,-1
645,1,STEP,534226413800,534246632700,20218900,-1
646,1,STEP,534246687800,534267127600,20439800,-1
647,1,STEP,534267178000,534288173200,20995200,-1
648,1,STEP,534288339000,534308688500,20349500,-1
649,1,STEP,534308734800,534329034900,20300100,-1
650,1,STEP,534329082400,534349592100,20509700,-1
651,1,STEP,534349637100,534369361000,19723900,-1
652,1,STEP,534369423000,534389762800,20339800,-1
653,1,STEP,534389825800,534409698300,19872500,-1
654,1,STEP,534409768100,534430149300,20381200,-1
655,1,STEP,534430198300,534450402300,20204000,-1
656,1,STEP,534450449300,534470940500,20491200,-1
657,1,STEP,534470988500,534491718100,20729600,-1
658,1,STEP,534491771900,534511567700,19795800,-1
659,1,STEP,534511613800,534532767700,21153900,-1
660,1,STEP,534532815400,534552809900,19994500,-1
661,1,STEP,534552857400,534573008800,20151400,-1
662,1,STEP,534573049600,534592911700,19862100,-1
663,1,STEP,534592950600,534614061900,21111300,-1
664,1,STEP,534614110000,534634174100,20064100,-1
665,1,STEP,534634213200,534654297500,20084300,-1
666,1,STEP,534654336700,534674206100,19869400,-1
667,1,STEP,534674246100,534693947900,19701800,-1
668,1,STEP,534693995100,534714264800,20269700,-1
669,1,STEP,534714322500,534734985500,20663000,-1
670,1,STEP,534735064700,534755963800,20899100,-1
671,1,STEP,534756022500,534776069200,20046700,-1
672,1,STEP,534776115400,534795828900,19713500,-1
673,1,STEP,534795873500,534816030800,20157300,-1
674,1,STEP,534816070800,534836628900,20558100,-1
675,1,STEP,534836680700,534856331200,19650500,-1
676,1,STEP,534856398600,534876354200,19955600,-1
677,1,STEP,534876404900,534897419100,21014200,-1
678,1,STEP,534897471300,534917615600,20144300,-1
679,1,STEP,534917666300,534937954900,20288600,-1
680,1,STEP,534938000700,534958335300,20334600,-1
681,1,STEP,534958417800,534978166300,19748500,-1
682,1,STEP,534978231600,534998384900,20153300,-1
683,1,STEP,534998443700,535018301500,19857800,-1
684,1,STEP,535018351400,535038880000,20528600,-1
685,1,STEP,535038933800,535059870600,20936800,-1
686,1,STEP,535059919300,535080195800,20276500,-1
687,1,STEP,535080244200,535099962600,19718400,-1
688,1,STEP,535100012600,535119951300,19938700,-1
689,1,STEP,535119995900,535140526100,20530200,-1
690,1,STEP,535140573000,535160823100,20250100,-1
691,1,STEP,535160891100,535182473000,21581900,-1
692,1,STEP,535182522800,535202776700,20253900,-1
693,1,STEP,535202816400,535222885400,20069000,-1
694,1,STEP,535222981700,535243471000,20489300,-1
695,1,STEP,535243525700,535264174600,20648900,-1
696,1,STEP,535264226300,535284645300,20419000,-1
697,1,STEP,535284700700,535306111100,21410400,-1
698,1,STEP,535306163300,535326513600,20350300,-1
699,1,STEP,535326620000,535346839100,20219100,-1
700,1,STEP,535346881000,535366842300,19961300,-1
701,1,STEP,535366890600,535386532600,19642000,-1
702,1,STEP,535386578100,535406869900,20291800,-1
703,1,STEP,535406912500,535427237700,20325200,-1
704,1,STEP,535427282500,535447198700,19916200,-1
705,1,STEP,535447239100,535467564000,20324900,-1
706,1,STEP,535467608900,535487704800,20095900,-1
707,1,STEP,535487774500,535507736700,19962200,-1
708,1,STEP,535507782400,535528585300,20802900,-1
709,1,STEP,535528627300,535548374400,19747100,-1
710,1,STEP,535548481500,535568887500,20406000,-1
711,1,STEP,535568957200,535588459400,19502200,-1
712,1,STEP,535588544000,535608551400,20007400,-1
713,1,STEP,535608609100,535629098800,20489700,-1
714,1,STEP,535629145800,535650357500,21211700,-1
715,1,STEP,535650394300,535670985700,20591400,-1
716,1,STEP,535671029500,535691236200,20206700,-1
717,1,STEP,535691282600,535711905500,20622900,-1
718,1,STEP,535711965000,535731968500,20003500,-1
719,1,STEP,535732007800,535752002500,19994700,-1
720,1,STEP,535752041700,535772582600,20540900,-1
721,1,STEP,535772628200,535793620600,20992400,-1
722,1,STEP,535793661400,535813616100,19954700,-1
723,1,STEP,535813660100,535833912300,20252200,-1
724,1,STEP,535833959200,535854295500,20336300,-1
725,1,STEP,535854333600,535875296000,20962400,-1
726,1,STEP,535875338400,535896017600,20679200,-1
727,1,STEP,535896064600,535916598200,20533600,-1
728,1,STEP,535916639800,535936876900,20237100,-1
729,1,STEP,535936910000,535957235800,20325800,-1
730,1,STEP,535957270700,535977186800,19916100,-1
731,1,STEP,535977236200,535997779300,20543100,-1
732,1,STEP,535997821900,536018371400,20549500,-1
733,1,STEP,536018412100,536038062700,19650600,-1
734,1,STEP,536038133700,536058623900,20490200,-1
735,1,STEP,536058665800,536078687500,20021700,-1
736,1,STEP,536078728200,536099352500,20624300,-1
737,1,STEP,536099404700,536119226000,19821300,-1
738,1,STEP,536119277600,536139243900,19966300,-1
739,1,STEP,536139305100,536159586700,20281600,-1
740,1,STEP,536159657100,536179535700,19878600,-1
741,1,STEP,536179593200,536199577700,19984500,-1
742,1,STEP,536199639400,536219474600,19835200,-1
743,1,STEP,536219525200,536239652500,20127300,-1
744,1,STEP,536239700700,536259864500,20163800,-1
745,1,STEP,536259913900,536280388500,20474600,-1
746,1,STEP,536280447000,536301320900,20873900,-1
747,1,STEP,536301404400,536321941200,20536800,-1
748,1,STEP,536321996500,536342313500,20317000,-1
749,1,STEP,536342375800,536362691000,20315200,-1
750,1,STEP,536362757300,536382791200,20033900,-1
751,1,STEP,536382853100,536403155700,20302600,-1
752,1,STEP,536403219500,536423544200,20324700,-1
753,1,STEP,536423615000,536443361600,19746600,-1
754,1,STEP,536443532500,536463505600,19973100,-1
755,1,STEP,536463554400,536484051900,20497500,-1
756,1,STEP,536484094300,536504711400,20617100,-1
757,1,STEP,536504759500,536525419900,20660400,-1
758,1,STEP,536525463400,536545607400,20144000,-1
759,1,STEP,536545648600,536566115900,20467300,-1
760,1,STEP,536566160300,536586599400,20439100,-1
761,1,STEP,536586646800,536606884300,20237500,-1
762,1,STEP,536606944000,536626943400,19999400,-1
763,1,STEP,536627015800,536647192300,20176500,-1
764,1,STEP,536647257200,536667765200,20508000,-1
765,1,STEP,536667843200,536688050700,20207500,-1
766,1,STEP,536688109100,536707945400,19836300,-1
767,1,STEP,536707994700,536728243300,20248600,-1
768,1,STEP,536728296000,536748006100,19710100,-1
769,1,STEP,536748053200,536768024300,19971100,-1
770,1,STEP,536768066400,536788525500,20459100,-1
771,1,STEP,536788568400,536808689500,20121100,-1
772,1,STEP,536808741100,536829248500,20507400,-1
773,1,STEP,536829295300,536849309600,20014300,-1
774,1,STEP,536849354500,536869247200,19892700,-1
775,1,STEP,536869313400,536889419800,20106400,-1
776,1,STEP,536889484200,536909282100,19797900,-1
777,1,STEP,536909329100,536928964800,19635700,-1
778,1,STEP,536929010500,536948922400,19911900,-1
779,1,STEP,536948969600,536968897800,19928200,-1
780,1,STEP,536968944100,536989262200,20318100,-1
781,1,STEP,536989319800,537009172200,19852400,-1
782,1,STEP,537009214800,537029189400,19974600,-1
783,1,STEP,537029286300,537049666400,20380100,-1
784,1,STEP,537049746000,537069534900,19788900,-1
785,1,STEP,537069588900,537089461800,19872900,-1
786,1,STEP,537089508100,537109574700,20066600,-1
787,1,STEP,537109625800,537129928500,20302700,-1
788,1,STEP,537129976400,537150568200,20591800,-1
789,1,STEP,537150615300,537170908500,20293200,-1
790,1,STEP,537170951300,537190889500,19938200,-1
791,1,STEP,537190934200,537211336000,20401800,-1
792,1,STEP,537211383500,537231328400,19944900,-1
793,1,STEP,537231398000,537251222700,19824700,-1
794,1,STEP,537251274800,537271060900,19786100,-1
795,1,STEP,537271106300,537291105000,19998700,-1
796,1,STEP,537291157000,537310893700,19736700,-1
797,1,STEP,537310955500,537331705700,20750200,-1
798,1,STEP,537331752800,537352178800,20426000,-1
799,1,STEP,537352227500,537372091200,19863700,-1
800,1,STEP,537372139200,537392110300,19971100,-1
801,1,STEP,537392162700,537412195300,20032600,-1
802,1,STEP,537412258100,537432241400,19983300,-1
803,1,STEP,537432291300,537453245000,20953700,-1
804,1,STEP,537453287700,537473281100,19993400,-1
805,1,STEP,537473322100,537493111900,19789800,-1
806,1,STEP,537493160300,537514695700,21535400,-1
807,1,STEP,537514849400,537536784400,21935000,-1
808,1,STEP,537536919100,537558612000,21692900,-1
809,1,STEP,537558729900,537580004200,21274300,-1
810,1,STEP,537580050500,537600248900,20198400,-1
811,1,STEP,537600291200,537620003100,19711900,-1
812,1,STEP,537620053100,537639991200,19938100,-1
813,1,STEP,537640047300,537660348700,20301400,-1
814,1,STEP,537660410500,537680473400,20062900,-1
815,1,STEP,537680519000,537700884400,20365400,-1
816,1,STEP,537700926700,537721242700,20316000,-1
817,1,STEP,537721290200,537741710900,20420700,-1
818,1,STEP,537741753200,537762925400,21172200,-1
819,1,STEP,537762971300,537782846400,19875100,-1
820,1,STEP,537782890900,537802863800,19972900,-1
821,1,STEP,537802910300,537822819600,19909300,-1
822,1,STEP,537822864600,537843261100,20396500,-1
823,1,STEP,537843310100,537863662700,20352600,-1
824,1,STEP,537863707200,537883883100,20175900,-1
825,1,STEP,537883926000,537904411400,20485400,-1
826,1,STEP,537904452500,537924218200,19765700,-1
827,1,STEP,537924271100,537944646000,20374900,-1
828,1,STEP,537944705500,537964783300,20077800,-1
829,1,STEP,537964831500,537984956400,20124900,-1
830,1,STEP,537985012900,538005011200,19998300,-1
831,1,STEP,538005051900,538024972800,19920900,-1
832,1,STEP,538025016800,538045301700,20284900,-1
833,1,STEP,538045339900,538065483500,20143600,-1
834,1,STEP,538065533200,538085694900,20161700,-1
835,1,STEP,538085739800,538105876600,20136800,-1
836,1,STEP,538105928500,538126516100,20587600,-1
837,1,STEP,538126568400,538146974400,20406000,-1
838,1,STEP,538147029700,538166979000,19949300,-1
839,1,STEP,538167049500,538187054500,20005000,-1
840,1,STEP,538187105900,538207462900,20357000,-1
841,1,STEP,538207510700,538227959800,20449100,-1
842,1,STEP,538228007300,538247846500,19839200,-1
843,1,STEP,538247893000,538267777000,19884000,-1
844,1,STEP,538267820700,538288239000,20418300,-1
845,1,STEP,538288282800,538308454300,20171500,-1
846,1,STEP,538308508900,538328510700,20001800,-1
847,1,STEP,538328556100,538348338900,19782800,-1
848,1,STEP,538348383300,538368222200,19838900,-1
849,1,STEP,538368300600,538388018700,19718100,-1
850,1,STEP,538388073700,538407845400,19771700,-1
851,1,STEP,538407892900,538427922000,20029100,-1
852,1,STEP,538427967500,538449000200,21032700,-1
853,1,STEP,538449098700,538469736900,20638200,-1
854,1,STEP,538469787300,538489757000,19969700,-1
855,1,STEP,538489806800,538509748700,19941900,-1
856,1,STEP,538509797400,538529237500,19440100,-1
857,1,STEP,538529291900,538549552800,20260900,-1
858,1,STEP,538549604400,538569980300,20375900,-1
859,1,STEP,538570052100,538590111500,20059400,-1
860,1,STEP,538590175100,538610146800,19971700,-1
861,1,STEP,538610191500,538630072100,19880600,-1
862,1,STEP,538630111100,538650146300,20035200,-1
863,1,STEP,538650187700,538670471100,20283400,-1
864,1,STEP,538670536300,538690367500,19831200,-1
865,1,STEP,538690409900,538710325200,19915300,-1
866,1,STEP,538710366800,538730974700,20607900,-1
867,1,STEP,538731019400,538751021300,20001900,-1
868,1,STEP,538751085300,538771605700,20520400,-1
869,1,STEP,538771730500,538793784900,22054400,-1
870,1,STEP,538793935000,538814613100,20678100,-1
871,1,STEP,538814658600,538834923300,20264700,-1
872,1,STEP,538834963600,538856093900,21130300,-1
873,1,STEP,538856132700,538876780300,20647600,-1
874,1,STEP,538876825500,538897470600,20645100,-1
875,1,STEP,538897518400,538917465300,19946900,-1
876,1,STEP,538917504500,538937520800,20016300,-1
877,1,STEP,538937571400,538957615300,20043900,-1
878,1,STEP,538957657300,538978177500,20520200,-1
879,1,STEP,538978228300,538998170500,19942200,-1
880,1,STEP,538998223600,539018737400,20513800,-1
881,1,STEP,539018781300,539039013700,20232400,-1
882,1,STEP,539039052300,539059339400,20287100,-1
883,1,STEP,539059384100,539080468000,21083900,-1
884,1,STEP,539080519000,539100897900,20378900,-1
885,1,STEP,539100944000,539121376900,20432900,-1
886,1,STEP,539121425100,539141976800,20551700,-1
887,1,STEP,539142025400,539162453100,20427700,-1
888,1,STEP,539162503500,539182345200,19841700,-1
889,1,STEP,539182390500,539202370600,19980100,-1
890,1,STEP,539202419900,539222663000,20243100,-1
891,1,STEP,539222705100,539243430000,20724900,-1
892,1,STEP,539243484800,539263418900,19934100,-1
893,1,STEP,539263463200,539283918600,20455400,-1
894,1,STEP,539283970300,539304600900,20630600,-1
895,1,STEP,539304647200,539325210200,20563000,-1
896,1,STEP,539325253700,539346005400,20751700,-1
897,1,STEP,539346050300,539366145000,20094700,-1
898,1,STEP,539366182800,539386214300,20031500,-1
899,1,STEP,539386259000,539406310400,20051400,-1
900,1,STEP,539406361300,539426374000,20012700,-1
901,1,STEP,539426419400,539446381400,19962000,-1
902,1,STEP,539446431400,539466593300,20161900,-1
903,1,STEP,539466634500,539486439800,19805300,-1
904,1,STEP,539486498100,539506336700,19838600,-1
905,1,STEP,539506381400,539527277100,20895700,-1
906,1,STEP,539527324700,539548163800,20839100,-1
907,1,STEP,539548210700,539567843700,19633000,-1
908,1,STEP,539567899200,539588265300,20366100,-1
909,1,STEP,539588304800,539608465300,20160500,-1
910,1,STEP,539608516500,539628373900,19857400,-1
911,1,STEP,539628414200,539648432800,20018600,-1
912,1,STEP,539648476100,539668481500,20005400,-1
913,1,STEP,539668543700,539688350900,19807200,-1
914,1,STEP,539688395600,539709064400,20668800,-1
915,1,STEP,539709129900,539728957300,19827400,-1
916,1,STEP,539729010000,539748930900,19920900,-1
917,1,STEP,539748977800,539769221100,20243300,-1
918,1,STEP,539769271400,539789556000,20284600,-1
919,1,STEP,539789619000,539809535400,19916400,-1
920,1,STEP,539809597800,539829739200,20141400,-1
921,1,STEP,539829791300,539849736500,19945200,-1
922,1,STEP,539849785400,539869998600,20213200,-1
923,1,STEP,539870042300,539890165000,20122700,-1
924,1,STEP,539890214400,539912304800,22090400,-1
925,1,STEP,539912382100,539932645100,20263000,-1
926,1,STEP,539932712400,539952492800,19780400,-1
927,1,STEP,539952537500,539972705500,20168000,-1
928,1,STEP,539972748300,539992761500,20013200,-1
929,1,STEP,539992805500,540013500300,20694800,-1
930,1,STEP,540013552700,540034183300,20630600,-1
931,1,STEP,540034224600,540053887300,19662700,-1
932,1,STEP,540053928900,540073707000,19778100,-1
933,1,STEP,540073750200,540093467400,19717200,-1
934,1,STEP,540093503800,540113332400,19828600,-1
935,1,STEP,540113392200,540133355900,19963700,-1
936,1,STEP,540133407300,540153842600,20435300,-1
937,1,STEP,540153907800,540174188200,20280400,-1
938,1,STEP,540174250800,540194430400,20179600,-1
939,1,STEP,540194477000,540214294800,19817800,-1
940,1,STEP,540214353100,540234525300,20172200,-1
941,1,STEP,540234571800,540255640600,21068800,-1
942,1,STEP,540255701700,540275594000,19892300,-1
943,1,STEP,540275645100,540296537300,20892200,-1
944,1,STEP,540296584300,540316802700,20218400,-1
945,1,STEP,540316849000,540338061900,21212900,-1
946,1,STEP,540338100500,540358639000,20538500,-1
947,1,STEP,540358688100,540379906200,21218100,-1
948,1,STEP,540379947900,540400364300,20416400,-1
949,1,STEP,540400405700,540420947200,20541500,-1
950,1,STEP,540421009000,540440974100,19965100,-1
951,1,STEP,540441048300,540461601100,20552800,-1
952,1,STEP,540461647400,540481716500,20069100,-1
953,1,STEP,540481776200,540502245600,20469400,-1
954,1,STEP,540502303500,540522176400,19872900,-1
955,1,STEP,540522246500,540542265300,20018800,-1
956,1,STEP,540542350400,540562998500,20648100,-1
957,1,STEP,540563077800,540583826300,20748500,-1
958,1,STEP,540583891300,540604386700,20495400,-1
959,1,STEP,540604439200,540624769500,20330300,-1
960,1,STEP,540624814300,540645286700,20472400,-1
961,1,STEP,540645338300,540665842300,20504000,-1
962,1,STEP,540665895000,540685975800,20080800,-1
963,1,STEP,540686031300,540707197900,21166600,-1
964,1,STEP,540707252900,540727850800,20597900,-1
965,1,STEP,540727895600,540748542500,20646900,-1
966,1,STEP,540748586800,540768780100,20193300,-1
967,1,STEP,540768831100,540789361800,20530700,-1
968,1,STEP,540789404700,540809876100,20471400,-1
969,1,STEP,540809944800,540830176500,20231700,-1
970,1,STEP,540830224200,540850692100,20467900,-1
971,1,STEP,540850736800,540871033000,20296200,-1
972,1,STEP,540871081000,540891122800,20041800,-1
973,1,STEP,540891169900,540911861700,20691800,-1
974,1,STEP,540911914500,540931723100,19808600,-1
975,1,STEP,540931779600,540951517300,19737700,-1
976,1,STEP,540951571400,540971979500,20408100,-1
977,1,STEP,540972031700,540991715600,19683900,-1
978,1,STEP,540991764600,541012680500,20915900,-1
979,1,STEP,541012725700,541032799600,20073900,-1
980,1,STEP,541032845300,541052991800,20146500,-1
981,1,STEP,541053025900,541073603200,20577300,-1
982,1,STEP,541073645400,541093840800,20195400,-1
983,1,STEP,541093893900,541114078700,20184800,-1
984,1,STEP,541114122600,541134486500,20363900,-1
985,1,STEP,541134547200,541154339400,19792200,-1
986,1,STEP,541154410700,541174339200,19928500,-1
987,1,STEP,541174401500,541194551500,20150000,-1
988,1,STEP,541194599300,541215103200,20503900,-1
989,1,STEP,541215150400,541235174400,20024000,-1
990,1,STEP,541235215000,541255222900,20007900,-1
991,1,STEP,541255267800,541275241400,19973600,-1
992,1,STEP,541275279400,541295613200,20333800,-1
993,1,STEP,541295659200,541315653500,19994300,-1
994,1,STEP,541315696800,541336613400,20916600,-1
995,1,STEP,541336658000,541356560700,19902700,-1
996,1,STEP,541356611900,541377216600,20604700,-1
997,1,STEP,541377261600,541397770400,20508800,-1
998,1,STEP,541397814600,541417902200,20087600,-1
999,1,STEP,541418069000,541437945000,19876000,-1
