Gen,Resource,Stamp,TimeStamp_Start,TimeStamp_End,Duration,Indiv_id
0,1,TransfertToDevice,907457546000,907722404400,264858400,-1
0,1,STEP,907855620500,907868572800,12952300,-1
1,1,STEP,907868636700,907881610800,12974100,-1
2,1,STEP,907881680100,907894853900,13173800,-1
3,1,STEP,907894916500,907908118100,13201600,-1
4,1,STEP,907908190000,907921396100,13206100,-1
5,1,STEP,907921453800,907934958600,13504800,-1
6,1,STEP,907935047300,907949073000,14025700,-1
7,1,STEP,907949129600,907962798400,13668800,-1
8,1,STEP,907962861700,907976394200,13532500,-1
9,1,STEP,907976461200,907989857700,13396500,-1
10,1,STEP,907989933500,908003224200,13290700,-1
11,1,STEP,908003299900,908016684500,13384600,-1
12,1,STEP,908016756700,908030118800,13362100,-1
13,1,STEP,908030185500,908043351000,13165500,-1
14,1,STEP,908043399800,908056630700,13230900,-1
15,1,STEP,908056684900,908069867500,13182600,-1
16,1,STEP,908069935700,908083239500,13303800,-1
17,1,STEP,908083297000,908096822300,13525300,-1
18,1,STEP,908096875000,908110206500,13331500,-1
19,1,STEP,908110277200,908124042400,13765200,-1
20,1,STEP,908124101300,908137998100,13896800,-1
21,1,STEP,908138065500,908151831500,13766000,-1
22,1,STEP,908151882900,908165653600,13770700,-1
23,1,STEP,908165713900,908180066800,14352900,-1
24,1,STEP,908180175200,908194319600,14144400,-1
25,1,STEP,908194393700,908208140300,13746600,-1
26,1,STEP,908208214900,908222474900,14260000,-1
27,1,STEP,908222538100,908236698400,14160300,-1
28,1,STEP,908236782300,908251026000,14243700,-1
29,1,STEP,908251092200,908264951300,13859100,-1
30,1,STEP,908265020200,908279101600,14081400,-1
31,1,STEP,908279157200,908293146800,13989600,-1
32,1,STEP,908293206900,908307413900,14207000,-1
33,1,STEP,908307472400,908321630700,14158300,-1
34,1,STEP,908321689300,908335901500,14212200,-1
35,1,STEP,908335961500,908349946000,13984500,-1
36,1,STEP,908350015800,908364716700,14700900,-1
37,1,STEP,908364781600,908379032600,14251000,-1
38,1,STEP,908379099500,908393354300,14254800,-1
39,1,STEP,908393444400,908407508200,14063800,-1
40,1,STEP,908407588000,908422259500,14671500,-1
41,1,STEP,908422337900,908436726100,14388200,-1
42,1,STEP,908436801900,908451032700,14230800,-1
43,1,STEP,908451092100,908465624500,14532400,-1
44,1,STEP,908465685100,908480308100,14623000,-1
45,1,STEP,908480378400,908494990100,14611700,-1
46,1,STEP,908495050900,908509292800,14241900,-1
47,1,STEP,908509369000,908524007600,14638600,-1
48,1,STEP,908524089000,908539306800,15217800,-1
49,1,STEP,908539371800,908554357500,14985700,-1
50,1,STEP,908554460800,908569514600,15053800,-1
51,1,STEP,908569587300,908584868100,15280800,-1
52,1,STEP,908584945900,908600417200,15471300,-1
53,1,STEP,908600520300,908615941900,15421600,-1
54,1,STEP,908616029100,908631605500,15576400,-1
55,1,STEP,908631689000,908647413000,15724000,-1
56,1,STEP,908647514000,908663589500,16075500,-1
57,1,STEP,908663670200,908679777400,16107200,-1
58,1,STEP,908679854900,908695798600,15943700,-1
59,1,STEP,908695905700,908712221700,16316000,-1
60,1,STEP,908712299000,908727613100,15314100,-1
61,1,STEP,908727684800,908743560700,15875900,-1
62,1,STEP,908743626700,908759607500,15980800,-1
63,1,STEP,908759670300,908775477900,15807600,-1
64,1,STEP,908775555200,908791823100,16267900,-1
65,1,STEP,908791882400,908808432600,16550200,-1
66,1,STEP,908808511500,908824936900,16425400,-1
67,1,STEP,908825022200,908841734200,16712000,-1
68,1,STEP,908841795500,908857965900,16170400,-1
69,1,STEP,908858057800,908874207400,16149600,-1
70,1,STEP,908874270900,908891014700,16743800,-1
71,1,STEP,908891076700,908907454000,16377300,-1
72,1,STEP,908907536600,908924019300,16482700,-1
73,1,STEP,908924072800,908940248200,16175400,-1
74,1,STEP,908940293900,908957012300,16718400,-1
75,1,STEP,908957064400,908973128600,16064200,-1
76,1,STEP,908973192400,908989487400,16295000,-1
77,1,STEP,908989543100,909005819400,16276300,-1
78,1,STEP,909005902500,909022996900,17094400,-1
79,1,STEP,909023076900,909039485500,16408600,-1
80,1,STEP,909039571100,909055837200,16266100,-1
81,1,STEP,909055904300,909072264600,16360300,-1
82,1,STEP,909072327100,909088821800,16494700,-1
83,1,STEP,909088902100,909105329700,16427600,-1
84,1,STEP,909105416700,909121972200,16555500,-1
85,1,STEP,909122061700,909138406600,16344900,-1
86,1,STEP,909138471200,909154896500,16425300,-1
87,1,STEP,909154951300,909171828800,16877500,-1
88,1,STEP,909171900900,909188240600,16339700,-1
89,1,STEP,909188317600,909204658300,16340700,-1
90,1,STEP,909204727400,909221487900,16760500,-1
91,1,STEP,909221547500,909237612300,16064800,-1
92,1,STEP,909237669500,909253696200,16026700,-1
93,1,STEP,909253796500,909270078000,16281500,-1
94,1,STEP,909270145300,909286189000,16043700,-1
95,1,STEP,909286256000,909303259300,17003300,-1
96,1,STEP,909303324500,909319710900,16386400,-1
97,1,STEP,909319778300,909335964900,16186600,-1
98,1,STEP,909336035000,909352971100,16936100,-1
99,1,STEP,909353038600,909369408200,16369600,-1
100,1,STEP,909369484100,909385978700,16494600,-1
101,1,STEP,909386048300,909402551600,16503300,-1
102,1,STEP,909402630800,909419607600,16976800,-1
103,1,STEP,909419685800,909436122700,16436900,-1
104,1,STEP,909436207200,909453523400,17316200,-1
105,1,STEP,909453608800,909470557400,16948600,-1
106,1,STEP,909470618400,909487049700,16431300,-1
107,1,STEP,909487122800,909503308000,16185200,-1
108,1,STEP,909503390600,909519811400,16420800,-1
109,1,STEP,909519868700,909536317400,16448700,-1
110,1,STEP,909536368000,909553346800,16978800,-1
111,1,STEP,909553408800,909569821000,16412200,-1
112,1,STEP,909569870400,909586272100,16401700,-1
113,1,STEP,909586341100,909602471400,16130300,-1
114,1,STEP,909602529600,909618556800,16027200,-1
115,1,STEP,909618633900,909635019400,16385500,-1
116,1,STEP,909635091000,909651378200,16287200,-1
117,1,STEP,909651440800,909668330900,16890100,-1
118,1,STEP,909668393000,909685463900,17070900,-1
119,1,STEP,909685527100,909702317800,16790700,-1
120,1,STEP,909702378700,909719100300,16721600,-1
121,1,STEP,909719155300,909735930600,16775300,-1
122,1,STEP,909736002100,909752017200,16015100,-1
123,1,STEP,909752077600,909768103000,16025400,-1
124,1,STEP,909768160500,909784972600,16812100,-1
125,1,STEP,909785039100,909801395800,16356700,-1
126,1,STEP,909801461100,909818729000,17267900,-1
127,1,STEP,909818792000,909835216100,16424100,-1
128,1,STEP,909835284100,909851959900,16675800,-1
129,1,STEP,909852032300,909868319200,16286900,-1
130,1,STEP,909868387200,909884659500,16272300,-1
131,1,STEP,909884724700,909901132900,16408200,-1
132,1,STEP,909901201900,909918178000,16976100,-1
133,1,STEP,909918249400,909935295300,17045900,-1
134,1,STEP,909935366800,909951793900,16427100,-1
135,1,STEP,909951863300,909968745000,16881700,-1
136,1,STEP,909968799300,909985524200,16724900,-1
137,1,STEP,909985578800,910002594000,17015200,-1
138,1,STEP,910002647800,910019603700,16955900,-1
139,1,STEP,910019658200,910035938700,16280500,-1
140,1,STEP,910036001700,910052316700,16315000,-1
141,1,STEP,910052402700,910071698000,19295300,-1
142,1,STEP,910071785000,910091562700,19777700,-1
143,1,STEP,910091646300,910108650000,17003700,-1
144,1,STEP,910108731600,910124854200,16122600,-1
145,1,STEP,910124923700,910142087600,17163900,-1
146,1,STEP,910142168800,910158599800,16431000,-1
147,1,STEP,910158670900,910174432100,15761200,-1
148,1,STEP,910174520200,910190864100,16343900,-1
149,1,STEP,910190932100,910207362300,16430200,-1
150,1,STEP,910207423200,910223927500,16504300,-1
151,1,STEP,910223986100,910241506200,17520100,-1
152,1,STEP,910241581400,910258768400,17187000,-1
153,1,STEP,910258840400,910275959300,17118900,-1
154,1,STEP,910276031600,910292534300,16502700,-1
155,1,STEP,910292595000,910309703200,17108200,-1
156,1,STEP,910309769400,910327388500,17619100,-1
157,1,STEP,910327452000,910344771700,17319700,-1
158,1,STEP,910344856100,910363188000,18331900,-1
159,1,STEP,910363268700,910382043200,18774500,-1
160,1,STEP,910382116700,910400571600,18454900,-1
161,1,STEP,910400645000,910418868700,18223700,-1
162,1,STEP,910418948400,910437136500,18188100,-1
163,1,STEP,910437196400,910455455600,18259200,-1
164,1,STEP,910455523700,910473999900,18476200,-1
165,1,STEP,910474056700,910492234500,18177800,-1
166,1,STEP,910492293500,910510306200,18012700,-1
167,1,STEP,910510370600,910528259400,17888800,-1
168,1,STEP,910528319200,910546650500,18331300,-1
169,1,STEP,910546703000,910564982700,18279700,-1
170,1,STEP,910565028800,910583377600,18348800,-1
171,1,STEP,910583429000,910601336600,17907600,-1
172,1,STEP,910601397300,910619888600,18491300,-1
173,1,STEP,910619949400,910638380200,18430800,-1
174,1,STEP,910638443800,910656732500,18288700,-1
175,1,STEP,910656814900,910674793400,17978500,-1
176,1,STEP,910674858600,910693157400,18298800,-1
177,1,STEP,910693288700,910712686000,19397300,-1
178,1,STEP,910712787100,910730943400,18156300,-1
179,1,STEP,910731023500,910749388000,18364500,-1
180,1,STEP,910749491200,910768746400,19255200,-1
181,1,STEP,910768837100,910787989300,19152200,-1
182,1,STEP,910788105700,910806751200,18645500,-1
183,1,STEP,910806814200,910825236500,18422300,-1
184,1,STEP,910825385000,910844620100,19235100,-1
185,1,STEP,910844708400,910863399200,18690800,-1
186,1,STEP,910863483200,910881911000,18427800,-1
187,1,STEP,910882081400,910900357300,18275900,-1
188,1,STEP,910900463000,910918185400,17722400,-1
189,1,STEP,910918249300,910937036200,18786900,-1
190,1,STEP,910937179600,910956287100,19107500,-1
191,1,STEP,910956389600,910974905900,18516300,-1
192,1,STEP,910974971200,910993653300,18682100,-1
193,1,STEP,910993732300,911012913000,19180700,-1
194,1,STEP,911012981500,911031892100,18910600,-1
195,1,STEP,911032001600,911050328000,18326400,-1
196,1,STEP,911050394500,911069951000,19556500,-1
197,1,STEP,911070023000,911088804400,18781400,-1
198,1,STEP,911088866600,911107224100,18357500,-1
199,1,STEP,911107310800,911126804500,19493700,-1
200,1,STEP,911126887600,911146207200,19319600,-1
201,1,STEP,911146277800,911165157300,18879500,-1
202,1,STEP,911165224300,911183497200,18272900,-1
203,1,STEP,911183580900,911202546800,18965900,-1
204,1,STEP,911202619400,911221987400,19368000,-1
205,1,STEP,911222057800,911241434500,19376700,-1
206,1,STEP,911241521100,911260148600,18627500,-1
207,1,STEP,911260275900,911279082300,18806400,-1
208,1,STEP,911279145300,911297513500,18368200,-1
209,1,STEP,911297605500,911315961400,18355900,-1
210,1,STEP,911316079200,911334426300,18347100,-1
211,1,STEP,911334499000,911353365600,18866600,-1
212,1,STEP,911353459500,911372181500,18722000,-1
213,1,STEP,911372292500,911390931700,18639200,-1
214,1,STEP,911390996900,911409449000,18452100,-1
215,1,STEP,911409541200,911428825400,19284200,-1
216,1,STEP,911428917800,911447329700,18411900,-1
217,1,STEP,911447427900,911466676000,19248100,-1
218,1,STEP,911466794400,911485300900,18506500,-1
219,1,STEP,911485392800,911504402800,19010000,-1
220,1,STEP,911504517500,911522701500,18184000,-1
221,1,STEP,911522781700,911541804500,19022800,-1
222,1,STEP,911541945600,911560505700,18560100,-1
223,1,STEP,911560590500,911578785000,18194500,-1
224,1,STEP,911578864300,911597369000,18504700,-1
225,1,STEP,911597447100,911617006800,19559700,-1
226,1,STEP,911617170500,911636098900,18928400,-1
227,1,STEP,911636192200,911655689400,19497200,-1
228,1,STEP,911655774800,911674322300,18547500,-1
229,1,STEP,911674385200,911693151800,18766600,-1
230,1,STEP,911693269800,911711760700,18490900,-1
231,1,STEP,911711947000,911730953500,19006500,-1
232,1,STEP,911731025400,911749309600,18284200,-1
233,1,STEP,911749408500,911768099700,18691200,-1
234,1,STEP,911768210600,911787113100,18902500,-1
235,1,STEP,911787182400,911804936000,17753600,-1
236,1,STEP,911805099100,911823337000,18237900,-1
237,1,STEP,911823534100,911841892600,18358500,-1
238,1,STEP,911841986700,911860226000,18239300,-1
239,1,STEP,911860361500,911879250900,18889400,-1
240,1,STEP,911879325600,911897313900,17988300,-1
241,1,STEP,911897381300,911916034500,18653200,-1
242,1,STEP,911916105400,911935281700,19176300,-1
243,1,STEP,911935413900,911954024200,18610300,-1
244,1,STEP,911954097300,911972621800,18524500,-1
245,1,STEP,911972712900,911991837400,19124500,-1
246,1,STEP,911991916100,912013954900,22038800,-1
247,1,STEP,912014065700,912032405800,18340100,-1
248,1,STEP,912032501300,912050773600,18272300,-1
249,1,STEP,912050849000,912069454900,18605900,-1
250,1,STEP,912069519700,912087390800,17871100,-1
251,1,STEP,912087483700,912106452500,18968800,-1
252,1,STEP,912106518100,912124810500,18292400,-1
253,1,STEP,912124875800,912143462100,18586300,-1
254,1,STEP,912143536800,912162096000,18559200,-1
255,1,STEP,912162172000,912180222700,18050700,-1
256,1,STEP,912180315600,912198708400,18392800,-1
257,1,STEP,912198789000,912216743200,17954200,-1
258,1,STEP,912216811900,912234795000,17983100,-1
259,1,STEP,912234862000,912253639100,18777100,-1
260,1,STEP,912253720700,912271111800,17391100,-1
261,1,STEP,912271185900,912288897800,17711900,-1
262,1,STEP,912288973200,912306135400,17162200,-1
263,1,STEP,912306201900,912322904400,16702500,-1
264,1,STEP,912322988300,912340167600,17179300,-1
265,1,STEP,912340240300,912357032000,16791700,-1
266,1,STEP,912357096800,912374562800,17466000,-1
267,1,STEP,912374628300,912392112000,17483700,-1
268,1,STEP,912392188200,912410571700,18383500,-1
269,1,STEP,912410665300,912428822100,18156800,-1
270,1,STEP,912428880800,912446595000,17714200,-1
271,1,STEP,912446657500,912465196800,18539300,-1
272,1,STEP,912465256800,912483763800,18507000,-1
273,1,STEP,912483815100,912503621700,19806600,-1
274,1,STEP,912503685100,912522227500,18542400,-1
275,1,STEP,912522293200,912542661300,20368100,-1
276,1,STEP,912542724700,912562406500,19681800,-1
277,1,STEP,912562466500,912580841300,18374800,-1
278,1,STEP,912580923900,912599970000,19046100,-1
279,1,STEP,912600051000,912620463800,20412800,-1
280,1,STEP,912620575600,912640738600,20163000,-1
281,1,STEP,912640817600,912662143500,21325900,-1
282,1,STEP,912662233000,912682208500,19975500,-1
283,1,STEP,912682303700,912701686500,19382800,-1
284,1,STEP,912701761700,912723397300,21635600,-1
285,1,STEP,912723489700,912745128500,21638800,-1
286,1,STEP,912745207300,912765916500,20709200,-1
287,1,STEP,912765977900,912786500800,20522900,-1
288,1,STEP,912786583300,912807626200,21042900,-1
289,1,STEP,912807700100,912828909800,21209700,-1
290,1,STEP,912828993900,912849363900,20370000,-1
291,1,STEP,912849461900,912870779500,21317600,-1
292,1,STEP,912870855700,912892732600,21876900,-1
293,1,STEP,912892936200,912914160500,21224300,-1
294,1,STEP,912914259300,912935322300,21063000,-1
295,1,STEP,912935442000,912957688800,22246800,-1
296,1,STEP,912957872100,912979464200,21592100,-1
297,1,STEP,912979520700,913001430000,21909300,-1
298,1,STEP,913001495100,913023928000,22432900,-1
299,1,STEP,913024021400,913046474200,22452800,-1
300,1,STEP,913046531000,913067909800,21378800,-1
301,1,STEP,913067967400,913089651200,21683800,-1
302,1,STEP,913089709700,913111692300,21982600,-1
303,1,STEP,913111746200,913134097400,22351200,-1
304,1,STEP,913134164800,913155719100,21554300,-1
305,1,STEP,913155800700,913177630000,21829300,-1
306,1,STEP,913177718700,913200055400,22336700,-1
307,1,STEP,913200116200,913222071400,21955200,-1
308,1,STEP,913222206000,913244913600,22707600,-1
309,1,STEP,913244976600,913267139700,22163100,-1
310,1,STEP,913267199200,913288967400,21768200,-1
311,1,STEP,913289035000,913310599400,21564400,-1
312,1,STEP,913310746100,913332638400,21892300,-1
313,1,STEP,913332744200,913354649400,21905200,-1
314,1,STEP,913354710900,913376166800,21455900,-1
315,1,STEP,913376240600,913399039800,22799200,-1
316,1,STEP,913399120800,913422168600,23047800,-1
317,1,STEP,913422240800,913445415300,23174500,-1
318,1,STEP,913445477900,913468725900,23248000,-1
319,1,STEP,913468794800,913492158200,23363400,-1
320,1,STEP,913492225200,913514896300,22671100,-1
321,1,STEP,913514952200,913538053800,23101600,-1
322,1,STEP,913538123500,913561318500,23195000,-1
323,1,STEP,913561378300,913584919600,23541300,-1
324,1,STEP,913584985600,913608576100,23590500,-1
325,1,STEP,913608636400,913631586900,22950500,-1
326,1,STEP,913631643000,913654662900,23019900,-1
327,1,STEP,913654716900,913678034300,23317400,-1
328,1,STEP,913678084700,913701020400,22935700,-1
329,1,STEP,913701071100,913724713300,23642200,-1
330,1,STEP,913724763100,913749005200,24242100,-1
331,1,STEP,913749057500,913772214900,23157400,-1
332,1,STEP,913772259600,913795736800,23477200,-1
333,1,STEP,913795786300,913819892100,24105800,-1
334,1,STEP,913819935800,913844172400,24236600,-1
335,1,STEP,913844224100,913867926800,23702700,-1
336,1,STEP,913867976600,913891806300,23829700,-1
337,1,STEP,913891851800,913915137100,23285300,-1
338,1,STEP,913915189000,913937973000,22784000,-1
339,1,STEP,913938026400,913961492200,23465800,-1
340,1,STEP,913961566600,913985192100,23625500,-1
341,1,STEP,913985241500,914008832200,23590700,-1
342,1,STEP,914008889400,914032006300,23116900,-1
343,1,STEP,914032067200,914055368800,23301600,-1
344,1,STEP,914055422600,914078604600,23182000,-1
345,1,STEP,914078666100,914102103000,23436900,-1
346,1,STEP,914102158900,914125195600,23036700,-1
347,1,STEP,914125251300,914149600800,24349500,-1
348,1,STEP,914149665200,914173443400,23778200,-1
349,1,STEP,914173508400,914196169800,22661400,-1
350,1,STEP,914196229800,914219461700,23231900,-1
351,1,STEP,914219521200,914242806800,23285600,-1
352,1,STEP,914242876400,914266777000,23900600,-1
353,1,STEP,914266845100,914290257100,23412000,-1
354,1,STEP,914290306200,914313863100,23556900,-1
355,1,STEP,914313906800,914336958000,23051200,-1
356,1,STEP,914337009900,914360451300,23441400,-1
357,1,STEP,914360501400,914384438100,23936700,-1
358,1,STEP,914384483100,914407775900,23292800,-1
359,1,STEP,914407832000,914431557900,23725900,-1
360,1,STEP,914431605400,914455495900,23890500,-1
361,1,STEP,914455545200,914478842300,23297100,-1
362,1,STEP,914478890300,914502484400,23594100,-1
363,1,STEP,914502562400,914525803100,23240700,-1
364,1,STEP,914525850700,914549541800,23691100,-1
365,1,STEP,914549590400,914572333700,22743300,-1
366,1,STEP,914572383300,914595948000,23564700,-1
367,1,STEP,914596004900,914619430700,23425800,-1
368,1,STEP,914619486500,914643799600,24313100,-1
369,1,STEP,914643870300,914667294300,23424000,-1
370,1,STEP,914667347400,914690904000,23556600,-1
371,1,STEP,914690963600,914714601800,23638200,-1
372,1,STEP,914714664300,914738202500,23538200,-1
373,1,STEP,914738259000,914762039300,23780300,-1
374,1,STEP,914762099400,914785319100,23219700,-1
375,1,STEP,914785380400,914809393600,24013200,-1
376,1,STEP,914809450800,914832317800,22867000,-1
377,1,STEP,914832377100,914855531900,23154800,-1
378,1,STEP,914855584700,914879120800,23536100,-1
379,1,STEP,914879170600,914902950500,23779900,-1
380,1,STEP,914902997800,914926605700,23607900,-1
381,1,STEP,914926662400,914950260100,23597700,-1
382,1,STEP,914950322700,914973497900,23175200,-1
383,1,STEP,914973555400,914996380200,22824800,-1
384,1,STEP,914996442600,915019762400,23319800,-1
385,1,STEP,915019817800,915043214200,23396400,-1
386,1,STEP,915043265700,915066109200,22843500,-1
387,1,STEP,915066157400,915089806600,23649200,-1
388,1,STEP,915089854000,915114004400,24150400,-1
389,1,STEP,915114054000,915137325700,23271700,-1
390,1,STEP,915137381300,915160375200,22993900,-1
391,1,STEP,915160423200,915183450300,23027100,-1
392,1,STEP,915183504300,915206213000,22708700,-1
393,1,STEP,915206261600,915229151500,22889900,-1
394,1,STEP,915229200800,915252406500,23205700,-1
395,1,STEP,915252458500,915275376000,22917500,-1
396,1,STEP,915275424100,915298853700,23429600,-1
397,1,STEP,915298907500,915321596100,22688600,-1
398,1,STEP,915321645000,915343741700,22096700,-1
399,1,STEP,915343807200,915366304300,22497100,-1
400,1,STEP,915366347300,915388191800,21844500,-1
401,1,STEP,915388240900,915409738700,21497800,-1
402,1,STEP,915409780700,915431749300,21968600,-1
403,1,STEP,915431802200,915453618500,21816300,-1
404,1,STEP,915453669600,915475686900,22017300,-1
405,1,STEP,915475738400,915497100600,21362200,-1
406,1,STEP,915497146900,915518610600,21463700,-1
407,1,STEP,915518670200,915541384900,22714700,-1
408,1,STEP,915541430600,915563655800,22225200,-1
409,1,STEP,915563709600,915585889400,22179800,-1
410,1,STEP,915585973400,915607545000,21571600,-1
411,1,STEP,915607597800,915629317200,21719400,-1
412,1,STEP,915629361400,915651331800,21970400,-1
413,1,STEP,915651376600,915673407800,22031200,-1
414,1,STEP,915673459500,915695743200,22283700,-1
415,1,STEP,915695801900,915717867800,22065900,-1
416,1,STEP,915717922500,915739322800,21400300,-1
417,1,STEP,915739391700,915761415400,22023700,-1
418,1,STEP,915761475100,915782991900,21516800,-1
419,1,STEP,915783044400,915805778400,22734000,-1
420,1,STEP,915805822800,915828913800,23091000,-1
421,1,STEP,915828961000,915850891600,21930600,-1
422,1,STEP,915850932600,915872750800,21818200,-1
423,1,STEP,915872803000,915894941900,22138900,-1
424,1,STEP,915894988800,915917285700,22296900,-1
425,1,STEP,915917334000,915939567500,22233500,-1
426,1,STEP,915939616300,915961424600,21808300,-1
427,1,STEP,915961482700,915983539000,22056300,-1
428,1,STEP,915983591100,916005877700,22286600,-1
429,1,STEP,916005926700,916027932400,22005700,-1
430,1,STEP,916027987700,916050045600,22057900,-1
431,1,STEP,916050098800,916072204500,22105700,-1
432,1,STEP,916072250600,916094133900,21883300,-1
433,1,STEP,916094189600,916116176200,21986600,-1
434,1,STEP,916116225600,916138237500,22011900,-1
435,1,STEP,916138285100,916160773800,22488700,-1
436,1,STEP,916160822100,916183166200,22344100,-1
437,1,STEP,916183214800,916205312900,22098100,-1
438,1,STEP,916205361300,916228395600,23034300,-1
439,1,STEP,916228437400,916250413600,21976200,-1
440,1,STEP,916250459000,916272415200,21956200,-1
441,1,STEP,916272453800,916295446000,22992200,-1
442,1,STEP,916295496600,916319633200,24136600,-1
443,1,STEP,916319679700,916343839300,24159600,-1
444,1,STEP,916343891100,916367870000,23978900,-1
445,1,STEP,916367911200,916391719800,23808600,-1
446,1,STEP,916391781300,916415247000,23465700,-1
447,1,STEP,916415302400,916439096700,23794300,-1
448,1,STEP,916439144300,916462553700,23409400,-1
449,1,STEP,916462604800,916486173300,23568500,-1
450,1,STEP,916486225200,916510164200,23939000,-1
451,1,STEP,916510233700,916533466200,23232500,-1
452,1,STEP,916533518900,916556970000,23451100,-1
453,1,STEP,916557012200,916581254800,24242600,-1
454,1,STEP,916581305300,916604767300,23462000,-1
455,1,STEP,916604827400,916627659800,22832400,-1
456,1,STEP,916627726100,916651178600,23452500,-1
457,1,STEP,916651246600,916674482700,23236100,-1
458,1,STEP,916674549300,916697792000,23242700,-1
459,1,STEP,916697864000,916721999500,24135500,-1
460,1,STEP,916722160500,916746868900,24708400,-1
461,1,STEP,916747006400,916770193100,23186700,-1
462,1,STEP,916770348400,916793716400,23368000,-1
463,1,STEP,916793786500,916816093700,22307200,-1
464,1,STEP,916816176100,916838696900,22520800,-1
465,1,STEP,916838754200,916861969100,23214900,-1
466,1,STEP,916862017100,916885292400,23275300,-1
467,1,STEP,916885355200,916910288800,24933600,-1
468,1,STEP,916910340300,916934036600,23696300,-1
469,1,STEP,916934099500,916957029200,22929700,-1
470,1,STEP,916957172000,916980708800,23536800,-1
471,1,STEP,916980773600,917004400600,23627000,-1
472,1,STEP,917004459100,917027155100,22696000,-1
473,1,STEP,917027225400,917051065200,23839800,-1
474,1,STEP,917051118900,917074955800,23836900,-1
475,1,STEP,917075025600,917098750300,23724700,-1
476,1,STEP,917098814500,917122445800,23631300,-1
477,1,STEP,917122519400,917145063300,22543900,-1
478,1,STEP,917145137100,917167181200,22044100,-1
479,1,STEP,917167252300,917189413000,22160700,-1
480,1,STEP,917189470500,917211958600,22488100,-1
481,1,STEP,917212170700,917234459900,22289200,-1
482,1,STEP,917234517600,917256928900,22411300,-1
483,1,STEP,917256976600,917278486100,21509500,-1
484,1,STEP,917278545000,917300585500,22040500,-1
485,1,STEP,917300633000,917324290300,23657300,-1
486,1,STEP,917324351300,917346857800,22506500,-1
487,1,STEP,917346906300,917369072800,22166500,-1
488,1,STEP,917369117800,917390768200,21650400,-1
489,1,STEP,917390821600,917413104600,22283000,-1
490,1,STEP,917413160200,917434383200,21223000,-1
491,1,STEP,917434442500,917456049400,21606900,-1
492,1,STEP,917456105400,917478842200,22736800,-1
493,1,STEP,917478897900,917500299500,21401600,-1
494,1,STEP,917500354800,917521602100,21247300,-1
495,1,STEP,917521662300,917543409500,21747200,-1
496,1,STEP,917543468900,917564481300,21012400,-1
497,1,STEP,917564536100,917586082300,21546200,-1
498,1,STEP,917586139500,917607841500,21702000,-1
499,1,STEP,917607938000,917630295000,22357000,-1
500,1,STEP,917630354000,917651950400,21596400,-1
501,1,STEP,917652008600,917673574200,21565600,-1
502,1,STEP,917673637200,917695481600,21844400,-1
503,1,STEP,917695540900,917717595100,22054200,-1
504,1,STEP,917717670500,917739532700,21862200,-1
505,1,STEP,917739608100,917761315000,21706900,-1
506,1,STEP,917761372400,917782997900,21625500,-1
507,1,STEP,917783051200,917805054900,22003700,-1
508,1,STEP,917805113200,917826347700,21234500,-1
509,1,STEP,917826402200,917848232300,21830100,-1
510,1,STEP,917848283600,917870607900,22324300,-1
511,1,STEP,917870654300,917893085700,22431400,-1
512,1,STEP,917893152000,917915589900,22437900,-1
513,1,STEP,917915644000,917937418200,21774200,-1
514,1,STEP,917937475500,917959616600,22141100,-1
515,1,STEP,917959667900,917981672800,22004900,-1
516,1,STEP,917981730400,918004348400,22618000,-1
517,1,STEP,918004405800,918026613200,22207400,-1
518,1,STEP,918026669600,918049209400,22539800,-1
519,1,STEP,918049258100,918071745500,22487400,-1
520,1,STEP,918071798000,918093988200,22190200,-1
521,1,STEP,918094043000,918115777800,21734800,-1
522,1,STEP,918115832500,918137519500,21687000,-1
523,1,STEP,918137572000,918159112000,21540000,-1
524,1,STEP,918159161000,918181131800,21970800,-1
525,1,STEP,918181188700,918203526400,22337700,-1
526,1,STEP,918203575600,918225368500,21792900,-1
527,1,STEP,918225421400,918246889400,21468000,-1
528,1,STEP,918246934700,918269201900,22267200,-1
529,1,STEP,918269247700,918291706100,22458400,-1
530,1,STEP,918291759600,918313834100,22074500,-1
531,1,STEP,918313877100,918335738100,21861000,-1
532,1,STEP,918335788000,918357428100,21640100,-1
533,1,STEP,918357485900,918379367600,21881700,-1
534,1,STEP,918379424700,918401292400,21867700,-1
535,1,STEP,918401346900,918422741200,21394300,-1
536,1,STEP,918422798700,918444956600,22157900,-1
537,1,STEP,918445063100,918467512400,22449300,-1
538,1,STEP,918467566700,918490148900,22582200,-1
539,1,STEP,918490209800,918512560200,22350400,-1
540,1,STEP,918512614800,918534812700,22197900,-1
541,1,STEP,918534868900,918558906800,24037900,-1
542,1,STEP,918558969600,918583012000,24042400,-1
543,1,STEP,918583057200,918607324700,24267500,-1
544,1,STEP,918607439400,918632217800,24778400,-1
545,1,STEP,918632286700,918655452700,23166000,-1
546,1,STEP,918655551200,918679022200,23471000,-1
547,1,STEP,918679130200,918703543800,24413600,-1
548,1,STEP,918703634800,918727323200,23688400,-1
549,1,STEP,918727441500,918750781700,23340200,-1
550,1,STEP,918750896200,918774401500,23505300,-1
551,1,STEP,918774596100,918798124700,23528600,-1
552,1,STEP,918798193800,918823152500,24958700,-1
553,1,STEP,918823232500,918846916000,23683500,-1
554,1,STEP,918846993300,918871251400,24258100,-1
555,1,STEP,918871377700,918895202700,23825000,-1
556,1,STEP,918895268700,918918850200,23581500,-1
557,1,STEP,918918921500,918942897100,23975600,-1
558,1,STEP,918942962400,918967654900,24692500,-1
559,1,STEP,918967720500,918991979100,24258600,-1
560,1,STEP,918992055700,919016506100,24450400,-1
561,1,STEP,919016573400,919040167100,23593700,-1
562,1,STEP,919040253900,919063657100,23403200,-1
563,1,STEP,919063727000,919087597400,23870400,-1
564,1,STEP,919087678200,919111949800,24271600,-1
565,1,STEP,919112010200,919135775000,23764800,-1
566,1,STEP,919135854700,919159241800,23387100,-1
567,1,STEP,919159294400,919183307800,24013400,-1
568,1,STEP,919183365200,919207047500,23682300,-1
569,1,STEP,919207103500,919231386300,24282800,-1
570,1,STEP,919231456500,919255400300,23943800,-1
571,1,STEP,919255465000,919279676100,24211100,-1
572,1,STEP,919279748800,919303615300,23866500,-1
573,1,STEP,919303671100,919327274400,23603300,-1
574,1,STEP,919327355000,919350224100,22869100,-1
575,1,STEP,919350306500,919373365700,23059200,-1
576,1,STEP,919373466600,919396036100,22569500,-1
577,1,STEP,919396106200,919418254600,22148400,-1
578,1,STEP,919418323400,919441008600,22685200,-1
579,1,STEP,919441108100,919463467600,22359500,-1
580,1,STEP,919463531900,919486293400,22761500,-1
581,1,STEP,919486375200,919508427800,22052600,-1
582,1,STEP,919508503700,919530562500,22058800,-1
583,1,STEP,919530647900,919552508000,21860100,-1
584,1,STEP,919552590500,919574665300,22074800,-1
585,1,STEP,919574763600,919596665200,21901600,-1
586,1,STEP,919596731700,919618035100,21303400,-1
587,1,STEP,919618118400,919641220300,23101900,-1
588,1,STEP,919641296300,919663399000,22102700,-1
589,1,STEP,919663477200,919685476600,21999400,-1
590,1,STEP,919685547400,919708047600,22500200,-1
591,1,STEP,919708136700,919730393800,22257100,-1
592,1,STEP,919730506800,919752169700,21662900,-1
593,1,STEP,919752234800,919774609800,22375000,-1
594,1,STEP,919774663500,919795999400,21335900,-1
595,1,STEP,919796055300,919818779200,22723900,-1
596,1,STEP,919818849500,919840465800,21616300,-1
597,1,STEP,919840510700,919862944600,22433900,-1
598,1,STEP,919862992400,919885238500,22246100,-1
599,1,STEP,919885295100,919907311800,22016700,-1
600,1,STEP,919907363800,919929421700,22057900,-1
601,1,STEP,919929475500,919951925600,22450100,-1
602,1,STEP,919951983000,919973611000,21628000,-1
603,1,STEP,919973670800,919995594000,21923200,-1
604,1,STEP,919995661200,920017583200,21922000,-1
605,1,STEP,920017656300,920039673700,22017400,-1
606,1,STEP,920039741100,920062111600,22370500,-1
607,1,STEP,920062182600,920084190600,22008000,-1
608,1,STEP,920084246300,920106755000,22508700,-1
609,1,STEP,920106809400,920128636600,21827200,-1
610,1,STEP,920128698400,920150333500,21635100,-1
611,1,STEP,920150389800,920172777400,22387600,-1
612,1,STEP,920172832800,920195488600,22655800,-1
613,1,STEP,920195549900,920218222800,22672900,-1
614,1,STEP,920218278300,920240456900,22178600,-1
615,1,STEP,920240547200,920262860000,22312800,-1
616,1,STEP,920262942800,920285776100,22833300,-1
617,1,STEP,920285897000,920308485100,22588100,-1
618,1,STEP,920308604400,920331749000,23144600,-1
619,1,STEP,920332001700,920355863300,23861600,-1
620,1,STEP,920355954300,920378680600,22726300,-1
621,1,STEP,920378775300,920400463200,21687900,-1
622,1,STEP,920400561400,920422459300,21897900,-1
623,1,STEP,920422704200,920445404900,22700700,-1
624,1,STEP,920445484300,920467857400,22373100,-1
625,1,STEP,920468016000,920490613700,22597700,-1
626,1,STEP,920490707100,920513296800,22589700,-1
627,1,STEP,920513396400,920535392000,21995600,-1
628,1,STEP,920535530500,920557790300,22259800,-1
629,1,STEP,920557888700,920580181400,22292700,-1
630,1,STEP,920580281400,920602286100,22004700,-1
631,1,STEP,920602383100,920625812300,23429200,-1
632,1,STEP,920625906800,920648111200,22204400,-1
633,1,STEP,920648186500,920669443900,21257400,-1
634,1,STEP,920669516800,920691040300,21523500,-1
635,1,STEP,920691111100,920713472900,22361800,-1
636,1,STEP,920713538900,920734754800,21215900,-1
637,1,STEP,920734829600,920756954300,22124700,-1
638,1,STEP,920757021800,920778219700,21197900,-1
639,1,STEP,920778313400,920799943300,21629900,-1
640,1,STEP,920800008300,920822797100,22788800,-1
641,1,STEP,920822886700,920844762000,21875300,-1
642,1,STEP,920844893000,920867562800,22669800,-1
643,1,STEP,920867656400,920889698100,22041700,-1
644,1,STEP,920889769900,920911801900,22032000,-1
645,1,STEP,920911887900,920934806700,22918800,-1
646,1,STEP,920934891600,920956658700,21767100,-1
647,1,STEP,920956733800,920978389900,21656100,-1
648,1,STEP,920978580500,921000756900,22176400,-1
649,1,STEP,921000841900,921021779100,20937200,-1
650,1,STEP,921021859500,921043322800,21463300,-1
651,1,STEP,921043397500,921066192400,22794900,-1
652,1,STEP,921066264300,921087447200,21182900,-1
653,1,STEP,921087507400,921108473200,20965800,-1
654,1,STEP,921108599500,921129827500,21228000,-1
655,1,STEP,921129877300,921151167600,21290300,-1
656,1,STEP,921151220900,921174037200,22816300,-1
657,1,STEP,921174082100,921196130200,22048100,-1
658,1,STEP,921196189400,921218197600,22008200,-1
659,1,STEP,921218242100,921240438100,22196000,-1
660,1,STEP,921240487900,921263578700,23090800,-1
661,1,STEP,921263633800,921285680300,22046500,-1
662,1,STEP,921285724900,921308064300,22339400,-1
663,1,STEP,921308122500,921330403600,22281100,-1
664,1,STEP,921330457100,921352821900,22364800,-1
665,1,STEP,921352880200,921374817000,21936800,-1
666,1,STEP,921374879000,921396662300,21783300,-1
667,1,STEP,921396719500,921418535400,21815900,-1
668,1,STEP,921418594000,921440507800,21913800,-1
669,1,STEP,921440620000,921462785000,22165000,-1
670,1,STEP,921462866300,921485523700,22657400,-1
671,1,STEP,921485579000,921507457900,21878900,-1
672,1,STEP,921507511800,921529310500,21798700,-1
673,1,STEP,921529365500,921551481100,22115600,-1
674,1,STEP,921551539600,921574359000,22819400,-1
675,1,STEP,921574424400,921596659000,22234600,-1
676,1,STEP,921596719800,921618844700,22124900,-1
677,1,STEP,921618901100,921641229800,22328700,-1
678,1,STEP,921641286700,921664383800,23097100,-1
679,1,STEP,921664468900,921687069700,22600800,-1
680,1,STEP,921687124500,921709334100,22209600,-1
681,1,STEP,921709388700,921731825700,22437000,-1
682,1,STEP,921731872900,921754898300,23025400,-1
683,1,STEP,921754954900,921777293200,22338300,-1
684,1,STEP,921777352700,921799619500,22266800,-1
685,1,STEP,921799676700,921821079200,21402500,-1
686,1,STEP,921821147400,921843487900,22340500,-1
687,1,STEP,921843551800,921865571700,22019900,-1
688,1,STEP,921865631100,921886849700,21218600,-1
689,1,STEP,921886924300,921908508200,21583900,-1
690,1,STEP,921908571400,921930488900,21917500,-1
691,1,STEP,921930545100,921952940500,22395400,-1
692,1,STEP,921952992800,921976614200,23621400,-1
693,1,STEP,921976685000,921999748700,23063700,-1
694,1,STEP,921999805400,922022082800,22277400,-1
695,1,STEP,922022131000,922044434000,22303000,-1
696,1,STEP,922044487800,922066799400,22311600,-1
697,1,STEP,922066881400,922088830900,21949500,-1
698,1,STEP,922088889500,922110943400,22053900,-1
699,1,STEP,922111008500,922133220400,22211900,-1
700,1,STEP,922133272600,922155808200,22535600,-1
701,1,STEP,922155868600,922177915900,22047300,-1
702,1,STEP,922178004500,922199908400,21903900,-1
703,1,STEP,922199959900,922222223000,22263100,-1
704,1,STEP,922222279100,922244874700,22595600,-1
705,1,STEP,922244952700,922267086100,22133400,-1
706,1,STEP,922267144700,922289241800,22097100,-1
707,1,STEP,922289297300,922310992400,21695100,-1
708,1,STEP,922311049500,922332968100,21918600,-1
709,1,STEP,922333027900,922354587100,21559200,-1
710,1,STEP,922354646200,922376805900,22159700,-1
711,1,STEP,922376882800,922398854600,21971800,-1
712,1,STEP,922398921100,922420928700,22007600,-1
713,1,STEP,922421000300,922443755200,22754900,-1
714,1,STEP,922443833500,922465752300,21918800,-1
715,1,STEP,922465818500,922487022900,21204400,-1
716,1,STEP,922487086400,922508456000,21369600,-1
717,1,STEP,922508554100,922530321400,21767300,-1
718,1,STEP,922530389900,922551998800,21608900,-1
719,1,STEP,922552066800,922573180200,21113400,-1
720,1,STEP,922573247900,922595209500,21961600,-1
721,1,STEP,922595275200,922617110600,21835400,-1
722,1,STEP,922617172900,922640089800,22916900,-1
723,1,STEP,922640146600,922663972100,23825500,-1
724,1,STEP,922664032100,922687407200,23375100,-1
725,1,STEP,922687482500,922711129000,23646500,-1
726,1,STEP,922711195700,922735186300,23990600,-1
727,1,STEP,922735248700,922759555700,24307000,-1
728,1,STEP,922759630600,922784501400,24870800,-1
729,1,STEP,922784564100,922808003600,23439500,-1
730,1,STEP,922808065100,922831596800,23531700,-1
731,1,STEP,922831662500,922855538300,23875800,-1
732,1,STEP,922855629900,922879925100,24295200,-1
733,1,STEP,922880010700,922904140600,24129900,-1
734,1,STEP,922904242900,922928978600,24735700,-1
735,1,STEP,922929097400,922952436700,23339300,-1
736,1,STEP,922952518200,922975485000,22966800,-1
737,1,STEP,922975597500,922999369000,23771500,-1
738,1,STEP,922999456000,923023681700,24225700,-1
739,1,STEP,923023747700,923048215300,24467600,-1
740,1,STEP,923048326200,923073766300,25440100,-1
741,1,STEP,923073942100,923097799500,23857400,-1
742,1,STEP,923097869400,923121988200,24118800,-1
743,1,STEP,923122180600,923147147300,24966700,-1
744,1,STEP,923147240400,923171245900,24005500,-1
745,1,STEP,923171431300,923197057700,25626400,-1
746,1,STEP,923197466500,923222667500,25201000,-1
747,1,STEP,923222759400,923246407200,23647800,-1
748,1,STEP,923246519900,923271001900,24482000,-1
749,1,STEP,923271084700,923295128500,24043800,-1
750,1,STEP,923295226400,923318887900,23661500,-1
751,1,STEP,923319026800,923342636200,23609400,-1
752,1,STEP,923342710300,923366441800,23731500,-1
753,1,STEP,923371672000,923396188300,24516300,-1
754,1,STEP,923396352700,923419635800,23283100,-1
755,1,STEP,923419708500,923445090900,25382400,-1
756,1,STEP,923445267300,923468077400,22810100,-1
757,1,STEP,923468145300,923490825100,22679800,-1
758,1,STEP,923490905800,923512745500,21839700,-1
759,1,STEP,923512833600,923535417700,22584100,-1
760,1,STEP,923535501800,923557128800,21627000,-1
761,1,STEP,923557226800,923580945200,23718400,-1
762,1,STEP,923581127500,923609006500,27879000,-1
763,1,STEP,923609451800,923631315100,21863300,-1
764,1,STEP,923631442400,923654176400,22734000,-1
765,1,STEP,923654270000,923675989400,21719400,-1
766,1,STEP,923676067700,923697646800,21579100,-1
767,1,STEP,923697752100,923719584000,21831900,-1
768,1,STEP,923719742300,923741083000,21340700,-1
769,1,STEP,923741188000,923762897100,21709100,-1
770,1,STEP,923763021400,923785083900,22062500,-1
771,1,STEP,923785224500,923807204800,21980300,-1
772,1,STEP,923807278300,923829044600,21766300,-1
773,1,STEP,923829116000,923850991000,21875000,-1
774,1,STEP,923851195300,923874717600,23522300,-1
775,1,STEP,923874833100,923896540900,21707800,-1
776,1,STEP,923896609300,923918375500,21766200,-1
777,1,STEP,923918469900,923939618100,21148200,-1
778,1,STEP,923939707200,923961657500,21950300,-1
779,1,STEP,923961750900,923985351300,23600400,-1
780,1,STEP,923985454600,924007035000,21580400,-1
781,1,STEP,924007108900,924029383800,22274900,-1
782,1,STEP,924029465200,924051233500,21768300,-1
783,1,STEP,924051410800,924074861200,23450400,-1
784,1,STEP,924074966200,924096718400,21752200,-1
785,1,STEP,924096816100,924118348000,21531900,-1
786,1,STEP,924118419100,924140656300,22237200,-1
787,1,STEP,924140729700,924162594500,21864800,-1
788,1,STEP,924162651500,924184358200,21706700,-1
789,1,STEP,924184481700,924206636900,22155200,-1
790,1,STEP,924206776100,924228992600,22216500,-1
791,1,STEP,924229059600,924251617400,22557800,-1
792,1,STEP,924251854000,924274850800,22996800,-1
793,1,STEP,924274981300,924296918100,21936800,-1
794,1,STEP,924297023900,924319400200,22376300,-1
795,1,STEP,924319489500,924341183500,21694000,-1
796,1,STEP,924341252500,924363604500,22352000,-1
797,1,STEP,924363686300,924385188900,21502600,-1
798,1,STEP,924385277800,924408007700,22729900,-1
799,1,STEP,924408087500,924430159200,22071700,-1
800,1,STEP,924430280000,924453167600,22887600,-1
801,1,STEP,924453254500,924476511800,23257300,-1
802,1,STEP,924476604200,924498094000,21489800,-1
803,1,STEP,924498167300,924519667700,21500400,-1
804,1,STEP,924519738600,924541714700,21976100,-1
805,1,STEP,924541806300,924563463100,21656800,-1
806,1,STEP,924563539100,924584608200,21069100,-1
807,1,STEP,924584686200,924605870000,21183800,-1
808,1,STEP,924605941200,924628268300,22327100,-1
809,1,STEP,924628363300,924651063000,22699700,-1
810,1,STEP,924651146500,924672827400,21680900,-1
811,1,STEP,924672917300,924695127800,22210500,-1
812,1,STEP,924695213700,924717771700,22558000,-1
813,1,STEP,924717841100,924739782800,21941700,-1
814,1,STEP,924739867000,924762383100,22516100,-1
815,1,STEP,924762441400,924784116500,21675100,-1
816,1,STEP,924784181000,924805573800,21392800,-1
817,1,STEP,924805641000,924827759000,22118000,-1
818,1,STEP,924827826100,924849044100,21218000,-1
819,1,STEP,924849103100,924870620800,21517700,-1
820,1,STEP,924870688100,924892541100,21853000,-1
821,1,STEP,924892604100,924914528700,21924600,-1
822,1,STEP,924914592000,924936995900,22403900,-1
823,1,STEP,924937059200,924958863200,21804000,-1
824,1,STEP,924958931800,924980331400,21399600,-1
825,1,STEP,924980400400,925001989300,21588900,-1
826,1,STEP,925002048900,925024031000,21982100,-1
827,1,STEP,925024095500,925045775200,21679700,-1
828,1,STEP,925045836900,925067754100,21917200,-1
829,1,STEP,925067803000,925089653600,21850600,-1
830,1,STEP,925089705800,925112186900,22481100,-1
831,1,STEP,925112244400,925135047500,22803100,-1
832,1,STEP,925135111600,925157391500,22279900,-1
833,1,STEP,925157453500,925179836500,22383000,-1
834,1,STEP,925179885100,925202197400,22312300,-1
835,1,STEP,925202247100,925224202700,21955600,-1
836,1,STEP,925224260100,925246318100,22058000,-1
837,1,STEP,925246366500,925268812900,22446400,-1
838,1,STEP,925268875700,925291114000,22238300,-1
839,1,STEP,925291159600,925313452800,22293200,-1
840,1,STEP,925313508900,925335856000,22347100,-1
841,1,STEP,925335914900,925358026200,22111300,-1
842,1,STEP,925358088200,925380242700,22154500,-1
843,1,STEP,925380292200,925403030100,22737900,-1
844,1,STEP,925403080100,925425710700,22630600,-1
845,1,STEP,925425763700,925448881100,23117400,-1
846,1,STEP,925448927600,925471107000,22179400,-1
847,1,STEP,925471154300,925493920100,22765800,-1
848,1,STEP,925493980200,925516381800,22401600,-1
849,1,STEP,925516429700,925539936800,23507100,-1
850,1,STEP,925539983800,925563019900,23036100,-1
851,1,STEP,925563071400,925585669000,22597600,-1
852,1,STEP,925585729300,925608175200,22445900,-1
853,1,STEP,925608253500,925630773800,22520300,-1
854,1,STEP,925630828000,925653470300,22642300,-1
855,1,STEP,925653530900,925676005000,22474100,-1
856,1,STEP,925676058800,925698755400,22696600,-1
857,1,STEP,925698812400,925720756100,21943700,-1
858,1,STEP,925720810000,925743974000,23164000,-1
859,1,STEP,925744026900,925767152200,23125300,-1
860,1,STEP,925767210900,925789609200,22398300,-1
861,1,STEP,925789675600,925813260100,23584500,-1
862,1,STEP,925813311700,925835353100,22041400,-1
863,1,STEP,925835405500,925857503800,22098300,-1
864,1,STEP,925857551500,925879461200,21909700,-1
865,1,STEP,925879511400,925902199100,22687700,-1
866,1,STEP,925902246400,925925785700,23539300,-1
867,1,STEP,925925827600,925947804100,21976500,-1
868,1,STEP,925947862900,925969793400,21930500,-1
869,1,STEP,925969845900,925992365900,22520000,-1
870,1,STEP,925992408000,926015137700,22729700,-1
871,1,STEP,926015188700,926037205300,22016600,-1
872,1,STEP,926037251100,926060027600,22776500,-1
873,1,STEP,926060075900,926083409300,23333400,-1
874,1,STEP,926083462500,926106777900,23315400,-1
875,1,STEP,926106827900,926129352400,22524500,-1
876,1,STEP,926129403700,926152412900,23009200,-1
877,1,STEP,926152455000,926174640200,22185200,-1
878,1,STEP,926174690300,926196990200,22299900,-1
879,1,STEP,926197035200,926219638800,22603600,-1
880,1,STEP,926219684500,926242307400,22622900,-1
881,1,STEP,926242363900,926264941500,22577600,-1
882,1,STEP,926264984500,926287329200,22344700,-1
883,1,STEP,926287381100,926310578600,23197500,-1
884,1,STEP,926310628900,926333202800,22573900,-1
885,1,STEP,926333249600,926355443000,22193400,-1
886,1,STEP,926355491900,926377560600,22068700,-1
887,1,STEP,926377608900,926399674200,22065300,-1
888,1,STEP,926399731000,926421907200,22176200,-1
889,1,STEP,926421963200,926444367400,22404200,-1
890,1,STEP,926444421100,926466862000,22440900,-1
891,1,STEP,926466913700,926489383000,22469300,-1
892,1,STEP,926489438000,926511671600,22233600,-1
893,1,STEP,926511722200,926534072000,22349800,-1
894,1,STEP,926534125500,926558524700,24399200,-1
895,1,STEP,926558565800,926580611200,22045400,-1
896,1,STEP,926580668000,926602298600,21630600,-1
897,1,STEP,926602348500,926624613800,22265300,-1
898,1,STEP,926624664000,926647204600,22540600,-1
899,1,STEP,926647256100,926669966000,22709900,-1
900,1,STEP,926670028200,926692516700,22488500,-1
901,1,STEP,926692586700,926714445700,21859000,-1
902,1,STEP,926714516100,926736975100,22459000,-1
903,1,STEP,926737045200,926759341500,22296300,-1
904,1,STEP,926759395800,926781734900,22339100,-1
905,1,STEP,926781801000,926803632600,21831600,-1
906,1,STEP,926803691400,926826331600,22640200,-1
907,1,STEP,926826383700,926849505500,23121800,-1
908,1,STEP,926849554600,926872034200,22479600,-1
909,1,STEP,926872081300,926893966500,21885200,-1
910,1,STEP,926894023500,926915947100,21923600,-1
911,1,STEP,926915993200,926938390900,22397700,-1
912,1,STEP,926938445100,926960585000,22139900,-1
913,1,STEP,926960625700,926982904300,22278600,-1
914,1,STEP,926982956400,927005149600,22193200,-1
915,1,STEP,927005201000,927027359000,22158000,-1
916,1,STEP,927027409600,927049898400,22488800,-1
917,1,STEP,927049943400,927072313800,22370400,-1
918,1,STEP,927072381200,927094643100,22261900,-1
919,1,STEP,927094693000,927117475000,22782000,-1
920,1,STEP,927117551200,927140018000,22466800,-1
921,1,STEP,927140067600,927164478900,24411300,-1
922,1,STEP,927164519600,927189626700,25107100,-1
923,1,STEP,927189670400,927214090000,24419600,-1
924,1,STEP,927214138400,927238213900,24075500,-1
925,1,STEP,927238258900,927262455100,24196200,-1
926,1,STEP,927262500900,927285612300,23111400,-1
927,1,STEP,927285660500,927310180100,24519600,-1
928,1,STEP,927310230800,927334946900,24716100,-1
929,1,STEP,927334993900,927359504700,24510800,-1
930,1,STEP,927359546400,927384390400,24844000,-1
931,1,STEP,927384435800,927408929300,24493500,-1
932,1,STEP,927408985600,927433074600,24089000,-1
933,1,STEP,927433126900,927457473100,24346200,-1
934,1,STEP,927457533700,927482061800,24528100,-1
935,1,STEP,927482127800,927506444400,24316600,-1
936,1,STEP,927506498100,927531166900,24668800,-1
937,1,STEP,927531217000,927555174100,23957100,-1
938,1,STEP,927555222900,927579586500,24363600,-1
939,1,STEP,927579629000,927603630600,24001600,-1
940,1,STEP,927603679900,927628387700,24707800,-1
941,1,STEP,927628445900,927652326300,23880400,-1
942,1,STEP,927652383800,927676296400,23912600,-1
943,1,STEP,927676347300,927700708800,24361500,-1
944,1,STEP,927700762200,927724799900,24037700,-1
945,1,STEP,927724847200,927748717600,23870400,-1
946,1,STEP,927748772200,927772761100,23988900,-1
947,1,STEP,927772807800,927797567700,24759900,-1
948,1,STEP,927797616500,927822719200,25102700,-1
949,1,STEP,927822778200,927846542100,23763900,-1
950,1,STEP,927846625400,927871985000,25359600,-1
951,1,STEP,927872039600,927896060800,24021200,-1
952,1,STEP,927896101300,927920143400,24042100,-1
953,1,STEP,927920196600,927943721000,23524400,-1
954,1,STEP,927943770400,927968592500,24822100,-1
955,1,STEP,927968639600,927993041900,24402300,-1
956,1,STEP,927993088800,928019052200,25963400,-1
957,1,STEP,928019105400,928043581300,24475900,-1
958,1,STEP,928043628300,928069686600,26058300,-1
959,1,STEP,928069731100,928093572900,23841800,-1
960,1,STEP,928093616400,928118087100,24470700,-1
961,1,STEP,928118132500,928142166900,24034400,-1
962,1,STEP,928142221600,928166678900,24457300,-1
963,1,STEP,928166723000,928189944800,23221800,-1
964,1,STEP,928189990700,928212211800,22221100,-1
965,1,STEP,928212262900,928235634100,23371200,-1
966,1,STEP,928235687800,928258363700,22675900,-1
967,1,STEP,928258406500,928280741500,22335000,-1
968,1,STEP,928280789700,928303362100,22572400,-1
969,1,STEP,928303410400,928326109500,22699100,-1
970,1,STEP,928326221100,928348476700,22255600,-1
971,1,STEP,928348570000,928370840500,22270500,-1
972,1,STEP,928370882300,928393803800,22921500,-1
973,1,STEP,928393852600,928416815500,22962900,-1
974,1,STEP,928416872700,928439157100,22284400,-1
975,1,STEP,928439209700,928461557400,22347700,-1
976,1,STEP,928461604000,928483388000,21784000,-1
977,1,STEP,928483429500,928505365000,21935500,-1
978,1,STEP,928505420500,928528407900,22987400,-1
979,1,STEP,928528484100,928550979600,22495500,-1
980,1,STEP,928551039300,928573581600,22542300,-1
981,1,STEP,928573637500,928596730800,23093300,-1
982,1,STEP,928596778300,928619294500,22516200,-1
983,1,STEP,928619342100,928642410400,23068300,-1
984,1,STEP,928642472400,928665276600,22804200,-1
985,1,STEP,928665329800,928687776000,22446200,-1
986,1,STEP,928687833100,928710590200,22757100,-1
987,1,STEP,928710639900,928732663800,22023900,-1
988,1,STEP,928732744300,928754666200,21921900,-1
989,1,STEP,928754742100,928776814400,22072300,-1
990,1,STEP,928776861700,928799210200,22348500,-1
991,1,STEP,928799257600,928821665100,22407500,-1
992,1,STEP,928821710800,928844195000,22484200,-1
993,1,STEP,928844240200,928866587600,22347400,-1
994,1,STEP,928866633300,928889316100,22682800,-1
995,1,STEP,928889367900,928912077700,22709800,-1
996,1,STEP,928912128900,928934674500,22545600,-1
997,1,STEP,928934729800,928957910000,23180200,-1
998,1,STEP,928957961500,928980236400,22274900,-1
999,1,STEP,928980276300,929002635000,22358700,-1
