Gen,Resource,Stamp,TimeStamp_Start,TimeStamp_End,Duration,Indiv_id
0,1,TransfertToDevice,423115363900,423262147200,146783300,-1
0,1,STEP,423295236100,423298295200,3059100,-1
1,1,STEP,423298368400,423301293100,2924700,-1
2,1,STEP,423301453200,423304217800,2764600,-1
3,1,STEP,423304267500,423307083800,2816300,-1
4,1,STEP,423307151200,423309959400,2808200,-1
5,1,STEP,423310034600,423312859600,2825000,-1
6,1,STEP,423312932400,423316526200,3593800,-1
7,1,STEP,423316599800,423319344100,2744300,-1
8,1,STEP,423319402000,423322462600,3060600,-1
9,1,STEP,423322545700,423325267700,2722000,-1
10,1,STEP,423325319900,423327873400,2553500,-1
11,1,STEP,423327960700,423330590700,2630000,-1
12,1,STEP,423330651500,423333226600,2575100,-1
13,1,STEP,423333260100,423335676200,2416100,-1
14,1,STEP,423335742300,423338044400,2302100,-1
15,1,STEP,423338097300,423340548600,2451300,-1
16,1,STEP,423340586200,423343518200,2932000,-1
17,1,STEP,423343656900,423346324500,2667600,-1
18,1,STEP,423346378400,423348711500,2333100,-1
19,1,STEP,423348770400,423351193600,2423200,-1
20,1,STEP,423351270400,423353928900,2658500,-1
21,1,STEP,423354011600,423356796500,2784900,-1
22,1,STEP,423356859200,423359443600,2584400,-1
23,1,STEP,423359500100,423362022000,2521900,-1
24,1,STEP,423362084100,423364921600,2837500,-1
25,1,STEP,423365023600,423367465100,2441500,-1
26,1,STEP,423367515800,423369872100,2356300,-1
27,1,STEP,423369939100,423372370800,2431700,-1
28,1,STEP,423372431500,423374688000,2256500,-1
29,1,STEP,423374745100,423377370500,2625400,-1
30,1,STEP,423377484700,423380160300,2675600,-1
31,1,STEP,423380211500,423382797000,2585500,-1
32,1,STEP,423382871600,423385673100,2801500,-1
33,1,STEP,423385784100,423388207500,2423400,-1
34,1,STEP,423388254900,423390629200,2374300,-1
35,1,STEP,423390693800,423393208200,2514400,-1
36,1,STEP,423393275400,423395622800,2347400,-1
37,1,STEP,423395685000,423398203700,2518700,-1
38,1,STEP,423398316200,423400794800,2478600,-1
39,1,STEP,423400874900,423403410500,2535600,-1
40,1,STEP,423403482700,423406178900,2696200,-1
41,1,STEP,423406268000,423408771200,2503200,-1
42,1,STEP,423408821900,423411535800,2713900,-1
43,1,STEP,423411593400,423414046800,2453400,-1
44,1,STEP,423414094400,423416488500,2394100,-1
45,1,STEP,423416551400,423419180300,2628900,-1
46,1,STEP,423419276700,423421484400,2207700,-1
47,1,STEP,423421536600,423424016300,2479700,-1
48,1,STEP,423424075200,423426490500,2415300,-1
49,1,STEP,423426564700,423428691900,2127200,-1
50,1,STEP,423428737900,423431077100,2339200,-1
51,1,STEP,423431139900,423433660400,2520500,-1
52,1,STEP,423433724600,423435991900,2267300,-1
53,1,STEP,423436041000,423438384200,2343200,-1
54,1,STEP,423438422900,423440995100,2572200,-1
55,1,STEP,423441045500,423443345300,2299800,-1
56,1,STEP,423443428100,423445652100,2224000,-1
57,1,STEP,423445698800,423447982000,2283200,-1
58,1,STEP,423448035700,423450479300,2443600,-1
59,1,STEP,423450559000,423452813100,2254100,-1
60,1,STEP,423452867700,423455040300,2172600,-1
61,1,STEP,423455082300,423457247300,2165000,-1
62,1,STEP,423457285000,423459747000,2462000,-1
63,1,STEP,423459812900,423462291900,2479000,-1
64,1,STEP,423462362000,423464994900,2632900,-1
65,1,STEP,423465057700,423467402300,2344600,-1
66,1,STEP,423467456800,423469762500,2305700,-1
67,1,STEP,423469835700,423472053700,2218000,-1
68,1,STEP,423472142400,423474493700,2351300,-1
69,1,STEP,423474545100,423476794800,2249700,-1
70,1,STEP,423476834000,423479459100,2625100,-1
71,1,STEP,423479521500,423482296100,2774600,-1
72,1,STEP,423482378300,423485118300,2740000,-1
73,1,STEP,423485185300,423487677500,2492200,-1
74,1,STEP,423487731400,423490204700,2473300,-1
75,1,STEP,423490262800,423493001400,2738600,-1
76,1,STEP,423493053100,423495421100,2368000,-1
77,1,STEP,423495468600,423497932000,2463400,-1
78,1,STEP,423498012600,423500554400,2541800,-1
79,1,STEP,423500625600,423503316500,2690900,-1
80,1,STEP,423503367600,423505918300,2550700,-1
81,1,STEP,423505964800,423508505400,2540600,-1
82,1,STEP,423508554300,423511332200,2777900,-1
83,1,STEP,423511404800,423514296300,2891500,-1
84,1,STEP,423514350000,423516855200,2505200,-1
85,1,STEP,423516916000,423519187700,2271700,-1
86,1,STEP,423519229800,423521740500,2510700,-1
87,1,STEP,423521789300,423524344800,2555500,-1
88,1,STEP,423524399200,423527321700,2922500,-1
89,1,STEP,423527383500,423530057700,2674200,-1
90,1,STEP,423530157100,423532758600,2601500,-1
91,1,STEP,423532811600,423535302400,2490800,-1
92,1,STEP,423535365000,423537597600,2232600,-1
93,1,STEP,423537686300,423539935300,2249000,-1
94,1,STEP,423539971000,423542260600,2289600,-1
95,1,STEP,423542301700,423544699400,2397700,-1
96,1,STEP,423544775500,423546999200,2223700,-1
97,1,STEP,423547070300,423549343300,2273000,-1
98,1,STEP,423549390300,423551569800,2179500,-1
99,1,STEP,423551607900,423553979400,2371500,-1
100,1,STEP,423554064900,423556782100,2717200,-1
101,1,STEP,423556854600,423559536400,2681800,-1
102,1,STEP,423559585900,423562267200,2681300,-1
103,1,STEP,423562304000,423565070100,2766100,-1
104,1,STEP,423565147100,423567885100,2738000,-1
105,1,STEP,423567977300,423570916500,2939200,-1
106,1,STEP,423570960600,423574061300,3100700,-1
107,1,STEP,423574117500,423577067600,2950100,-1
108,1,STEP,423577133000,423579684500,2551500,-1
109,1,STEP,423579729000,423582042200,2313200,-1
110,1,STEP,423582075700,423584511200,2435500,-1
111,1,STEP,423584568900,423587198100,2629200,-1
112,1,STEP,423587297700,423589648900,2351200,-1
113,1,STEP,423589701800,423592069600,2367800,-1
114,1,STEP,423592133200,423594562700,2429500,-1
115,1,STEP,423594619900,423596870600,2250700,-1
116,1,STEP,423596910200,423599236000,2325800,-1
117,1,STEP,423599325500,423601760000,2434500,-1
118,1,STEP,423601799900,423604122400,2322500,-1
119,1,STEP,423604177000,423606592600,2415600,-1
120,1,STEP,423606638300,423608928300,2290000,-1
121,1,STEP,423608961300,423611511900,2550600,-1
122,1,STEP,423611564100,423614174600,2610500,-1
123,1,STEP,423614245900,423616791800,2545900,-1
124,1,STEP,423616843400,423619574600,2731200,-1
125,1,STEP,423619645100,423622156600,2511500,-1
126,1,STEP,423622208800,423624627800,2419000,-1
127,1,STEP,423624677100,423627431900,2754800,-1
128,1,STEP,423627483900,423630232600,2748700,-1
129,1,STEP,423630303500,423632742700,2439200,-1
130,1,STEP,423632803600,423635105900,2302300,-1
131,1,STEP,423635145000,423637675600,2530600,-1
132,1,STEP,423637759800,423640260300,2500500,-1
133,1,STEP,423640314200,423642719000,2404800,-1
134,1,STEP,423642766600,423645191300,2424700,-1
135,1,STEP,423645246700,423647623100,2376400,-1
136,1,STEP,423647681900,423649880100,2198200,-1
137,1,STEP,423649953800,423651994500,2040700,-1
138,1,STEP,423652054900,423653963800,1908900,-1
139,1,STEP,423654003000,423656115700,2112700,-1
140,1,STEP,423656164300,423658494900,2330600,-1
141,1,STEP,423658573400,423660844900,2271500,-1
142,1,STEP,423660968300,423662839000,1870700,-1
143,1,STEP,423662886900,423664645600,1758700,-1
144,1,STEP,423664684400,423666438400,1754000,-1
145,1,STEP,423666484200,423668512100,2027900,-1
146,1,STEP,423668558600,423670548600,1990000,-1
147,1,STEP,423670609000,423672922600,2313600,-1
148,1,STEP,423672970800,423675247200,2276400,-1
149,1,STEP,423675313000,423677193500,1880500,-1
150,1,STEP,423677227000,423679028300,1801300,-1
151,1,STEP,423679058600,423681021600,1963000,-1
152,1,STEP,423681072600,423683118700,2046100,-1
153,1,STEP,423683186600,423685071100,1884500,-1
154,1,STEP,423685124900,423686916000,1791100,-1
155,1,STEP,423686970100,423688794600,1824500,-1
156,1,STEP,423688842500,423691047900,2205400,-1
157,1,STEP,423691137100,423693213800,2076700,-1
158,1,STEP,423693266300,423695729200,2462900,-1
159,1,STEP,423695785100,423697614000,1828900,-1
160,1,STEP,423697650500,423699470400,1819900,-1
161,1,STEP,423699504000,423701337000,1833000,-1
162,1,STEP,423701369800,423703508700,2138900,-1
163,1,STEP,423703552700,423705691600,2138900,-1
164,1,STEP,423705747000,423707729100,1982100,-1
165,1,STEP,423707804800,423709860700,2055900,-1
166,1,STEP,423709895700,423711881200,1985500,-1
167,1,STEP,423711915500,423713867700,1952200,-1
168,1,STEP,423713902600,423716001900,2099300,-1
169,1,STEP,423716038800,423717996400,1957600,-1
170,1,STEP,423718029000,423720344800,2315800,-1
171,1,STEP,423720425500,423723034900,2609400,-1
172,1,STEP,423723114500,423725707800,2593300,-1
173,1,STEP,423725759900,423727900300,2140400,-1
174,1,STEP,423727952000,423730034000,2082000,-1
175,1,STEP,423730100700,423732477900,2377200,-1
176,1,STEP,423732535300,423734809200,2273900,-1
177,1,STEP,423734936000,423737021400,2085400,-1
178,1,STEP,423737104800,423739495900,2391100,-1
179,1,STEP,423739546000,423742087500,2541500,-1
180,1,STEP,423742154100,423744195200,2041100,-1
181,1,STEP,423744257600,423746112100,1854500,-1
182,1,STEP,423746162400,423747954500,1792100,-1
183,1,STEP,423747988600,423749796900,1808300,-1
184,1,STEP,423749829200,423751982600,2153400,-1
185,1,STEP,423752061100,423754196800,2135700,-1
186,1,STEP,423754250000,423756117100,1867100,-1
187,1,STEP,423756186100,423758083900,1897800,-1
188,1,STEP,423758116900,423759866000,1749100,-1
189,1,STEP,423759907800,423761927600,2019800,-1
190,1,STEP,423762026800,423763829800,1803000,-1
191,1,STEP,423763874000,423765758500,1884500,-1
192,1,STEP,423765806300,423767623700,1817400,-1
193,1,STEP,423767658500,423769770800,2112300,-1
194,1,STEP,423769828800,423771848800,2020000,-1
195,1,STEP,423771908800,423773800600,1891800,-1
196,1,STEP,423773837100,423775686000,1848900,-1
197,1,STEP,423775717900,423777622500,1904600,-1
198,1,STEP,423777653900,423779728600,2074700,-1
199,1,STEP,423779794800,423781641000,1846200,-1
200,1,STEP,423781681500,423783705700,2024200,-1
201,1,STEP,423783751900,423785839200,2087300,-1
202,1,STEP,423785891700,423787930700,2039000,-1
203,1,STEP,423787976800,423790001900,2025100,-1
204,1,STEP,423790046600,423792027000,1980400,-1
205,1,STEP,423792058800,423793965800,1907000,-1
206,1,STEP,423793996800,423795883500,1886700,-1
207,1,STEP,423795927100,423798003300,2076200,-1
208,1,STEP,423798061800,423800337900,2276100,-1
209,1,STEP,423800398400,423802346700,1948300,-1
210,1,STEP,423802389600,423804175000,1785400,-1
211,1,STEP,423804208200,423806305100,2096900,-1
212,1,STEP,423806360300,423808655900,2295600,-1
213,1,STEP,423808707800,423810712900,2005100,-1
214,1,STEP,423810782600,423812976600,2194000,-1
215,1,STEP,423813058400,423814961100,1902700,-1
216,1,STEP,423815008800,423816789300,1780500,-1
217,1,STEP,423816834100,423818661600,1827500,-1
218,1,STEP,423818709000,423820566400,1857400,-1
219,1,STEP,423820612600,423822743400,2130800,-1
220,1,STEP,423822806500,423824743000,1936500,-1
221,1,STEP,423824806800,423826972300,2165500,-1
222,1,STEP,423827079000,423829286600,2207600,-1
223,1,STEP,423829360000,423831250300,1890300,-1
224,1,STEP,423831312100,423833046800,1734700,-1
225,1,STEP,423833079200,423834928000,1848800,-1
226,1,STEP,423834963200,423836870300,1907100,-1
227,1,STEP,423836960700,423838788800,1828100,-1
228,1,STEP,423838840700,423840855500,2014800,-1
229,1,STEP,423840902400,423842718300,1815900,-1
230,1,STEP,423842753900,423844780600,2026700,-1
231,1,STEP,423844816300,423847021300,2205000,-1
232,1,STEP,423847124500,423849624600,2500100,-1
233,1,STEP,423849701300,423851934800,2233500,-1
234,1,STEP,423851981700,423854190700,2209000,-1
235,1,STEP,423854291400,423856255600,1964200,-1
236,1,STEP,423856313000,423858111100,1798100,-1
237,1,STEP,423858148800,423860043300,1894500,-1
238,1,STEP,423860090600,423862034500,1943900,-1
239,1,STEP,423862086100,423863942500,1856400,-1
240,1,STEP,423863985700,423865898800,1913100,-1
241,1,STEP,423865951200,423867788700,1837500,-1
242,1,STEP,423867822100,423869802000,1979900,-1
243,1,STEP,423869857000,423871673600,1816600,-1
244,1,STEP,423871719100,423873796400,2077300,-1
245,1,STEP,423873868600,423875791800,1923200,-1
246,1,STEP,423875847600,423877662400,1814800,-1
247,1,STEP,423877711900,423879710100,1998200,-1
248,1,STEP,423879770700,423882167900,2397200,-1
249,1,STEP,423882237900,423884154100,1916200,-1
250,1,STEP,423884210300,423886120900,1910600,-1
251,1,STEP,423886160200,423888012800,1852600,-1
252,1,STEP,423888046300,423890206000,2159700,-1
253,1,STEP,423890292500,423892557100,2264600,-1
254,1,STEP,423892610800,423894779400,2168600,-1
255,1,STEP,423894830900,423896781300,1950400,-1
256,1,STEP,423896834400,423898807900,1973500,-1
257,1,STEP,423898842200,423901028200,2186000,-1
258,1,STEP,423901070800,423903733500,2662700,-1
259,1,STEP,423903795000,423906514400,2719400,-1
260,1,STEP,423906572100,423908883300,2311200,-1
261,1,STEP,423908924800,423910917200,1992400,-1
262,1,STEP,423910961700,423912962500,2000800,-1
263,1,STEP,423913009300,423914982900,1973600,-1
264,1,STEP,423915055200,423917172100,2116900,-1
265,1,STEP,423917210100,423919109700,1899600,-1
266,1,STEP,423919144500,423921063800,1919300,-1
267,1,STEP,423921104100,423923091800,1987700,-1
268,1,STEP,423923148300,423925110600,1962300,-1
269,1,STEP,423925172800,423927091100,1918300,-1
270,1,STEP,423927134200,423928958200,1824000,-1
271,1,STEP,423928992900,423930982300,1989400,-1
272,1,STEP,423931020800,423933165400,2144600,-1
273,1,STEP,423933211100,423935402600,2191500,-1
274,1,STEP,423935478600,423937801100,2322500,-1
275,1,STEP,423937907200,423940628400,2721200,-1
276,1,STEP,423940687100,423943002100,2315000,-1
277,1,STEP,423943041200,423945392900,2351700,-1
278,1,STEP,423945482500,423947509500,2027000,-1
279,1,STEP,423947562100,423949398600,1836500,-1
280,1,STEP,423949439200,423951234100,1794900,-1
281,1,STEP,423951269300,423953436900,2167600,-1
282,1,STEP,423953498100,423955439800,1941700,-1
283,1,STEP,423955492400,423957462000,1969600,-1
284,1,STEP,423957507200,423959432300,1925100,-1
285,1,STEP,423959470000,423961541900,2071900,-1
286,1,STEP,423961599500,423963770000,2170500,-1
287,1,STEP,423963823000,423965844300,2021300,-1
288,1,STEP,423965891800,423967769100,1877300,-1
289,1,STEP,423967806600,423970020500,2213900,-1
290,1,STEP,423970092000,423972082100,1990100,-1
291,1,STEP,423972130300,423974022300,1892000,-1
292,1,STEP,423974067400,423975928300,1860900,-1
293,1,STEP,423975963900,423977929200,1965300,-1
294,1,STEP,423977992700,423980050100,2057400,-1
295,1,STEP,423980112500,423982055900,1943400,-1
296,1,STEP,423982096400,423983903300,1806900,-1
297,1,STEP,423983936500,423986019200,2082700,-1
298,1,STEP,423986063700,423988186500,2122800,-1
299,1,STEP,423988256700,423990035000,1778300,-1
300,1,STEP,423990075100,423991864900,1789800,-1
301,1,STEP,423991905300,423993795400,1890100,-1
302,1,STEP,423993827500,423995859000,2031500,-1
303,1,STEP,423995921400,423998020800,2099400,-1
304,1,STEP,423998075300,424000392900,2317600,-1
305,1,STEP,424000442400,424002834500,2392100,-1
306,1,STEP,424002886900,424004861300,1974400,-1
307,1,STEP,424004906300,424006858900,1952600,-1
308,1,STEP,424006902400,424008947500,2045100,-1
309,1,STEP,424008983400,424011027600,2044200,-1
310,1,STEP,424011084400,424012971700,1887300,-1
311,1,STEP,424013018400,424014947000,1928600,-1
312,1,STEP,424015002500,424016838500,1836000,-1
313,1,STEP,424016888600,424018701300,1812700,-1
314,1,STEP,424018744500,424020597200,1852700,-1
315,1,STEP,424020647900,424022600000,1952100,-1
316,1,STEP,424022649300,424024573700,1924400,-1
317,1,STEP,424024616100,424026643600,2027500,-1
318,1,STEP,424026695300,424028735600,2040300,-1
319,1,STEP,424028820900,424030988800,2167900,-1
320,1,STEP,424031037000,424033247300,2210300,-1
321,1,STEP,424033299200,424035653700,2354500,-1
322,1,STEP,424035715900,424038203400,2487500,-1
323,1,STEP,424038265400,424040345900,2080500,-1
324,1,STEP,424040432200,424042455100,2022900,-1
325,1,STEP,424042496400,424044347900,1851500,-1
326,1,STEP,424044385700,424046386100,2000400,-1
327,1,STEP,424046462100,424048559100,2097000,-1
328,1,STEP,424048624100,424050681600,2057500,-1
329,1,STEP,424050738200,424052865200,2127000,-1
330,1,STEP,424052911700,424055133700,2222000,-1
331,1,STEP,424055185600,424057432800,2247200,-1
332,1,STEP,424057521700,424059615100,2093400,-1
333,1,STEP,424059674300,424061670400,1996100,-1
334,1,STEP,424061722800,424063645700,1922900,-1
335,1,STEP,424063689400,424065920600,2231200,-1
336,1,STEP,424065981700,424068372900,2391200,-1
337,1,STEP,424068433900,424070754500,2320600,-1
338,1,STEP,424070811600,424073059700,2248100,-1
339,1,STEP,424073119000,424075409000,2290000,-1
340,1,STEP,424075520400,424077998900,2478500,-1
341,1,STEP,424078076400,424080526600,2450200,-1
342,1,STEP,424080621300,424083268200,2646900,-1
343,1,STEP,424083309000,424085843300,2534300,-1
344,1,STEP,424085912100,424088592300,2680200,-1
345,1,STEP,424088651300,424090969900,2318600,-1
346,1,STEP,424091036000,424093245700,2209700,-1
347,1,STEP,424093290400,424095454100,2163700,-1
348,1,STEP,424095515700,424097870300,2354600,-1
349,1,STEP,424098039300,424100634000,2594700,-1
350,1,STEP,424100697800,424102755300,2057500,-1
351,1,STEP,424102826500,424105072500,2246000,-1
352,1,STEP,424105151300,424107530300,2379000,-1
353,1,STEP,424107613600,424109678800,2065200,-1
354,1,STEP,424109800800,424112157900,2357100,-1
355,1,STEP,424112257500,424114840500,2583000,-1
356,1,STEP,424114913000,424117383700,2470700,-1
357,1,STEP,424117453800,424119832300,2378500,-1
358,1,STEP,424119883500,424122022900,2139400,-1
359,1,STEP,424122060700,424124543900,2483200,-1
360,1,STEP,424124592500,424127078300,2485800,-1
361,1,STEP,424127151500,424129467500,2316000,-1
362,1,STEP,424129536300,424131448700,1912400,-1
363,1,STEP,424131500200,424133805500,2305300,-1
364,1,STEP,424133870500,424136021600,2151100,-1
365,1,STEP,424136157400,424138398700,2241300,-1
366,1,STEP,424138457700,424140845300,2387600,-1
367,1,STEP,424140904100,424143244100,2340000,-1
368,1,STEP,424143305900,424146036800,2730900,-1
369,1,STEP,424146111000,424148636600,2525600,-1
370,1,STEP,424148727600,424151142700,2415100,-1
371,1,STEP,424151180100,424153387300,2207200,-1
372,1,STEP,424153428900,424156127800,2698900,-1
373,1,STEP,424156234700,424158511600,2276900,-1
374,1,STEP,424158559500,424160507400,1947900,-1
375,1,STEP,424160560200,424162948300,2388100,-1
376,1,STEP,424163016700,424165286400,2269700,-1
377,1,STEP,424165380600,424167395600,2015000,-1
378,1,STEP,424167462200,424169713500,2251300,-1
379,1,STEP,424169768200,424171756700,1988500,-1
380,1,STEP,424171827900,424174187000,2359100,-1
381,1,STEP,424174306700,424176994200,2687500,-1
382,1,STEP,424177128300,424179513900,2385600,-1
383,1,STEP,424179552200,424181607300,2055100,-1
384,1,STEP,424181669300,424183773400,2104100,-1
385,1,STEP,424183852900,424185970100,2117200,-1
386,1,STEP,424186061800,424188470900,2409100,-1
387,1,STEP,424188522100,424190813100,2291000,-1
388,1,STEP,424190873000,424192975600,2102600,-1
389,1,STEP,424193046800,424195233100,2186300,-1
390,1,STEP,424195269400,424197404800,2135400,-1
391,1,STEP,424197480300,424199853600,2373300,-1
392,1,STEP,424199908800,424202078900,2170100,-1
393,1,STEP,424202118200,424204339100,2220900,-1
394,1,STEP,424204389800,424206441500,2051700,-1
395,1,STEP,424206503000,424208367300,1864300,-1
396,1,STEP,424208499900,424210461600,1961700,-1
397,1,STEP,424210496900,424212506500,2009600,-1
398,1,STEP,424212549600,424214851800,2302200,-1
399,1,STEP,424214898300,424217260800,2362500,-1
400,1,STEP,424217344900,424219980000,2635100,-1
401,1,STEP,424220021100,424222415200,2394100,-1
402,1,STEP,424222468400,424224616300,2147900,-1
403,1,STEP,424224658700,424226778300,2119600,-1
404,1,STEP,424226845200,424228920600,2075400,-1
405,1,STEP,424228972000,424230987500,2015500,-1
406,1,STEP,424231022900,424233167400,2144500,-1
407,1,STEP,424233200300,424235319200,2118900,-1
408,1,STEP,424235352100,424237181100,1829000,-1
409,1,STEP,424237216200,424239310400,2094200,-1
410,1,STEP,424239353300,424241162100,1808800,-1
411,1,STEP,424241191600,424243019900,1828300,-1
412,1,STEP,424243048100,424244965100,1917000,-1
413,1,STEP,424245015600,424246830200,1814600,-1
414,1,STEP,424246862100,424248693000,1830900,-1
415,1,STEP,424248724300,424250595900,1871600,-1
416,1,STEP,424250630400,424252452800,1822400,-1
417,1,STEP,424252483500,424254333200,1849700,-1
418,1,STEP,424254369900,424256197500,1827600,-1
419,1,STEP,424256229000,424258053500,1824500,-1
420,1,STEP,424258085400,424259886100,1800700,-1
421,1,STEP,424259944400,424261992900,2048500,-1
422,1,STEP,424262057600,424263914200,1856600,-1
423,1,STEP,424263964200,424265891600,1927400,-1
424,1,STEP,424265963000,424268055400,2092400,-1
425,1,STEP,424268109400,424270093600,1984200,-1
426,1,STEP,424270145800,424272055800,1910000,-1
427,1,STEP,424272124500,424274116400,1991900,-1
428,1,STEP,424274169200,424276163800,1994600,-1
429,1,STEP,424276210000,424278235200,2025200,-1
430,1,STEP,424278272000,424280224400,1952400,-1
431,1,STEP,424280260700,424282235300,1974600,-1
432,1,STEP,424282275800,424284168800,1893000,-1
433,1,STEP,424284202000,424286088800,1886800,-1
434,1,STEP,424286125900,424288044900,1919000,-1
435,1,STEP,424288079300,424289968800,1889500,-1
436,1,STEP,424290004700,424292090000,2085300,-1
437,1,STEP,424292130500,424294156700,2026200,-1
438,1,STEP,424294192200,424296237600,2045400,-1
439,1,STEP,424296274000,424298611900,2337900,-1
440,1,STEP,424298645800,424301219800,2574000,-1
441,1,STEP,424301257000,424303392000,2135000,-1
442,1,STEP,424303427100,424305792000,2364900,-1
443,1,STEP,424305843500,424307931500,2088000,-1
444,1,STEP,424307981700,424310259100,2277400,-1
445,1,STEP,424310298900,424312233600,1934700,-1
446,1,STEP,424312273400,424315087700,2814300,-1
447,1,STEP,424315130700,424317117300,1986600,-1
448,1,STEP,424317158900,424319013700,1854800,-1
449,1,STEP,424319048600,424320895600,1847000,-1
450,1,STEP,424320953200,424322809900,1856700,-1
451,1,STEP,424322844900,424324805100,1960200,-1
452,1,STEP,424324838300,424326749700,1911400,-1
453,1,STEP,424326782600,424328607300,1824700,-1
454,1,STEP,424328638400,424330385600,1747200,-1
455,1,STEP,424330415700,424332288800,1873100,-1
456,1,STEP,424332324900,424334216600,1891700,-1
457,1,STEP,424334257300,424336130000,1872700,-1
458,1,STEP,424336167100,424338198800,2031700,-1
459,1,STEP,424338256800,424340332900,2076100,-1
460,1,STEP,424340404800,424342304200,1899400,-1
461,1,STEP,424342341900,424344391500,2049600,-1
462,1,STEP,424344444100,424346588300,2144200,-1
463,1,STEP,424346648500,424348476300,1827800,-1
464,1,STEP,424348571300,424350446400,1875100,-1
465,1,STEP,424350494200,424352363600,1869400,-1
466,1,STEP,424352395400,424354483100,2087700,-1
467,1,STEP,424354553100,424356603700,2050600,-1
468,1,STEP,424356655000,424358506700,1851700,-1
469,1,STEP,424358539000,424360473300,1934300,-1
470,1,STEP,424360506700,424362496700,1990000,-1
471,1,STEP,424362537600,424364331800,1794200,-1
472,1,STEP,424364362800,424366412700,2049900,-1
473,1,STEP,424366465400,424368381400,1916000,-1
474,1,STEP,424368417500,424370362500,1945000,-1
475,1,STEP,424370401800,424372279700,1877900,-1
476,1,STEP,424372310500,424374278300,1967800,-1
477,1,STEP,424374313900,424376393700,2079800,-1
478,1,STEP,424376435700,424378266200,1830500,-1
479,1,STEP,424378298300,424380130700,1832400,-1
480,1,STEP,424380163500,424382585600,2422100,-1
481,1,STEP,424382625000,424384988200,2363200,-1
482,1,STEP,424385021900,424386978600,1956700,-1
483,1,STEP,424387015000,424388880300,1865300,-1
484,1,STEP,424388913200,424390967700,2054500,-1
485,1,STEP,424391009300,424392796600,1787300,-1
486,1,STEP,424392828400,424394657200,1828800,-1
487,1,STEP,424394689700,424396718100,2028400,-1
488,1,STEP,424396775300,424398729100,1953800,-1
489,1,STEP,424398779000,424400987900,2208900,-1
490,1,STEP,424401026900,424402947300,1920400,-1
491,1,STEP,424402982300,424405030700,2048400,-1
492,1,STEP,424405074400,424406900500,1826100,-1
493,1,STEP,424406934400,424408777100,1842700,-1
494,1,STEP,424408809600,424410856600,2047000,-1
495,1,STEP,424410893100,424412916800,2023700,-1
496,1,STEP,424412960400,424414833500,1873100,-1
497,1,STEP,424414866800,424416718200,1851400,-1
498,1,STEP,424416753300,424418852300,2099000,-1
499,1,STEP,424418910700,424420803900,1893200,-1
500,1,STEP,424420838700,424422652100,1813400,-1
501,1,STEP,424422685800,424424622200,1936400,-1
502,1,STEP,424424667900,424426687800,2019900,-1
503,1,STEP,424426740400,424428552400,1812000,-1
504,1,STEP,424428585700,424430476400,1890700,-1
505,1,STEP,424430517200,424432343800,1826600,-1
506,1,STEP,424432388500,424434522400,2133900,-1
507,1,STEP,424434552800,424436362100,1809300,-1
508,1,STEP,424436392100,424438226400,1834300,-1
509,1,STEP,424438265800,424440172100,1906300,-1
510,1,STEP,424440227900,424442468300,2240400,-1
511,1,STEP,424442560500,424444817900,2257400,-1
512,1,STEP,424444882100,424446837800,1955700,-1
513,1,STEP,424446878400,424448789600,1911200,-1
514,1,STEP,424448819300,424450634400,1815100,-1
515,1,STEP,424450663300,424452649200,1985900,-1
516,1,STEP,424452693000,424454508300,1815300,-1
517,1,STEP,424454538700,424456344700,1806000,-1
518,1,STEP,424456376600,424458172300,1795700,-1
519,1,STEP,424458202100,424460449900,2247800,-1
520,1,STEP,424460514600,424462255900,1741300,-1
521,1,STEP,424462282500,424464014900,1732400,-1
522,1,STEP,424464040400,424466026400,1986000,-1
523,1,STEP,424466066900,424467906000,1839100,-1
524,1,STEP,424467937500,424469710100,1772600,-1
525,1,STEP,424469736800,424471512500,1775700,-1
526,1,STEP,424471540100,424473430100,1890000,-1
527,1,STEP,424473468500,424475386900,1918400,-1
528,1,STEP,424475418600,424477239900,1821300,-1
529,1,STEP,424477268800,424479035000,1766200,-1
530,1,STEP,424479063400,424480970500,1907100,-1
531,1,STEP,424481006000,424482762000,1756000,-1
532,1,STEP,424482790300,424484537000,1746700,-1
533,1,STEP,424484564400,424486426100,1861700,-1
534,1,STEP,424486466800,424488417700,1950900,-1
535,1,STEP,424488453400,424490284800,1831400,-1
536,1,STEP,424490316800,424492116300,1799500,-1
537,1,STEP,424492145100,424494275800,2130700,-1
538,1,STEP,424494311800,424496163200,1851400,-1
539,1,STEP,424496194200,424497963200,1769000,-1
540,1,STEP,424497991600,424499858700,1867100,-1
541,1,STEP,424499887900,424501821800,1933900,-1
542,1,STEP,424501861000,424503649100,1788100,-1
543,1,STEP,424503679000,424505515900,1836900,-1
544,1,STEP,424505553000,424507520900,1967900,-1
545,1,STEP,424507563700,424509600900,2037200,-1
546,1,STEP,424509634600,424511435500,1800900,-1
547,1,STEP,424511470300,424513288700,1818400,-1
548,1,STEP,424513318000,424515339200,2021200,-1
549,1,STEP,424515377100,424517272800,1895700,-1
550,1,STEP,424517306900,424519111000,1804100,-1
551,1,STEP,424519141500,424521591100,2449600,-1
552,1,STEP,424521642700,424524020200,2377500,-1
553,1,STEP,424524053300,424526059300,2006000,-1
554,1,STEP,424526088400,424528137600,2049200,-1
555,1,STEP,424528176000,424530206400,2030400,-1
556,1,STEP,424530248000,424532085500,1837500,-1
557,1,STEP,424532116000,424533907300,1791300,-1
558,1,STEP,424533935300,424535965100,2029800,-1
559,1,STEP,424536000900,424538015100,2014200,-1
560,1,STEP,424538057700,424539867300,1809600,-1
561,1,STEP,424539901300,424541745400,1844100,-1
562,1,STEP,424541787700,424543873300,2085600,-1
563,1,STEP,424543931800,424545870900,1939100,-1
564,1,STEP,424545912200,424547762300,1850100,-1
565,1,STEP,424547799400,424549762900,1963500,-1
566,1,STEP,424549812000,424551774600,1962600,-1
567,1,STEP,424551816900,424553711100,1894200,-1
568,1,STEP,424553754800,424555579800,1825000,-1
569,1,STEP,424555614800,424557686600,2071800,-1
570,1,STEP,424557740100,424559767700,2027600,-1
571,1,STEP,424559812400,424561659700,1847300,-1
572,1,STEP,424561697800,424563688100,1990300,-1
573,1,STEP,424563736900,424565819700,2082800,-1
574,1,STEP,424565865800,424567743100,1877300,-1
575,1,STEP,424567797900,424569791800,1993900,-1
576,1,STEP,424569847100,424571829200,1982100,-1
577,1,STEP,424571878000,424573913800,2035800,-1
578,1,STEP,424573960300,424576275500,2315200,-1
579,1,STEP,424576313200,424578692300,2379100,-1
580,1,STEP,424578743800,424581152000,2408200,-1
581,1,STEP,424581202800,424583732900,2530100,-1
582,1,STEP,424583778100,424586344800,2566700,-1
583,1,STEP,424586401200,424588594900,2193700,-1
584,1,STEP,424588632400,424591017000,2384600,-1
585,1,STEP,424591073900,424593820200,2746300,-1
586,1,STEP,424593870200,424596271000,2400800,-1
587,1,STEP,424596311900,424598632600,2320700,-1
588,1,STEP,424598696100,424601167800,2471700,-1
589,1,STEP,424601214000,424603707500,2493500,-1
590,1,STEP,424603742900,424606160100,2417200,-1
591,1,STEP,424606210500,424607978700,1768200,-1
592,1,STEP,424608016100,424610006100,1990000,-1
593,1,STEP,424610042300,424611840200,1797900,-1
594,1,STEP,424611889500,424613953800,2064300,-1
595,1,STEP,424613994400,424616262100,2267700,-1
596,1,STEP,424616303800,424618431100,2127300,-1
597,1,STEP,424618480000,424620789800,2309800,-1
598,1,STEP,424620840500,424622924700,2084200,-1
599,1,STEP,424622971000,424624927600,1956600,-1
600,1,STEP,424624960200,424627079300,2119100,-1
601,1,STEP,424627137700,424629420600,2282900,-1
602,1,STEP,424629467300,424631681200,2213900,-1
603,1,STEP,424631721500,424633845200,2123700,-1
604,1,STEP,424633897600,424636010700,2113100,-1
605,1,STEP,424636071600,424637861600,1790000,-1
606,1,STEP,424637901100,424639647200,1746100,-1
607,1,STEP,424639695400,424641586600,1891200,-1
608,1,STEP,424641639100,424643407300,1768200,-1
609,1,STEP,424643457500,424645157300,1699800,-1
610,1,STEP,424645187600,424647502700,2315100,-1
611,1,STEP,424647546400,424649279400,1733000,-1
612,1,STEP,424649308700,424650947600,1638900,-1
613,1,STEP,424650978900,424652626800,1647900,-1
614,1,STEP,424652654100,424654354600,1700500,-1
615,1,STEP,424654396700,424656117000,1720300,-1
616,1,STEP,424656156300,424657943800,1787500,-1
617,1,STEP,424657981300,424660349500,2368200,-1
618,1,STEP,424660409100,424662736800,2327700,-1
619,1,STEP,424662773700,424664687900,1914200,-1
620,1,STEP,424664717600,424666582300,1864700,-1
621,1,STEP,424666614900,424668537400,1922500,-1
622,1,STEP,424668581300,424670270800,1689500,-1
623,1,STEP,424670301600,424671937300,1635700,-1
624,1,STEP,424671986000,424673613900,1627900,-1
625,1,STEP,424673646600,424675730300,2083700,-1
626,1,STEP,424675772500,424677965100,2192600,-1
627,1,STEP,424677994600,424680239000,2244400,-1
628,1,STEP,424680318100,424682424400,2106300,-1
629,1,STEP,424682465400,424684616200,2150800,-1
630,1,STEP,424684646400,424686528200,1881800,-1
631,1,STEP,424686575600,424688370900,1795300,-1
632,1,STEP,424688408300,424690321900,1913600,-1
633,1,STEP,424690354900,424692223500,1868600,-1
634,1,STEP,424692254500,424694196600,1942100,-1
635,1,STEP,424694231300,424696112100,1880800,-1
636,1,STEP,424696166900,424697850000,1683100,-1
637,1,STEP,424697884100,424699593400,1709300,-1
638,1,STEP,424699626900,424701370100,1743200,-1
639,1,STEP,424701415600,424703447400,2031800,-1
640,1,STEP,424703500300,424705190300,1690000,-1
641,1,STEP,424705231400,424706917700,1686300,-1
642,1,STEP,424706958000,424708970200,2012200,-1
643,1,STEP,424709008300,424710991800,1983500,-1
644,1,STEP,424711032700,424712745800,1713100,-1
645,1,STEP,424712791400,424714593300,1801900,-1
646,1,STEP,424714635400,424716608900,1973500,-1
647,1,STEP,424716670800,424719043600,2372800,-1
648,1,STEP,424719077900,424721477800,2399900,-1
649,1,STEP,424721515200,424723770900,2255700,-1
650,1,STEP,424723820300,424726057100,2236800,-1
651,1,STEP,424726094000,424728216600,2122600,-1
652,1,STEP,424728252400,424730315400,2063000,-1
653,1,STEP,424730378900,424732673300,2294400,-1
654,1,STEP,424732714700,424734906200,2191500,-1
655,1,STEP,424734939300,424737018200,2078900,-1
656,1,STEP,424737073700,424738967800,1894100,-1
657,1,STEP,424739005600,424740977600,1972000,-1
658,1,STEP,424741010900,424742967200,1956300,-1
659,1,STEP,424743000900,424744981700,1980800,-1
660,1,STEP,424745028200,424746881400,1853200,-1
661,1,STEP,424746939800,424748933400,1993600,-1
662,1,STEP,424748977900,424750916000,1938100,-1
663,1,STEP,424750976500,424753212700,2236200,-1
664,1,STEP,424753248400,424755628300,2379900,-1
665,1,STEP,424755672000,424757870900,2198900,-1
666,1,STEP,424757929500,424760108000,2178500,-1
667,1,STEP,424760149200,424762310300,2161100,-1
668,1,STEP,424762370600,424764482200,2111600,-1
669,1,STEP,424764549200,424766595400,2046200,-1
670,1,STEP,424766639900,424768515800,1875900,-1
671,1,STEP,424768549400,424770441600,1892200,-1
672,1,STEP,424770473800,424772402100,1928300,-1
673,1,STEP,424772453800,424774326300,1872500,-1
674,1,STEP,424774358400,424776265900,1907500,-1
675,1,STEP,424776298900,424778221400,1922500,-1
676,1,STEP,424778282100,424780247900,1965800,-1
677,1,STEP,424780303100,424782213900,1910800,-1
678,1,STEP,424782246200,424784115900,1869700,-1
679,1,STEP,424784146400,424786098600,1952200,-1
680,1,STEP,424786146500,424787939200,1792700,-1
681,1,STEP,424787989900,424789946900,1957000,-1
682,1,STEP,424789981600,424791972200,1990600,-1
683,1,STEP,424792020500,424793949600,1929100,-1
684,1,STEP,424794002500,424795899300,1896800,-1
685,1,STEP,424795975100,424797917900,1942800,-1
686,1,STEP,424797966400,424799927600,1961200,-1
687,1,STEP,424799992700,424801988100,1995400,-1
688,1,STEP,424802036000,424804009700,1973700,-1
689,1,STEP,424804068300,424806127500,2059200,-1
690,1,STEP,424806181300,424808141000,1959700,-1
691,1,STEP,424808185200,424810147600,1962400,-1
692,1,STEP,424810182200,424812123800,1941600,-1
693,1,STEP,424812184100,424814331300,2147200,-1
694,1,STEP,424814387300,424816325500,1938200,-1
695,1,STEP,424816363000,424818277900,1914900,-1
696,1,STEP,424818312700,424820405000,2092300,-1
697,1,STEP,424820487900,424822559500,2071600,-1
698,1,STEP,424822614400,424824562800,1948400,-1
699,1,STEP,424824599400,424826578000,1978600,-1
700,1,STEP,424826615800,424828728900,2113100,-1
701,1,STEP,424828780300,424830702500,1922200,-1
702,1,STEP,424830738500,424832573300,1834800,-1
703,1,STEP,424832608300,424834619000,2010700,-1
704,1,STEP,424834669800,424836638700,1968900,-1
705,1,STEP,424836684700,424838597500,1912800,-1
706,1,STEP,424838634700,424840524400,1889700,-1
707,1,STEP,424840561200,424842566400,2005200,-1
708,1,STEP,424842613500,424844545200,1931700,-1
709,1,STEP,424844583300,424846536900,1953600,-1
710,1,STEP,424846577900,424848725100,2147200,-1
711,1,STEP,424848782700,424850738500,1955800,-1
712,1,STEP,424850800600,424852745900,1945300,-1
713,1,STEP,424852783000,424854800500,2017500,-1
714,1,STEP,424854847200,424857043900,2196700,-1
715,1,STEP,424857090700,424859459700,2369000,-1
716,1,STEP,424859496400,424861629200,2132800,-1
717,1,STEP,424861666700,424863841700,2175000,-1
718,1,STEP,424863887600,424866401700,2514100,-1
719,1,STEP,424866459600,424868884300,2424700,-1
720,1,STEP,424868939000,424871534300,2595300,-1
721,1,STEP,424871582500,424873856700,2274200,-1
722,1,STEP,424873891900,424876366100,2474200,-1
723,1,STEP,424876447400,424878792700,2345300,-1
724,1,STEP,424878828700,424881044000,2215300,-1
725,1,STEP,424881076100,424883590600,2514500,-1
726,1,STEP,424883659800,424885999700,2339900,-1
727,1,STEP,424886037100,424888306700,2269600,-1
728,1,STEP,424888339100,424890390700,2051600,-1
729,1,STEP,424890427900,424892358500,1930600,-1
730,1,STEP,424892390600,424894248400,1857800,-1
731,1,STEP,424894279800,424896155100,1875300,-1
732,1,STEP,424896199200,424898297000,2097800,-1
733,1,STEP,424898347700,424900275000,1927300,-1
734,1,STEP,424900310000,424902210000,1900000,-1
735,1,STEP,424902249500,424904257600,2008100,-1
736,1,STEP,424904305500,424906324000,2018500,-1
737,1,STEP,424906363400,424908287400,1924000,-1
738,1,STEP,424908320100,424910276700,1956600,-1
739,1,STEP,424910311500,424912356700,2045200,-1
740,1,STEP,424912396100,424914359200,1963100,-1
741,1,STEP,424914418000,424916300700,1882700,-1
742,1,STEP,424916344100,424918253000,1908900,-1
743,1,STEP,424918309100,424919951400,1642300,-1
744,1,STEP,424919984700,424921995000,2010300,-1
745,1,STEP,424922044800,424923811000,1766200,-1
746,1,STEP,424923844600,424925599400,1754800,-1
747,1,STEP,424925669800,424927766200,2096400,-1
748,1,STEP,424927811400,424929940800,2129400,-1
749,1,STEP,424929999100,424932271300,2272200,-1
750,1,STEP,424932326400,424934080000,1753600,-1
751,1,STEP,424934131300,424936493500,2362200,-1
752,1,STEP,424936564800,424938709600,2144800,-1
753,1,STEP,424938774400,424940823700,2049300,-1
754,1,STEP,424940866300,424942803700,1937400,-1
755,1,STEP,424942844100,424944754500,1910400,-1
756,1,STEP,424944821800,424946982100,2160300,-1
757,1,STEP,424947037000,424949246700,2209700,-1
758,1,STEP,424949285500,424951646900,2361400,-1
759,1,STEP,424951698100,424953930100,2232000,-1
760,1,STEP,424953973500,424956238100,2264600,-1
761,1,STEP,424956275600,424958413700,2138100,-1
762,1,STEP,424958448400,424960685900,2237500,-1
763,1,STEP,424960740500,424962958800,2218300,-1
764,1,STEP,424962994100,424965173600,2179500,-1
765,1,STEP,424965207700,424967314000,2106300,-1
766,1,STEP,424967355400,424969216900,1861500,-1
767,1,STEP,424969251700,424971322000,2070300,-1
768,1,STEP,424971366400,424973270200,1903800,-1
769,1,STEP,424973316400,424975676300,2359900,-1
770,1,STEP,424975740700,424978207500,2466800,-1
771,1,STEP,424978245600,424980901600,2656000,-1
772,1,STEP,424980966500,424983514200,2547700,-1
773,1,STEP,424983561500,424985874600,2313100,-1
774,1,STEP,424985916500,424988208100,2291600,-1
775,1,STEP,424988260000,424990551900,2291900,-1
776,1,STEP,424990618800,424993012200,2393400,-1
777,1,STEP,424993042900,424995254000,2211100,-1
778,1,STEP,424995292100,424997531600,2239500,-1
779,1,STEP,424997563200,424999479300,1916100,-1
780,1,STEP,424999510000,425001443400,1933400,-1
781,1,STEP,425001481200,425003342300,1861100,-1
782,1,STEP,425003373600,425005249700,1876100,-1
783,1,STEP,425005280600,425007343900,2063300,-1
784,1,STEP,425007389300,425009606800,2217500,-1
785,1,STEP,425009637700,425011398800,1761100,-1
786,1,STEP,425011428100,425013045800,1617700,-1
787,1,STEP,425013074900,425015125500,2050600,-1
788,1,STEP,425015159600,425016778300,1618700,-1
789,1,STEP,425016810200,425018426000,1615800,-1
790,1,STEP,425018456100,425020071900,1615800,-1
791,1,STEP,425020103200,425022022200,1919000,-1
792,1,STEP,425022075600,425023674600,1599000,-1
793,1,STEP,425023705800,425025390500,1684700,-1
794,1,STEP,425025417900,425026989700,1571800,-1
795,1,STEP,425027018900,425028639400,1620500,-1
796,1,STEP,425028675300,425030405900,1730600,-1
797,1,STEP,425030434200,425032029100,1594900,-1
798,1,STEP,425032058100,425033677500,1619400,-1
799,1,STEP,425033706100,425035465600,1759500,-1
800,1,STEP,425035504700,425037223300,1718600,-1
801,1,STEP,425037265600,425038860700,1595100,-1
802,1,STEP,425038891100,425040490200,1599100,-1
803,1,STEP,425040521300,425042186400,1665100,-1
804,1,STEP,425042222700,425043826600,1603900,-1
805,1,STEP,425043866900,425045459200,1592300,-1
806,1,STEP,425045490700,425047070700,1580000,-1
807,1,STEP,425047104000,425048672300,1568300,-1
808,1,STEP,425048705900,425050352500,1646600,-1
809,1,STEP,425050392000,425052639500,2247500,-1
810,1,STEP,425052671600,425054467100,1795500,-1
811,1,STEP,425054500300,425056281900,1781600,-1
812,1,STEP,425056318500,425058582000,2263500,-1
813,1,STEP,425058627200,425060497700,1870500,-1
814,1,STEP,425060533000,425062210200,1677200,-1
815,1,STEP,425062243400,425063996200,1752800,-1
816,1,STEP,425064036400,425065890100,1853700,-1
817,1,STEP,425065925300,425067881400,1956100,-1
818,1,STEP,425067912800,425069878700,1965900,-1
819,1,STEP,425069921200,425071807500,1886300,-1
820,1,STEP,425071844000,425073685400,1841400,-1
821,1,STEP,425073731500,425075431700,1700200,-1
822,1,STEP,425075473900,425077164900,1691000,-1
823,1,STEP,425077207900,425078912900,1705000,-1
824,1,STEP,425078952000,425080900800,1948800,-1
825,1,STEP,425080933000,425083225000,2292000,-1
826,1,STEP,425083257700,425085671100,2413400,-1
827,1,STEP,425085717500,425087987400,2269900,-1
828,1,STEP,425088023400,425089817400,1794000,-1
829,1,STEP,425089851500,425091897100,2045600,-1
830,1,STEP,425091937500,425094222000,2284500,-1
831,1,STEP,425094252900,425096471300,2218400,-1
832,1,STEP,425096504900,425098442500,1937600,-1
833,1,STEP,425098490800,425100489200,1998400,-1
834,1,STEP,425100549100,425102317600,1768500,-1
835,1,STEP,425102354200,425104277600,1923400,-1
836,1,STEP,425104313700,425106541500,2227800,-1
837,1,STEP,425106595200,425108376800,1781600,-1
838,1,STEP,425108409500,425110067100,1657600,-1
839,1,STEP,425110098500,425111912000,1813500,-1
840,1,STEP,425111969100,425113742100,1773000,-1
841,1,STEP,425113782800,425115374900,1592100,-1
842,1,STEP,425115407900,425117137300,1729400,-1
843,1,STEP,425117178000,425118941900,1763900,-1
844,1,STEP,425118991900,425120752000,1760100,-1
845,1,STEP,425120780300,425122317900,1537600,-1
846,1,STEP,425122344500,425124136900,1792400,-1
847,1,STEP,425124163900,425126316900,2153000,-1
848,1,STEP,425126356700,425128709000,2352300,-1
849,1,STEP,425128736000,425130978400,2242400,-1
850,1,STEP,425131006500,425133213700,2207200,-1
851,1,STEP,425133266000,425134852700,1586700,-1
852,1,STEP,425134881200,425136538100,1656900,-1
853,1,STEP,425136578000,425138297100,1719100,-1
854,1,STEP,425138326000,425140464300,2138300,-1
855,1,STEP,425140508000,425142325700,1817700,-1
856,1,STEP,425142355600,425144163000,1807400,-1
857,1,STEP,425144191700,425146203400,2011700,-1
858,1,STEP,425146262400,425148201600,1939200,-1
859,1,STEP,425148264400,425150241600,1977200,-1
860,1,STEP,425150300600,425152066600,1766000,-1
861,1,STEP,425152113100,425154013100,1900000,-1
862,1,STEP,425154076700,425156042800,1966100,-1
863,1,STEP,425156087600,425158257900,2170300,-1
864,1,STEP,425158317500,425160477500,2160000,-1
865,1,STEP,425160516900,425162317800,1800900,-1
866,1,STEP,425162356800,425164052200,1695400,-1
867,1,STEP,425164085800,425165881800,1796000,-1
868,1,STEP,425165919200,425167875800,1956600,-1
869,1,STEP,425167935800,425169750900,1815100,-1
870,1,STEP,425169788400,425171534800,1746400,-1
871,1,STEP,425171570900,425173324800,1753900,-1
872,1,STEP,425173359800,425175221800,1862000,-1
873,1,STEP,425175260600,425177004400,1743800,-1
874,1,STEP,425177044400,425178806700,1762300,-1
875,1,STEP,425178845600,425180593400,1747800,-1
876,1,STEP,425180667100,425182426500,1759400,-1
877,1,STEP,425182464200,425184201800,1737600,-1
878,1,STEP,425184241000,425185948800,1707800,-1
879,1,STEP,425185987600,425187784500,1796900,-1
880,1,STEP,425187823600,425189771500,1947900,-1
881,1,STEP,425189809000,425191527000,1718000,-1
882,1,STEP,425191563600,425193324300,1760700,-1
883,1,STEP,425193362900,425195135300,1772400,-1
884,1,STEP,425195171700,425197024200,1852500,-1
885,1,STEP,425197061900,425198804300,1742400,-1
886,1,STEP,425198840600,425201093400,2252800,-1
887,1,STEP,425201137200,425203075600,1938400,-1
888,1,STEP,425203124900,425204847800,1722900,-1
889,1,STEP,425204890500,425206637100,1746600,-1
890,1,STEP,425206678800,425208467600,1788800,-1
891,1,STEP,425208508100,425210252300,1744200,-1
892,1,STEP,425210298000,425212181400,1883400,-1
893,1,STEP,425212225900,425213997400,1771500,-1
894,1,STEP,425214047400,425215818700,1771300,-1
895,1,STEP,425215867000,425217707800,1840800,-1
896,1,STEP,425217765800,425219718800,1953000,-1
897,1,STEP,425219783000,425221653900,1870900,-1
898,1,STEP,425221710200,425223969700,2259500,-1
899,1,STEP,425224010800,425225917800,1907000,-1
900,1,STEP,425225954600,425227675200,1720600,-1
901,1,STEP,425227710400,425229527800,1817400,-1
902,1,STEP,425229563200,425231265500,1702300,-1
903,1,STEP,425231303200,425232948900,1645700,-1
904,1,STEP,425232984300,425234906900,1922600,-1
905,1,STEP,425234938600,425236817600,1879000,-1
906,1,STEP,425236855000,425238762700,1907700,-1
907,1,STEP,425238800900,425241005000,2204100,-1
908,1,STEP,425241043500,425242829200,1785700,-1
909,1,STEP,425242864800,425244760700,1895900,-1
910,1,STEP,425244798600,425246817500,2018900,-1
911,1,STEP,425246853900,425248585800,1731900,-1
912,1,STEP,425248618300,425250302600,1684300,-1
913,1,STEP,425250334200,425252238300,1904100,-1
914,1,STEP,425252287700,425254025500,1737800,-1
915,1,STEP,425254069700,425255886100,1816400,-1
916,1,STEP,425255932900,425257620300,1687400,-1
917,1,STEP,425257656000,425259429700,1773700,-1
918,1,STEP,425259464900,425261177400,1712500,-1
919,1,STEP,425261213700,425262991900,1778200,-1
920,1,STEP,425263026200,425264913800,1887600,-1
921,1,STEP,425264943800,425266701500,1757700,-1
922,1,STEP,425266735900,425268388700,1652800,-1
923,1,STEP,425268422100,425270020100,1598000,-1
924,1,STEP,425270052000,425271696000,1644000,-1
925,1,STEP,425271731700,425273498300,1766600,-1
926,1,STEP,425273533600,425275235500,1701900,-1
927,1,STEP,425275266500,425277059500,1793000,-1
928,1,STEP,425277093400,425278929200,1835800,-1
929,1,STEP,425278961700,425280682500,1720800,-1
930,1,STEP,425280716000,425282477300,1761300,-1
931,1,STEP,425282518700,425284466200,1947500,-1
932,1,STEP,425284499600,425286675600,2176000,-1
933,1,STEP,425286717900,425288626600,1908700,-1
934,1,STEP,425288662200,425290277200,1615000,-1
935,1,STEP,425290310300,425291951900,1641600,-1
936,1,STEP,425292002700,425293666000,1663300,-1
937,1,STEP,425293700800,425295454800,1754000,-1
938,1,STEP,425295493100,425297321200,1828100,-1
939,1,STEP,425297368400,425299147700,1779300,-1
940,1,STEP,425299182700,425300829700,1647000,-1
941,1,STEP,425300866200,425302507300,1641100,-1
942,1,STEP,425302544600,425304206700,1662100,-1
943,1,STEP,425304241500,425305924300,1682800,-1
944,1,STEP,425305959900,425307541900,1582000,-1
945,1,STEP,425307576500,425309439800,1863300,-1
946,1,STEP,425309505600,425311554400,2048800,-1
947,1,STEP,425311594800,425313356000,1761200,-1
948,1,STEP,425313390800,425315068400,1677600,-1
949,1,STEP,425315097100,425316705100,1608000,-1
950,1,STEP,425316735100,425318345900,1610800,-1
951,1,STEP,425318374300,425320040500,1666200,-1
952,1,STEP,425320067900,425321741700,1673800,-1
953,1,STEP,425321769600,425323572400,1802800,-1
954,1,STEP,425323602500,425325473400,1870900,-1
955,1,STEP,425325511500,425327307600,1796100,-1
956,1,STEP,425327341100,425329086200,1745100,-1
957,1,STEP,425329138800,425330947200,1808400,-1
958,1,STEP,425330992100,425332705400,1713300,-1
959,1,STEP,425332751200,425334754700,2003500,-1
960,1,STEP,425334796200,425336505900,1709700,-1
961,1,STEP,425336538800,425338233800,1695000,-1
962,1,STEP,425338266200,425339881700,1615500,-1
963,1,STEP,425339924700,425341582200,1657500,-1
964,1,STEP,425341612400,425343173800,1561400,-1
965,1,STEP,425343204200,425344841600,1637400,-1
966,1,STEP,425344870000,425346423500,1553500,-1
967,1,STEP,425346453600,425348062800,1609200,-1
968,1,STEP,425348091600,425349710100,1618500,-1
969,1,STEP,425349738400,425351379900,1641500,-1
970,1,STEP,425351408800,425352961000,1552200,-1
971,1,STEP,425352989400,425354604600,1615200,-1
972,1,STEP,425354633000,425356210900,1577900,-1
973,1,STEP,425356252100,425357918800,1666700,-1
974,1,STEP,425357948000,425359609500,1661500,-1
975,1,STEP,425359638400,425361252400,1614000,-1
976,1,STEP,425361281500,425362877400,1595900,-1
977,1,STEP,425362908500,425364545400,1636900,-1
978,1,STEP,425364575600,425366198200,1622600,-1
979,1,STEP,425366228700,425367862600,1633900,-1
980,1,STEP,425367893000,425369673700,1780700,-1
981,1,STEP,425369704300,425371274700,1570400,-1
982,1,STEP,425371303600,425372928200,1624600,-1
983,1,STEP,425372967400,425374609700,1642300,-1
984,1,STEP,425374636800,425376198600,1561800,-1
985,1,STEP,425376228200,425377752400,1524200,-1
986,1,STEP,425377780400,425379328500,1548100,-1
987,1,STEP,425379356600,425381000200,1643600,-1
988,1,STEP,425381029000,425382613600,1584600,-1
989,1,STEP,425382641100,425384228500,1587400,-1
990,1,STEP,425384257000,425385982900,1725900,-1
991,1,STEP,425386018800,425387667900,1649100,-1
992,1,STEP,425387698700,425389312200,1613500,-1
993,1,STEP,425389341000,425390945300,1604300,-1
994,1,STEP,425390975000,425392578100,1603100,-1
995,1,STEP,425392607400,425394196500,1589100,-1
996,1,STEP,425394225800,425395785100,1559300,-1
997,1,STEP,425395814900,425397369000,1554100,-1
998,1,STEP,425397398500,425398947400,1548900,-1
999,1,STEP,425398976900,425400559400,1582500,-1
