Gen,Resource,Stamp,TimeStamp_Start,TimeStamp_End,Duration,Indiv_id
0,1,TransfertToDevice,942549506900,942888611100,339104200,-1
0,1,STEP,943026993700,943046832900,19839200,-1
1,1,STEP,943046938600,943065457900,18519300,-1
2,1,STEP,943065524400,943084316800,18792400,-1
3,1,STEP,943084387100,943105250500,20863400,-1
4,1,STEP,943105307800,943127430100,22122300,-1
5,1,STEP,943127487600,943147128300,19640700,-1
6,1,STEP,943147188100,943164427800,17239700,-1
7,1,STEP,943164487100,943179145300,14658200,-1
8,1,STEP,943179214400,943194213900,14999500,-1
9,1,STEP,943194264600,943209181400,14916800,-1
10,1,STEP,943209232300,943224170100,14937800,-1
11,1,STEP,943224224100,943239532400,15308300,-1
12,1,STEP,943239592800,943254585200,14992400,-1
13,1,STEP,943254639200,943269876700,15237500,-1
14,1,STEP,943269946500,943285160300,15213800,-1
15,1,STEP,943285208200,943300327600,15119400,-1
16,1,STEP,943300380200,943315562800,15182600,-1
17,1,STEP,943315620000,943330682400,15062400,-1
18,1,STEP,943330774500,943345772500,14998000,-1
19,1,STEP,943345830300,943360823500,14993200,-1
20,1,STEP,943360891000,943376306500,15415500,-1
21,1,STEP,943376453200,943392073600,15620400,-1
22,1,STEP,943392149700,943407681100,15531400,-1
23,1,STEP,943407863600,943423214500,15350900,-1
24,1,STEP,943423293300,943439357800,16064500,-1
25,1,STEP,943439430000,943455421200,15991200,-1
26,1,STEP,943455549300,943471521700,15972400,-1
27,1,STEP,943471600200,943487611700,16011500,-1
28,1,STEP,943487666600,943503759000,16092400,-1
29,1,STEP,943503823200,943519385200,15562000,-1
30,1,STEP,943519467200,943535332700,15865500,-1
31,1,STEP,943535394300,943551183400,15789100,-1
32,1,STEP,943551243300,943567526400,16283100,-1
33,1,STEP,943567588600,943583710400,16121800,-1
34,1,STEP,943583768500,943599804500,16036000,-1
35,1,STEP,943599854700,943616364800,16510100,-1
36,1,STEP,943616418600,943632512600,16094000,-1
37,1,STEP,943632563900,943649484400,16920500,-1
38,1,STEP,943649530400,943666566600,17036200,-1
39,1,STEP,943666605800,943683631700,17025900,-1
40,1,STEP,943683675200,943700445300,16770100,-1
41,1,STEP,943700488200,943717105600,16617400,-1
42,1,STEP,943717154000,943734067700,16913700,-1
43,1,STEP,943734146000,943750955600,16809600,-1
44,1,STEP,943751008800,943767881500,16872700,-1
45,1,STEP,943767932200,943784477600,16545400,-1
46,1,STEP,943784530900,943801073800,16542900,-1
47,1,STEP,943801119300,943819030900,17911600,-1
48,1,STEP,943819078000,943837532000,18454000,-1
49,1,STEP,943837596900,943856161200,18564300,-1
50,1,STEP,943856213100,943874529100,18316000,-1
51,1,STEP,943874572100,943893421600,18849500,-1
52,1,STEP,943893481100,943912203300,18722200,-1
53,1,STEP,943912250400,943931227400,18977000,-1
54,1,STEP,943931281000,943949925400,18644400,-1
55,1,STEP,943949977300,943968634700,18657400,-1
56,1,STEP,943968679900,943987110100,18430200,-1
57,1,STEP,943987159400,944005958700,18799300,-1
58,1,STEP,944006012500,944024505000,18492500,-1
59,1,STEP,944024563700,944043383600,18819900,-1
60,1,STEP,944043445800,944062791600,19345800,-1
61,1,STEP,944062837500,944082315000,19477500,-1
62,1,STEP,944082358900,944102146700,19787800,-1
63,1,STEP,944102187400,944121751800,19564400,-1
64,1,STEP,944121801400,944141430700,19629300,-1
65,1,STEP,944141487500,944161690200,20202700,-1
66,1,STEP,944161748800,944184842500,23093700,-1
67,1,STEP,944184896800,944205327800,20431000,-1
68,1,STEP,944205389600,944227095100,21705500,-1
69,1,STEP,944227149000,944248782900,21633900,-1
70,1,STEP,944248828700,944272405000,23576300,-1
71,1,STEP,944272462300,944291839800,19377500,-1
72,1,STEP,944291887600,944310765300,18877700,-1
73,1,STEP,944310827300,944330715900,19888600,-1
74,1,STEP,944330767700,944350332800,19565100,-1
75,1,STEP,944350378500,944370266200,19887700,-1
76,1,STEP,944370311400,944389750400,19439000,-1
77,1,STEP,944389793500,944409269000,19475500,-1
78,1,STEP,944409318100,944428677600,19359500,-1
79,1,STEP,944428722000,944447971200,19249200,-1
80,1,STEP,944448025800,944467247600,19221800,-1
81,1,STEP,944467305400,944487623800,20318400,-1
82,1,STEP,944487676600,944506977000,19300400,-1
83,1,STEP,944507038900,944526532500,19493600,-1
84,1,STEP,944526581500,944546078900,19497400,-1
85,1,STEP,944546127000,944565967600,19840600,-1
86,1,STEP,944566019600,944586355200,20335600,-1
87,1,STEP,944586408900,944606078100,19669200,-1
88,1,STEP,944606132000,944625987800,19855800,-1
89,1,STEP,944626045300,944645721000,19675700,-1
90,1,STEP,944645783000,944664432600,18649600,-1
91,1,STEP,944664535800,944683122200,18586400,-1
92,1,STEP,944683178600,944701474000,18295400,-1
93,1,STEP,944701546200,944719913300,18367100,-1
94,1,STEP,944719974100,944738209300,18235200,-1
95,1,STEP,944738260800,944756998700,18737900,-1
96,1,STEP,944757052200,944775598600,18546400,-1
97,1,STEP,944775658800,944793859500,18200700,-1
98,1,STEP,944793915300,944811830000,17914700,-1
99,1,STEP,944811888400,944830121700,18233300,-1
100,1,STEP,944830179500,944847928900,17749400,-1
101,1,STEP,944847978200,944866097000,18118800,-1
102,1,STEP,944866150400,944884039700,17889300,-1
103,1,STEP,944884094100,944902154300,18060200,-1
104,1,STEP,944902197200,944920444600,18247400,-1
105,1,STEP,944920499600,944938612400,18112800,-1
106,1,STEP,944938659100,944957835300,19176200,-1
107,1,STEP,944957876500,944976580900,18704400,-1
108,1,STEP,944976621300,944995002700,18381400,-1
109,1,STEP,944995056000,945013009400,17953400,-1
110,1,STEP,945013058700,945031383800,18325100,-1
111,1,STEP,945031457600,945049509600,18052000,-1
112,1,STEP,945049567900,945067762400,18194500,-1
113,1,STEP,945067819300,945086494700,18675400,-1
114,1,STEP,945086545600,945104873700,18328100,-1
115,1,STEP,945104939700,945123312200,18372500,-1
116,1,STEP,945123376000,945142690100,19314100,-1
117,1,STEP,945142766600,945161842200,19075600,-1
118,1,STEP,945161899400,945181605300,19705900,-1
119,1,STEP,945181648500,945201064400,19415900,-1
120,1,STEP,945201113000,945220969000,19856000,-1
121,1,STEP,945221009400,945240999400,19990000,-1
122,1,STEP,945241038300,945260959500,19921200,-1
123,1,STEP,945261005900,945280824300,19818400,-1
124,1,STEP,945280869600,945300487000,19617400,-1
125,1,STEP,945300545900,945323841500,23295600,-1
126,1,STEP,945323899800,945345680300,21780500,-1
127,1,STEP,945345740300,945366114200,20373900,-1
128,1,STEP,945366175000,945388709300,22534300,-1
129,1,STEP,945388769300,945410120200,21350900,-1
130,1,STEP,945410178800,945429797700,19618900,-1
131,1,STEP,945429857700,945448743900,18886200,-1
132,1,STEP,945448800300,945469743400,20943100,-1
133,1,STEP,945469803100,945490374100,20571000,-1
134,1,STEP,945490430800,945511793400,21362600,-1
135,1,STEP,945511861200,945534008300,22147100,-1
136,1,STEP,945534068100,945557669100,23601000,-1
137,1,STEP,945557726100,945581225900,23499800,-1
138,1,STEP,945581281200,945607733500,26452300,-1
139,1,STEP,945607791700,945632887900,25096200,-1
140,1,STEP,945632938300,945658905600,25967300,-1
141,1,STEP,945658959000,945684416700,25457700,-1
142,1,STEP,945684468400,945709934000,25465600,-1
143,1,STEP,945710002400,945736122400,26120000,-1
144,1,STEP,945736175600,945761699500,25523900,-1
145,1,STEP,945761751400,945787507100,25755700,-1
146,1,STEP,945787555300,945813716900,26161600,-1
147,1,STEP,945813771800,945841028900,27257100,-1
148,1,STEP,945841078500,945868046800,26968300,-1
149,1,STEP,945868099100,945894143400,26044300,-1
150,1,STEP,945894205200,945919058500,24853300,-1
151,1,STEP,945919111600,945944793000,25681400,-1
152,1,STEP,945944846700,945971055200,26208500,-1
153,1,STEP,945971101900,945997378600,26276700,-1
154,1,STEP,945997438500,946022833400,25394900,-1
155,1,STEP,946022884500,946048285400,25400900,-1
156,1,STEP,946048330000,946073363600,25033600,-1
157,1,STEP,946073415000,946098679300,25264300,-1
158,1,STEP,946098725100,946121923300,23198200,-1
159,1,STEP,946121977800,946146194700,24216900,-1
160,1,STEP,946146244300,946169201100,22956800,-1
161,1,STEP,946169238100,946193058800,23820700,-1
162,1,STEP,946193107200,946218556000,25448800,-1
163,1,STEP,946218598900,946240795400,22196500,-1
164,1,STEP,946240848400,946263726700,22878300,-1
165,1,STEP,946263766000,946286681300,22915300,-1
166,1,STEP,946286722300,946309408600,22686300,-1
167,1,STEP,946309461000,946330514400,21053400,-1
168,1,STEP,946330562100,946351289800,20727700,-1
169,1,STEP,946351352900,946373139100,21786200,-1
170,1,STEP,946373224500,946394406700,21182200,-1
171,1,STEP,946394569000,946415919400,21350400,-1
172,1,STEP,946415990600,946437502300,21511700,-1
173,1,STEP,946437588500,946459372300,21783800,-1
174,1,STEP,946459433700,946480871300,21437600,-1
175,1,STEP,946480940000,946503491000,22551000,-1
176,1,STEP,946503551200,946525621000,22069800,-1
177,1,STEP,946525692600,946546911400,21218800,-1
178,1,STEP,946546990400,946569025700,22035300,-1
179,1,STEP,946569106400,946590047500,20941100,-1
180,1,STEP,946590104400,946611958000,21853600,-1
181,1,STEP,946612024000,946633979900,21955900,-1
182,1,STEP,946634045100,946656675900,22630800,-1
183,1,STEP,946656767000,946678678800,21911800,-1
184,1,STEP,946678748700,946700163200,21414500,-1
185,1,STEP,946700223000,946721094600,20871600,-1
186,1,STEP,946721161200,946741926400,20765200,-1
187,1,STEP,946741985800,946762179700,20193900,-1
188,1,STEP,946762237200,946782056700,19819500,-1
189,1,STEP,946782104100,946802434500,20330400,-1
190,1,STEP,946802474900,946822853900,20379000,-1
191,1,STEP,946822896600,946843075500,20178900,-1
192,1,STEP,946843126600,946863120100,19993500,-1
193,1,STEP,946863173000,946882316300,19143300,-1
194,1,STEP,946882364600,946902220000,19855400,-1
195,1,STEP,946902267300,946922117300,19850000,-1
196,1,STEP,946922180900,946941634100,19453200,-1
197,1,STEP,946941692500,946962389800,20697300,-1
198,1,STEP,946962448000,946983115100,20667100,-1
199,1,STEP,946983169200,947003084500,19915300,-1
200,1,STEP,947003128200,947023432200,20304000,-1
201,1,STEP,947023469700,947043660300,20190600,-1
202,1,STEP,947043703100,947064029800,20326700,-1
203,1,STEP,947064078700,947084653800,20575100,-1
204,1,STEP,947084703800,947104555900,19852100,-1
205,1,STEP,947104591500,947124109900,19518400,-1
206,1,STEP,947124158300,947143625400,19467100,-1
207,1,STEP,947143667800,947163287300,19619500,-1
208,1,STEP,947163335000,947182859100,19524100,-1
209,1,STEP,947182907300,947202330500,19423200,-1
210,1,STEP,947202373200,947222032600,19659400,-1
211,1,STEP,947222080600,947241740000,19659400,-1
212,1,STEP,947241782200,947261708000,19925800,-1
213,1,STEP,947261754300,947281271700,19517400,-1
214,1,STEP,947281339600,947301037700,19698100,-1
215,1,STEP,947301078100,947320481900,19403800,-1
216,1,STEP,947320524600,947341222500,20697900,-1
217,1,STEP,947341272400,947360417600,19145200,-1
218,1,STEP,947360456000,947380478100,20022100,-1
219,1,STEP,947380530600,947400382600,19852000,-1
220,1,STEP,947400427100,947419912300,19485200,-1
221,1,STEP,947419955500,947439813300,19857800,-1
222,1,STEP,947439866900,947459443600,19576700,-1
223,1,STEP,947459489800,947479704100,20214300,-1
224,1,STEP,947479750600,947500627300,20876700,-1
225,1,STEP,947500680700,947522263100,21582400,-1
226,1,STEP,947522305000,947543976100,21671100,-1
227,1,STEP,947544019700,947565246900,21227200,-1
228,1,STEP,947565285800,947587011700,21725900,-1
229,1,STEP,947587069100,947608806500,21737400,-1
230,1,STEP,947608860600,947629436800,20576200,-1
231,1,STEP,947629501400,947651106200,21604800,-1
232,1,STEP,947651163000,947673548200,22385200,-1
233,1,STEP,947673596200,947694861800,21265600,-1
234,1,STEP,947694913700,947716627400,21713700,-1
235,1,STEP,947716671200,947737954400,21283200,-1
236,1,STEP,947737998700,947759688900,21690200,-1
237,1,STEP,947759729300,947781372900,21643600,-1
238,1,STEP,947781414100,947802561200,21147100,-1
239,1,STEP,947802615900,947824861900,22246000,-1
240,1,STEP,947824905600,947846395300,21489700,-1
241,1,STEP,947846430600,947867955900,21525300,-1
242,1,STEP,947867989600,947890510000,22520400,-1
243,1,STEP,947890563800,947912538100,21974300,-1
244,1,STEP,947912603200,947933768300,21165100,-1
245,1,STEP,947933821000,947955035700,21214700,-1
246,1,STEP,947955092900,947976308500,21215600,-1
247,1,STEP,947976362600,947998041300,21678700,-1
248,1,STEP,947998095500,948019127100,21031600,-1
249,1,STEP,948019175000,948040181900,21006900,-1
250,1,STEP,948040221400,948062222700,22001300,-1
251,1,STEP,948062272700,948083985600,21712900,-1
252,1,STEP,948084024000,948105219900,21195900,-1
253,1,STEP,948105271500,948127378000,22106500,-1
254,1,STEP,948127426600,948149345400,21918800,-1
255,1,STEP,948149382100,948171310300,21928200,-1
256,1,STEP,948171361700,948193238200,21876500,-1
257,1,STEP,948193284100,948214917300,21633200,-1
258,1,STEP,948214964400,948237285300,22320900,-1
259,1,STEP,948237333300,948260169100,22835800,-1
260,1,STEP,948260213900,948282408000,22194100,-1
261,1,STEP,948282452500,948304069000,21616500,-1
262,1,STEP,948304113300,948325950000,21836700,-1
263,1,STEP,948325998700,948347871900,21873200,-1
264,1,STEP,948347913600,948369414800,21501200,-1
265,1,STEP,948369451400,948391361000,21909600,-1
266,1,STEP,948391408600,948413237800,21829200,-1
267,1,STEP,948413284800,948434437800,21153000,-1
268,1,STEP,948434494700,948456482900,21988200,-1
269,1,STEP,948456525500,948479009200,22483700,-1
270,1,STEP,948479047500,948500852100,21804600,-1
271,1,STEP,948500891400,948521607700,20716300,-1
272,1,STEP,948521652300,948543255300,21603000,-1
273,1,STEP,948543307000,948564269800,20962800,-1
274,1,STEP,948564308000,948584457200,20149200,-1
275,1,STEP,948584507100,948603815100,19308000,-1
276,1,STEP,948603858500,948623787100,19928600,-1
277,1,STEP,948623836900,948643784800,19947900,-1
278,1,STEP,948643847800,948663579100,19731300,-1
279,1,STEP,948663647300,948683435600,19788300,-1
280,1,STEP,948683518800,948703503100,19984300,-1
281,1,STEP,948703553200,948723099700,19546500,-1
282,1,STEP,948723144400,948742695300,19550900,-1
283,1,STEP,948742751500,948763035700,20284200,-1
284,1,STEP,948763086200,948783213600,20127400,-1
285,1,STEP,948783266300,948804063300,20797000,-1
286,1,STEP,948804100700,948824258500,20157800,-1
287,1,STEP,948824318900,948844794000,20475100,-1
288,1,STEP,948844848800,948865973900,21125100,-1
289,1,STEP,948866015000,948885940000,19925000,-1
290,1,STEP,948885994900,948906315200,20320300,-1
291,1,STEP,948906376300,948926509100,20132800,-1
292,1,STEP,948926561500,948947321300,20759800,-1
293,1,STEP,948947368700,948967793600,20424900,-1
294,1,STEP,948967846300,948988075100,20228800,-1
295,1,STEP,948988123300,949008563400,20440100,-1
296,1,STEP,949008603500,949028858700,20255200,-1
297,1,STEP,949028919800,949049614200,20694400,-1
298,1,STEP,949049666300,949069983700,20317400,-1
299,1,STEP,949070035300,949090234400,20199100,-1
300,1,STEP,949090273600,949110263700,19990100,-1
301,1,STEP,949110303700,949130621000,20317300,-1
302,1,STEP,949130680200,949150858900,20178700,-1
303,1,STEP,949150894800,949171194300,20299500,-1
304,1,STEP,949171233700,949191691700,20458000,-1
305,1,STEP,949191742200,949212238400,20496200,-1
306,1,STEP,949212280100,949232382600,20102500,-1
307,1,STEP,949232421600,949252003800,19582200,-1
308,1,STEP,949252040900,949272552300,20511400,-1
309,1,STEP,949272595200,949292538300,19943100,-1
310,1,STEP,949292584400,949313198500,20614100,-1
311,1,STEP,949313237700,949333574300,20336600,-1
312,1,STEP,949333628400,949353228500,19600100,-1
313,1,STEP,949353275300,949373374800,20099500,-1
314,1,STEP,949373418000,949394067500,20649500,-1
315,1,STEP,949394111800,949413743200,19631400,-1
316,1,STEP,949413790500,949433943800,20153300,-1
317,1,STEP,949433987200,949454070900,20083700,-1
318,1,STEP,949454110400,949475048300,20937900,-1
319,1,STEP,949475087900,949495824400,20736500,-1
320,1,STEP,949495870700,949515431800,19561100,-1
321,1,STEP,949515470300,949535630900,20160600,-1
322,1,STEP,949535672800,949555859300,20186500,-1
323,1,STEP,949555902400,949575578800,19676400,-1
324,1,STEP,949575629900,949595361200,19731300,-1
325,1,STEP,949595411800,949615197900,19786100,-1
326,1,STEP,949615237600,949635112200,19874600,-1
327,1,STEP,949635155100,949654547700,19392600,-1
328,1,STEP,949654592200,949675746600,21154400,-1
329,1,STEP,949675789200,949695511700,19722500,-1
330,1,STEP,949695568900,949715516800,19947900,-1
331,1,STEP,949715559900,949736557500,20997600,-1
332,1,STEP,949736614600,949758804400,22189800,-1
333,1,STEP,949758853000,949780266000,21413000,-1
334,1,STEP,949780316000,949802346200,22030200,-1
335,1,STEP,949802403600,949823658300,21254700,-1
336,1,STEP,949823706800,949844912500,21205700,-1
337,1,STEP,949844958600,949866826700,21868100,-1
338,1,STEP,949866868900,949888793400,21924500,-1
339,1,STEP,949888843800,949911231300,22387500,-1
340,1,STEP,949911288700,949933124600,21835900,-1
341,1,STEP,949933171800,949955482700,22310900,-1
342,1,STEP,949955529100,949977714700,22185600,-1
343,1,STEP,949977759900,950000068700,22308800,-1
344,1,STEP,950000115400,950022134500,22019100,-1
345,1,STEP,950022194300,950043696500,21502200,-1
346,1,STEP,950043740300,950066368600,22628300,-1
347,1,STEP,950066419400,950087824600,21405200,-1
348,1,STEP,950087883200,950110141800,22258600,-1
349,1,STEP,950110198200,950131880600,21682400,-1
350,1,STEP,950131931700,950154241400,22309700,-1
351,1,STEP,950154294400,950177112700,22818300,-1
352,1,STEP,950177157400,950198657700,21500300,-1
353,1,STEP,950198695800,950220008100,21312300,-1
354,1,STEP,950220062500,950241618700,21556200,-1
355,1,STEP,950241668300,950263791400,22123100,-1
356,1,STEP,950263842700,950285588800,21746100,-1
357,1,STEP,950285628900,950307101400,21472500,-1
358,1,STEP,950307140700,950328756200,21615500,-1
359,1,STEP,950328810000,950350228400,21418400,-1
360,1,STEP,950350271200,950371743900,21472700,-1
361,1,STEP,950371785800,950392995800,21210000,-1
362,1,STEP,950393040500,950414383600,21343100,-1
363,1,STEP,950414428200,950436585600,22157400,-1
364,1,STEP,950436639800,950458656200,22016400,-1
365,1,STEP,950458703400,950480763600,22060200,-1
366,1,STEP,950480801600,950504305200,23503600,-1
367,1,STEP,950504345300,950526533700,22188400,-1
368,1,STEP,950526595100,950548735400,22140300,-1
369,1,STEP,950548782500,950571276500,22494000,-1
370,1,STEP,950571326400,950593784000,22457600,-1
371,1,STEP,950593831500,950615283200,21451700,-1
372,1,STEP,950615326500,950637331400,22004900,-1
373,1,STEP,950637379200,950659598700,22219500,-1
374,1,STEP,950659648100,950681573700,21925600,-1
375,1,STEP,950681622700,950703055100,21432400,-1
376,1,STEP,950703114700,950725601800,22487100,-1
377,1,STEP,950725654200,950747164200,21510000,-1
378,1,STEP,950747221500,950768874200,21652700,-1
379,1,STEP,950768929800,950790402300,21472500,-1
380,1,STEP,950790493400,950810490200,19996800,-1
381,1,STEP,950810541900,950831355000,20813100,-1
382,1,STEP,950831404100,950851834100,20430000,-1
383,1,STEP,950851882500,950871621500,19739000,-1
384,1,STEP,950871670000,950892135000,20465000,-1
385,1,STEP,950892180300,950913808600,21628300,-1
386,1,STEP,950913857200,950934134400,20277200,-1
387,1,STEP,950934177000,950954032800,19855800,-1
388,1,STEP,950954081500,950974948700,20867200,-1
389,1,STEP,950974990100,950996009500,21019400,-1
390,1,STEP,950996065100,951016016900,19951800,-1
391,1,STEP,951016052000,951036240300,20188300,-1
392,1,STEP,951036288800,951056827600,20538800,-1
393,1,STEP,951056872700,951078407800,21535100,-1
394,1,STEP,951078456500,951099508900,21052400,-1
395,1,STEP,951099549900,951119911100,20361200,-1
396,1,STEP,951119960500,951139737100,19776600,-1
397,1,STEP,951139792200,951160091100,20298900,-1
398,1,STEP,951160146700,951180715200,20568500,-1
399,1,STEP,951180762600,951200531200,19768600,-1
400,1,STEP,951200572300,951221103400,20531100,-1
401,1,STEP,951221148700,951240877000,19728300,-1
402,1,STEP,951240920400,951261941800,21021400,-1
403,1,STEP,951261992500,951281947000,19954500,-1
404,1,STEP,951281990400,951301505400,19515000,-1
405,1,STEP,951301550000,951321727500,20177500,-1
406,1,STEP,951321769400,951342146000,20376600,-1
407,1,STEP,951342192600,951363105400,20912800,-1
408,1,STEP,951363161300,951383549300,20388000,-1
409,1,STEP,951383596500,951403606300,20009800,-1
410,1,STEP,951403645100,951424148700,20503600,-1
411,1,STEP,951424196900,951444636800,20439900,-1
412,1,STEP,951444674700,951464862900,20188200,-1
413,1,STEP,951464903600,951484722700,19819100,-1
414,1,STEP,951484776900,951504701000,19924100,-1
415,1,STEP,951504747100,951524839700,20092600,-1
416,1,STEP,951524898500,951546264300,21365800,-1
417,1,STEP,951546309400,951566593800,20284400,-1
418,1,STEP,951566641700,951586652500,20010800,-1
419,1,STEP,951586704300,951607302800,20598500,-1
420,1,STEP,951607349700,951627276300,19926600,-1
421,1,STEP,951627320400,951648299800,20979400,-1
422,1,STEP,951648340600,951669904200,21563600,-1
423,1,STEP,951669941600,951689599600,19658000,-1
424,1,STEP,951689651200,951710306500,20655300,-1
425,1,STEP,951710363200,951730731200,20368000,-1
426,1,STEP,951730782900,951750456800,19673900,-1
427,1,STEP,951750504900,951770307700,19802800,-1
428,1,STEP,951770364900,951790580400,20215500,-1
429,1,STEP,951790635000,951810433400,19798400,-1
430,1,STEP,951810480300,951831333700,20853400,-1
431,1,STEP,951831390800,951851637900,20247100,-1
432,1,STEP,951851697700,951871611200,19913500,-1
433,1,STEP,951871649900,951892182000,20532100,-1
434,1,STEP,951892225000,951912188900,19963900,-1
435,1,STEP,951912232800,951932534000,20301200,-1
436,1,STEP,951932580600,951952735800,20155200,-1
437,1,STEP,951952774700,951972971100,20196400,-1
438,1,STEP,951973016300,951993600400,20584100,-1
439,1,STEP,951993650900,952014226900,20576000,-1
440,1,STEP,952014283900,952035318300,21034400,-1
441,1,STEP,952035364800,952054892000,19527200,-1
442,1,STEP,952054930600,952075756600,20826000,-1
443,1,STEP,952075793600,952096291400,20497800,-1
444,1,STEP,952096339700,952116664300,20324600,-1
445,1,STEP,952116723000,952138499100,21776100,-1
446,1,STEP,952138553900,952158454600,19900700,-1
447,1,STEP,952158518100,952178466900,19948800,-1
448,1,STEP,952178537100,952199163700,20626600,-1
449,1,STEP,952199221200,952219702400,20481200,-1
450,1,STEP,952219756000,952240088800,20332800,-1
451,1,STEP,952240133000,952260483200,20350200,-1
452,1,STEP,952260526300,952280938100,20411800,-1
453,1,STEP,952280979900,952301934300,20954400,-1
454,1,STEP,952301983800,952322195700,20211900,-1
455,1,STEP,952322248400,952342833600,20585200,-1
456,1,STEP,952342884000,952363156300,20272300,-1
457,1,STEP,952363196800,952383095800,19899000,-1
458,1,STEP,952383141300,952402962400,19821100,-1
459,1,STEP,952403014500,952423538400,20523900,-1
460,1,STEP,952423590100,952443813900,20223800,-1
461,1,STEP,952443856000,952464166500,20310500,-1
462,1,STEP,952464205700,952484515400,20309700,-1
463,1,STEP,952484554100,952505364300,20810200,-1
464,1,STEP,952505400200,952525422700,20022500,-1
465,1,STEP,952525495500,952545723000,20227500,-1
466,1,STEP,952545766100,952566197400,20431300,-1
467,1,STEP,952566232900,952586532100,20299200,-1
468,1,STEP,952586568400,952607393700,20825300,-1
469,1,STEP,952607449100,952628395700,20946600,-1
470,1,STEP,952628457700,952649339400,20881700,-1
471,1,STEP,952649379500,952669878100,20498600,-1
472,1,STEP,952669920400,952689880300,19959900,-1
473,1,STEP,952689923600,952709673200,19749600,-1
474,1,STEP,952709709700,952730200300,20490600,-1
475,1,STEP,952730240200,952751023600,20783400,-1
476,1,STEP,952751070600,952771708100,20637500,-1
477,1,STEP,952771748000,952792091600,20343600,-1
478,1,STEP,952792136900,952811909400,19772500,-1
479,1,STEP,952811953700,952834678000,22724300,-1
480,1,STEP,952834729100,952857138800,22409700,-1
481,1,STEP,952857198200,952879681800,22483600,-1
482,1,STEP,952879744800,952901526200,21781400,-1
483,1,STEP,952901574200,952923015800,21441600,-1
484,1,STEP,952923071900,952945803200,22731300,-1
485,1,STEP,952945855500,952968064500,22209000,-1
486,1,STEP,952968117800,952990324000,22206200,-1
487,1,STEP,952990374700,953012314300,21939600,-1
488,1,STEP,953012367600,953034153500,21785900,-1
489,1,STEP,953034205200,953055601600,21396400,-1
490,1,STEP,953055651200,953076811500,21160300,-1
491,1,STEP,953076859000,953099352400,22493400,-1
492,1,STEP,953099396300,953121098800,21702500,-1
493,1,STEP,953121140900,953142464000,21323100,-1
494,1,STEP,953142506200,953164328400,21822200,-1
495,1,STEP,953164390600,953187077500,22686900,-1
496,1,STEP,953187119500,953209106300,21986800,-1
497,1,STEP,953209154000,953231145500,21991500,-1
498,1,STEP,953231205900,953252620800,21414900,-1
499,1,STEP,953252668100,953274855600,22187500,-1
500,1,STEP,953274913400,953297237800,22324400,-1
501,1,STEP,953297288900,953319845000,22556100,-1
502,1,STEP,953319898500,953341717800,21819300,-1
503,1,STEP,953341759600,953363298600,21539000,-1
504,1,STEP,953363334200,953385737500,22403300,-1
505,1,STEP,953385791500,953407184500,21393000,-1
506,1,STEP,953407227800,953428797000,21569200,-1
507,1,STEP,953428841400,953451362700,22521300,-1
508,1,STEP,953451410300,953473344600,21934300,-1
509,1,STEP,953473394600,953496210400,22815800,-1
510,1,STEP,953496273800,953518087500,21813700,-1
511,1,STEP,953518129700,953540050200,21920500,-1
512,1,STEP,953540094300,953562099600,22005300,-1
513,1,STEP,953562140800,953584579500,22438700,-1
514,1,STEP,953584630000,953606436600,21806600,-1
515,1,STEP,953606483000,953628884400,22401400,-1
516,1,STEP,953628930100,953651338700,22408600,-1
517,1,STEP,953651380700,953674220400,22839700,-1
518,1,STEP,953674260200,953697736400,23476200,-1
519,1,STEP,953697789300,953719004000,21214700,-1
520,1,STEP,953719038700,953741823700,22785000,-1
521,1,STEP,953741861100,953764225100,22364000,-1
522,1,STEP,953764264100,953786296100,22032000,-1
523,1,STEP,953786340300,953808130100,21789800,-1
524,1,STEP,953808183200,953829609800,21426600,-1
525,1,STEP,953829648900,953851665200,22016300,-1
526,1,STEP,953851704500,953874435300,22730800,-1
527,1,STEP,953874475600,953896934000,22458400,-1
528,1,STEP,953896974600,953919229200,22254600,-1
529,1,STEP,953919284900,953940928300,21643400,-1
530,1,STEP,953940997200,953963093700,22096500,-1
531,1,STEP,953963142400,953985254500,22112100,-1
532,1,STEP,953985300600,954007128500,21827900,-1
533,1,STEP,954007177000,954028955900,21778900,-1
534,1,STEP,954029008100,954050903800,21895700,-1
535,1,STEP,954050952100,954072982900,22030800,-1
536,1,STEP,954073020800,954095852700,22831900,-1
537,1,STEP,954095905400,954118866300,22960900,-1
538,1,STEP,954118916800,954141285000,22368200,-1
539,1,STEP,954141328100,954164129600,22801500,-1
540,1,STEP,954164166400,954186339800,22173400,-1
541,1,STEP,954186381200,954208932700,22551500,-1
542,1,STEP,954208969200,954232045000,23075800,-1
543,1,STEP,954232123200,954254295200,22172000,-1
544,1,STEP,954254340400,954277087000,22746600,-1
545,1,STEP,954277146600,954299771300,22624700,-1
546,1,STEP,954299822300,954321671200,21848900,-1
547,1,STEP,954321717200,954344117400,22400200,-1
548,1,STEP,954344171300,954366344800,22173500,-1
549,1,STEP,954366397700,954387807400,21409700,-1
550,1,STEP,954387861800,954409865300,22003500,-1
551,1,STEP,954409905700,954432132700,22227000,-1
552,1,STEP,954432178100,954453563400,21385300,-1
553,1,STEP,954453611600,954475583200,21971600,-1
554,1,STEP,954475665400,954496932300,21266900,-1
555,1,STEP,954497016300,954517891400,20875100,-1
556,1,STEP,954517941300,954540158100,22216800,-1
557,1,STEP,954540206000,954561553700,21347700,-1
558,1,STEP,954561609600,954582599200,20989600,-1
559,1,STEP,954582644200,954604074200,21430000,-1
560,1,STEP,954604121000,954626120700,21999700,-1
561,1,STEP,954626168300,954647202000,21033700,-1
562,1,STEP,954647248000,954667688800,20440800,-1
563,1,STEP,954667736200,954687632900,19896700,-1
564,1,STEP,954687675600,954708619100,20943500,-1
565,1,STEP,954708662400,954729852800,21190400,-1
566,1,STEP,954729888900,954751323400,21434500,-1
567,1,STEP,954751366600,954771915300,20548700,-1
568,1,STEP,954771960500,954792568100,20607600,-1
569,1,STEP,954792609800,954813347100,20737300,-1
570,1,STEP,954813387600,954834316700,20929100,-1
571,1,STEP,954834358900,954855106900,20748000,-1
572,1,STEP,954855146400,954875718700,20572300,-1
573,1,STEP,954875761600,954895948500,20186900,-1
574,1,STEP,954896002200,954916802900,20800700,-1
575,1,STEP,954916875300,954937852900,20977600,-1
576,1,STEP,954937907900,954958626300,20718400,-1
577,1,STEP,954958664700,954980094000,21429300,-1
578,1,STEP,954980166400,955000305200,20138800,-1
579,1,STEP,955000357400,955020854100,20496700,-1
580,1,STEP,955020903400,955041990100,21086700,-1
581,1,STEP,955042038600,955062653800,20615200,-1
582,1,STEP,955062701000,955083769600,21068600,-1
583,1,STEP,955083824500,955103770500,19946000,-1
584,1,STEP,955103815100,955124342400,20527300,-1
585,1,STEP,955124394300,955145819900,21425600,-1
586,1,STEP,955145858200,955165878100,20019900,-1
587,1,STEP,955165921700,955186025000,20103300,-1
588,1,STEP,955186071500,955206369500,20298000,-1
589,1,STEP,955206413800,955227259100,20845300,-1
590,1,STEP,955227304000,955248099600,20795600,-1
591,1,STEP,955248152500,955269536500,21384000,-1
592,1,STEP,955269590200,955290098400,20508200,-1
593,1,STEP,955290138900,955311725100,21586200,-1
594,1,STEP,955311776700,955333016300,21239600,-1
595,1,STEP,955333079000,955353162200,20083200,-1
596,1,STEP,955353214800,955373832000,20617200,-1
597,1,STEP,955373889100,955394456200,20567100,-1
598,1,STEP,955394514700,955415690600,21175900,-1
599,1,STEP,955415741700,955436344900,20603200,-1
600,1,STEP,955436393200,955457107800,20714600,-1
601,1,STEP,955457147700,955478466500,21318800,-1
602,1,STEP,955478508900,955499755300,21246400,-1
603,1,STEP,955499804500,955521936000,22131500,-1
604,1,STEP,955521986900,955542579400,20592500,-1
605,1,STEP,955542621100,955563842500,21221400,-1
606,1,STEP,955563879200,955585245800,21366600,-1
607,1,STEP,955585283800,955606484800,21201000,-1
608,1,STEP,955606527300,955627857800,21330500,-1
609,1,STEP,955627909000,955649424000,21515000,-1
610,1,STEP,955649461000,955669896100,20435100,-1
611,1,STEP,955669938200,955690311500,20373300,-1
612,1,STEP,955690351900,955711098800,20746900,-1
613,1,STEP,955711138600,955731857300,20718700,-1
614,1,STEP,955731913400,955753081800,21168400,-1
615,1,STEP,955753117900,955774285200,21167300,-1
616,1,STEP,955774343800,955794492400,20148600,-1
617,1,STEP,955794531200,955814977000,20445800,-1
618,1,STEP,955815029000,955835519400,20490400,-1
619,1,STEP,955835561400,955856736800,21175400,-1
620,1,STEP,955856779100,955877948500,21169400,-1
621,1,STEP,955877989900,955898665900,20676000,-1
622,1,STEP,955898705800,955920445300,21739500,-1
623,1,STEP,955920496300,955941692400,21196100,-1
624,1,STEP,955941746300,955962600800,20854500,-1
625,1,STEP,955962655000,955982747300,20092300,-1
626,1,STEP,955982791700,956003062900,20271200,-1
627,1,STEP,956003108100,956023574400,20466300,-1
628,1,STEP,956023629700,956044038300,20408600,-1
629,1,STEP,956044093800,956064775100,20681300,-1
630,1,STEP,956064827600,956085422900,20595300,-1
631,1,STEP,956085472500,956105853400,20380900,-1
632,1,STEP,956105896000,956126502800,20606800,-1
633,1,STEP,956126552100,956147508000,20955900,-1
634,1,STEP,956147556400,956168032500,20476100,-1
635,1,STEP,956168069400,956189464500,21395100,-1
636,1,STEP,956189504000,956210384300,20880300,-1
637,1,STEP,956210429400,956231063600,20634200,-1
638,1,STEP,956231103800,956251846000,20742200,-1
639,1,STEP,956251899300,956272608800,20709500,-1
640,1,STEP,956272658400,956293357100,20698700,-1
641,1,STEP,956293404900,956314929200,21524300,-1
642,1,STEP,956314973900,956336235500,21261600,-1
643,1,STEP,956336284400,956357149500,20865100,-1
644,1,STEP,956357199000,956378367600,21168600,-1
645,1,STEP,956378409800,956398169200,19759400,-1
646,1,STEP,956398224600,956419810700,21586100,-1
647,1,STEP,956419862400,956440731900,20869500,-1
648,1,STEP,956440779300,956462367200,21587900,-1
649,1,STEP,956462415800,956483254300,20838500,-1
650,1,STEP,956483301900,956503786700,20484800,-1
651,1,STEP,956503831000,956524283900,20452900,-1
652,1,STEP,956524326400,956546389200,22062800,-1
653,1,STEP,956546441700,956566980100,20538400,-1
654,1,STEP,956567029200,956588177400,21148200,-1
655,1,STEP,956588221100,956608648600,20427500,-1
656,1,STEP,956608690100,956629176200,20486100,-1
657,1,STEP,956629218200,956649878600,20660400,-1
658,1,STEP,956649931000,956671150000,21219000,-1
659,1,STEP,956671200600,956692588200,21387600,-1
660,1,STEP,956692636900,956714069800,21432900,-1
661,1,STEP,956714117600,956734781000,20663400,-1
662,1,STEP,956734822800,956755539900,20717100,-1
663,1,STEP,956755593400,956777207000,21613600,-1
664,1,STEP,956777274900,956797658500,20383600,-1
665,1,STEP,956797716100,956818483000,20766900,-1
666,1,STEP,956818533600,956839777700,21244100,-1
667,1,STEP,956839821500,956860764000,20942500,-1
668,1,STEP,956860813400,956880947600,20134200,-1
669,1,STEP,956880999400,956901825700,20826300,-1
670,1,STEP,956901864000,956922598100,20734100,-1
671,1,STEP,956922645500,956943524200,20878700,-1
672,1,STEP,956943563200,956964343200,20780000,-1
673,1,STEP,956964391800,956985687000,21295200,-1
674,1,STEP,956985728000,957006361800,20633800,-1
675,1,STEP,957006402600,957027027100,20624500,-1
676,1,STEP,957027071600,957047755200,20683600,-1
677,1,STEP,957047795500,957068364100,20568600,-1
678,1,STEP,957068440200,957088816400,20376200,-1
679,1,STEP,957088873600,957109117000,20243400,-1
680,1,STEP,957109175200,957129241400,20066200,-1
681,1,STEP,957129302800,957149570500,20267700,-1
682,1,STEP,957149613700,957170201300,20587600,-1
683,1,STEP,957170242100,957190725400,20483300,-1
684,1,STEP,957190772200,957212537400,21765200,-1
685,1,STEP,957212577600,957233126200,20548600,-1
686,1,STEP,957233164200,957253749400,20585200,-1
687,1,STEP,957253788900,957274532100,20743200,-1
688,1,STEP,957274604900,957295699800,21094900,-1
689,1,STEP,957295748500,957316272400,20523900,-1
690,1,STEP,957316312700,957337478200,21165500,-1
691,1,STEP,957337523800,957358123400,20599600,-1
692,1,STEP,957358167300,957378811900,20644600,-1
693,1,STEP,957378861800,957399209400,20347600,-1
694,1,STEP,957399251700,957419738600,20486900,-1
695,1,STEP,957419785100,957440934600,21149500,-1
696,1,STEP,957441004200,957461758100,20753900,-1
697,1,STEP,957461825800,957482772900,20947100,-1
698,1,STEP,957482820600,957503294400,20473800,-1
699,1,STEP,957503348500,957524779800,21431300,-1
700,1,STEP,957524819800,957545284700,20464900,-1
701,1,STEP,957545324300,957565927100,20602800,-1
702,1,STEP,957565975500,957586772700,20797200,-1
703,1,STEP,957586844000,957607467200,20623200,-1
704,1,STEP,957607514900,957628861300,21346400,-1
705,1,STEP,957628903800,957649458800,20555000,-1
706,1,STEP,957649504600,957670022200,20517600,-1
707,1,STEP,957670065100,957690621300,20556200,-1
708,1,STEP,957690661700,957711815300,21153600,-1
709,1,STEP,957711864500,957732662200,20797700,-1
710,1,STEP,957732712200,957753419200,20707000,-1
711,1,STEP,957753462600,957774175600,20713000,-1
712,1,STEP,957774213300,957795266800,21053500,-1
713,1,STEP,957795310800,957816543400,21232600,-1
714,1,STEP,957816593100,957837308900,20715800,-1
715,1,STEP,957837358200,957858880000,21521800,-1
716,1,STEP,957858941300,957879549400,20608100,-1
717,1,STEP,957879598800,957900905800,21307000,-1
718,1,STEP,957900945800,957922275200,21329400,-1
719,1,STEP,957922328700,957943839300,21510600,-1
720,1,STEP,957943891200,957965765000,21873800,-1
721,1,STEP,957965806900,957986494100,20687200,-1
722,1,STEP,957986535900,958008055500,21519600,-1
723,1,STEP,958008099500,958029491200,21391700,-1
724,1,STEP,958029534000,958049787600,20253600,-1
725,1,STEP,958049823800,958070803500,20979700,-1
726,1,STEP,958070850600,958092267700,21417100,-1
727,1,STEP,958092314300,958113690100,21375800,-1
728,1,STEP,958113744800,958134494900,20750100,-1
729,1,STEP,958134537900,958154615300,20077400,-1
730,1,STEP,958154679200,958175967000,21287800,-1
731,1,STEP,958176021600,958196842900,20821300,-1
732,1,STEP,958196894100,958217479600,20585500,-1
733,1,STEP,958217518000,958238825900,21307900,-1
734,1,STEP,958238880400,958260188100,21307700,-1
735,1,STEP,958260250900,958280730500,20479600,-1
736,1,STEP,958280776500,958302110600,21334100,-1
737,1,STEP,958302161500,958322216700,20055200,-1
738,1,STEP,958322263100,958343196900,20933800,-1
739,1,STEP,958343246000,958363487100,20241100,-1
740,1,STEP,958363524900,958384662400,21137500,-1
741,1,STEP,958384704100,958405880200,21176100,-1
742,1,STEP,958405919600,958427198200,21278600,-1
743,1,STEP,958427249900,958447870200,20620300,-1
744,1,STEP,958447924800,958468309400,20384600,-1
745,1,STEP,958468343800,958490177400,21833600,-1
746,1,STEP,958490231600,958511189200,20957600,-1
747,1,STEP,958511247400,958532458000,21210600,-1
748,1,STEP,958532519600,958553797100,21277500,-1
749,1,STEP,958553853800,958574141300,20287500,-1
750,1,STEP,958574185800,958594493300,20307500,-1
751,1,STEP,958594569300,958614931700,20362400,-1
752,1,STEP,958614978300,958635717100,20738800,-1
753,1,STEP,958635779900,958657052100,21272200,-1
754,1,STEP,958657102900,958678235500,21132600,-1
755,1,STEP,958678273100,958698892400,20619300,-1
756,1,STEP,958698927200,958719658000,20730800,-1
757,1,STEP,958719706700,958740029500,20322800,-1
758,1,STEP,958740081500,958760582600,20501100,-1
759,1,STEP,958760627400,958781358200,20730800,-1
760,1,STEP,958781401500,958801998200,20596700,-1
761,1,STEP,958802039700,958822493200,20453500,-1
762,1,STEP,958822541100,958843647300,21106200,-1
763,1,STEP,958843702000,958864275300,20573300,-1
764,1,STEP,958864314400,958886270500,21956100,-1
765,1,STEP,958886316500,958907595300,21278800,-1
766,1,STEP,958907631400,958928706800,21075400,-1
767,1,STEP,958928754600,958949827900,21073300,-1
768,1,STEP,958949872400,958971202200,21329800,-1
769,1,STEP,958971252400,958993388200,22135800,-1
770,1,STEP,958993440600,959016192400,22751800,-1
771,1,STEP,959016237600,959039144900,22907300,-1
772,1,STEP,959039184800,959061600500,22415700,-1
773,1,STEP,959061651300,959083761300,22110000,-1
774,1,STEP,959083807400,959106065900,22258500,-1
775,1,STEP,959106113100,959128980200,22867100,-1
776,1,STEP,959129018200,959151333700,22315500,-1
777,1,STEP,959151381700,959173591000,22209300,-1
778,1,STEP,959173640500,959196531400,22890900,-1
779,1,STEP,959196588300,959219378900,22790600,-1
780,1,STEP,959219431100,959241839600,22408500,-1
781,1,STEP,959241893300,959264204600,22311300,-1
782,1,STEP,959264253400,959287276300,23022900,-1
783,1,STEP,959287317800,959309718300,22400500,-1
784,1,STEP,959309768300,959332581800,22813500,-1
785,1,STEP,959332633800,959354823800,22190000,-1
786,1,STEP,959354873200,959377824600,22951400,-1
787,1,STEP,959377884100,959399467400,21583300,-1
788,1,STEP,959399524300,959422341500,22817200,-1
789,1,STEP,959422383500,959444665600,22282100,-1
790,1,STEP,959444709600,959466961500,22251900,-1
791,1,STEP,959467019000,959488989300,21970300,-1
792,1,STEP,959489033700,959511622500,22588800,-1
793,1,STEP,959511672900,959534515700,22842800,-1
794,1,STEP,959534557600,959556792700,22235100,-1
795,1,STEP,959556847600,959580017900,23170300,-1
796,1,STEP,959580067800,959603034000,22966200,-1
797,1,STEP,959603087800,959625434000,22346200,-1
798,1,STEP,959625484800,959647775100,22290300,-1
799,1,STEP,959647817600,959669867600,22050000,-1
800,1,STEP,959669917300,959692029100,22111800,-1
801,1,STEP,959692091100,959714517200,22426100,-1
802,1,STEP,959714569100,959737030700,22461600,-1
803,1,STEP,959737084800,959759852700,22767900,-1
804,1,STEP,959759892800,959782092000,22199200,-1
805,1,STEP,959782134900,959804421300,22286400,-1
806,1,STEP,959804483100,959827599100,23116000,-1
807,1,STEP,959827643200,959849694300,22051100,-1
808,1,STEP,959849735100,959872088600,22353500,-1
809,1,STEP,959872129300,959894975100,22845800,-1
810,1,STEP,959895020800,959918032200,23011400,-1
811,1,STEP,959918089000,959940365900,22276900,-1
812,1,STEP,959940434200,959962640100,22205900,-1
813,1,STEP,959962677800,959984985200,22307400,-1
814,1,STEP,959985038800,960007909300,22870500,-1
815,1,STEP,960007963900,960029969200,22005300,-1
816,1,STEP,960030012700,960052049600,22036900,-1
817,1,STEP,960052085900,960075550800,23464900,-1
818,1,STEP,960075596200,960097219100,21622900,-1
819,1,STEP,960097268900,960119713400,22444500,-1
820,1,STEP,960119765900,960142764100,22998200,-1
821,1,STEP,960142809500,960164835300,22025800,-1
822,1,STEP,960164878400,960186822700,21944300,-1
823,1,STEP,960186864300,960209064000,22199700,-1
824,1,STEP,960209102500,960231554500,22452000,-1
825,1,STEP,960231603100,960254019400,22416300,-1
826,1,STEP,960254087900,960275491300,21403400,-1
827,1,STEP,960275550300,960297617900,22067600,-1
828,1,STEP,960297671100,960320653600,22982500,-1
829,1,STEP,960320708800,960342863500,22154700,-1
830,1,STEP,960342913200,960365881500,22968300,-1
831,1,STEP,960365918100,960388378300,22460200,-1
832,1,STEP,960388420500,960411058400,22637900,-1
833,1,STEP,960411093900,960432761200,21667300,-1
834,1,STEP,960432814200,960453936100,21121900,-1
835,1,STEP,960453980900,960475083800,21102900,-1
836,1,STEP,960475134900,960496528400,21393500,-1
837,1,STEP,960496583100,960517532600,20949500,-1
838,1,STEP,960517568500,960538422700,20854200,-1
839,1,STEP,960538504200,960558894000,20389800,-1
840,1,STEP,960558937200,960579589900,20652700,-1
841,1,STEP,960579628600,960600389100,20760500,-1
842,1,STEP,960600436100,960622616300,22180200,-1
843,1,STEP,960622670700,960644880500,22209800,-1
844,1,STEP,960644936500,960666899800,21963300,-1
845,1,STEP,960666946700,960687808900,20862200,-1
846,1,STEP,960687854700,960709592300,21737600,-1
847,1,STEP,960709631200,960730777500,21146300,-1
848,1,STEP,960730815700,960751821500,21005800,-1
849,1,STEP,960751873000,960772922300,21049300,-1
850,1,STEP,960772962500,960794219600,21257100,-1
851,1,STEP,960794257400,960815095700,20838300,-1
852,1,STEP,960815134300,960836097000,20962700,-1
853,1,STEP,960836141700,960857556300,21414600,-1
854,1,STEP,960857604600,960878589300,20984700,-1
855,1,STEP,960878625700,960899861600,21235900,-1
856,1,STEP,960899902900,960920971600,21068700,-1
857,1,STEP,960921025600,960941771900,20746300,-1
858,1,STEP,960941822500,960963065400,21242900,-1
859,1,STEP,960963118900,960984167200,21048300,-1
860,1,STEP,960984212600,961005371300,21158700,-1
861,1,STEP,961005417300,961026525900,21108600,-1
862,1,STEP,961026574500,961046902000,20327500,-1
863,1,STEP,961046954900,961068218900,21264000,-1
864,1,STEP,961068267700,961089133800,20866100,-1
865,1,STEP,961089184700,961110099500,20914800,-1
866,1,STEP,961110146300,961131874700,21728400,-1
867,1,STEP,961131928900,961153513600,21584700,-1
868,1,STEP,961153557500,961175229900,21672400,-1
869,1,STEP,961175273800,961196982600,21708800,-1
870,1,STEP,961197023600,961217823400,20799800,-1
871,1,STEP,961217872100,961239143900,21271800,-1
872,1,STEP,961239189000,961260999800,21810800,-1
873,1,STEP,961261045900,961283512000,22466100,-1
874,1,STEP,961283561600,961304198900,20637300,-1
875,1,STEP,961304236000,961325965600,21729600,-1
876,1,STEP,961326037500,961347707600,21670100,-1
877,1,STEP,961347762600,961369651400,21888800,-1
878,1,STEP,961369703400,961391555300,21851900,-1
879,1,STEP,961391594800,961412735500,21140700,-1
880,1,STEP,961412781300,961433756600,20975300,-1
881,1,STEP,961433801400,961454858900,21057500,-1
882,1,STEP,961454898500,961476645600,21747100,-1
883,1,STEP,961476697800,961498961000,22263200,-1
884,1,STEP,961498999500,961520253600,21254100,-1
885,1,STEP,961520296500,961541454000,21157500,-1
886,1,STEP,961541498600,961563326300,21827700,-1
887,1,STEP,961563415800,961584984100,21568300,-1
888,1,STEP,961585040200,961606757000,21716800,-1
889,1,STEP,961606797400,961628023300,21225900,-1
890,1,STEP,961628071200,961648918000,20846800,-1
891,1,STEP,961648969300,961670744900,21775600,-1
892,1,STEP,961670797700,961691644200,20846500,-1
893,1,STEP,961691709500,961712454900,20745400,-1
894,1,STEP,961712509000,961733668100,21159100,-1
895,1,STEP,961733717200,961755363800,21646600,-1
896,1,STEP,961755427000,961776222100,20795100,-1
897,1,STEP,961776286000,961797885200,21599200,-1
898,1,STEP,961797945100,961818984600,21039500,-1
899,1,STEP,961819039100,961841343000,22303900,-1
900,1,STEP,961841398400,961862786600,21388200,-1
901,1,STEP,961862839200,961883604400,20765200,-1
902,1,STEP,961883679700,961905084200,21404500,-1
903,1,STEP,961905137000,961925775200,20638200,-1
904,1,STEP,961925826500,961946460000,20633500,-1
905,1,STEP,961946512300,961967692200,21179900,-1
906,1,STEP,961967741000,961988638900,20897900,-1
907,1,STEP,961988684200,962010048500,21364300,-1
908,1,STEP,962010099200,962031305700,21206500,-1
909,1,STEP,962031361200,962052586700,21225500,-1
910,1,STEP,962052627500,962074325400,21697900,-1
911,1,STEP,962074368400,962095535700,21167300,-1
912,1,STEP,962095582600,962117431200,21848600,-1
913,1,STEP,962117477200,962139933600,22456400,-1
914,1,STEP,962139987400,962161040500,21053100,-1
915,1,STEP,962161101600,962182684600,21583000,-1
916,1,STEP,962182732500,962204293700,21561200,-1
917,1,STEP,962204357900,962225311200,20953300,-1
918,1,STEP,962225360100,962247584000,22223900,-1
919,1,STEP,962247622900,962269395900,21773000,-1
920,1,STEP,962269444300,962291231300,21787000,-1
921,1,STEP,962291274900,962312990100,21715200,-1
922,1,STEP,962313039900,962334475700,21435800,-1
923,1,STEP,962334539500,962356176500,21637000,-1
924,1,STEP,962356239700,962377966700,21727000,-1
925,1,STEP,962378032500,962399492200,21459700,-1
926,1,STEP,962399542800,962421229800,21687000,-1
927,1,STEP,962421283800,962442163700,20879900,-1
928,1,STEP,962442210200,962462718700,20508500,-1
929,1,STEP,962462762100,962483393800,20631700,-1
930,1,STEP,962483433100,962504130400,20697300,-1
931,1,STEP,962504178700,962525184100,21005400,-1
932,1,STEP,962525232000,962546176900,20944900,-1
933,1,STEP,962546220300,962567235300,21015000,-1
934,1,STEP,962567273400,962588823500,21550100,-1
935,1,STEP,962588861300,962610665500,21804200,-1
936,1,STEP,962610712000,962632172400,21460400,-1
937,1,STEP,962632221500,962652978500,20757000,-1
938,1,STEP,962653017700,962674106500,21088800,-1
939,1,STEP,962674146600,962695043600,20897000,-1
940,1,STEP,962695089100,962715146700,20057600,-1
941,1,STEP,962715209600,962736760300,21550700,-1
942,1,STEP,962736820100,962758394200,21574100,-1
943,1,STEP,962758448100,962779970200,21522100,-1
944,1,STEP,962780021100,962801880600,21859500,-1
945,1,STEP,962801924800,962823461000,21536200,-1
946,1,STEP,962823504700,962845357000,21852300,-1
947,1,STEP,962845404800,962866579400,21174600,-1
948,1,STEP,962866641400,962887549900,20908500,-1
949,1,STEP,962887594500,962908729700,21135200,-1
950,1,STEP,962908768600,962929254100,20485500,-1
951,1,STEP,962929310400,962950705900,21395500,-1
952,1,STEP,962950755200,962971562700,20807500,-1
953,1,STEP,962971612700,962992682400,21069700,-1
954,1,STEP,962992738400,963014222300,21483900,-1
955,1,STEP,963014261700,963036063900,21802200,-1
956,1,STEP,963036108800,963057205400,21096600,-1
957,1,STEP,963057250800,963078553100,21302300,-1
958,1,STEP,963078591600,963100054300,21462700,-1
959,1,STEP,963100096400,963121945200,21848800,-1
960,1,STEP,963121988800,963143747100,21758300,-1
961,1,STEP,963143802700,963165308300,21505600,-1
962,1,STEP,963165354200,963186384400,21030200,-1
963,1,STEP,963186426200,963208096600,21670400,-1
964,1,STEP,963208134300,963230201300,22067000,-1
965,1,STEP,963230239500,963252048800,21809300,-1
966,1,STEP,963252088900,963273820200,21731300,-1
967,1,STEP,963273873300,963295531600,21658300,-1
968,1,STEP,963295576100,963316633000,21056900,-1
969,1,STEP,963316675300,963338573600,21898300,-1
970,1,STEP,963338622500,963359617500,20995000,-1
971,1,STEP,963359677100,963380543500,20866400,-1
972,1,STEP,963380614100,963401800600,21186500,-1
973,1,STEP,963401861500,963423509800,21648300,-1
974,1,STEP,963423568100,963445288100,21720000,-1
975,1,STEP,963445361800,963466014400,20652600,-1
976,1,STEP,963466087000,963487416000,21329000,-1
977,1,STEP,963487473700,963509099200,21625500,-1
978,1,STEP,963509143900,963530406400,21262500,-1
979,1,STEP,963530450400,963551517500,21067100,-1
980,1,STEP,963551552600,963572500100,20947500,-1
981,1,STEP,963572541500,963594736100,22194600,-1
982,1,STEP,963594786200,963615904900,21118700,-1
983,1,STEP,963615942300,963636928500,20986200,-1
984,1,STEP,963636975200,963658498700,21523500,-1
985,1,STEP,963658543200,963679569500,21026300,-1
986,1,STEP,963679614800,963701337300,21722500,-1
987,1,STEP,963701382600,963722740300,21357700,-1
988,1,STEP,963722793100,963744547400,21754300,-1
989,1,STEP,963744593000,963766806900,22213900,-1
990,1,STEP,963766866600,963788427600,21561000,-1
991,1,STEP,963788487500,963809234900,20747400,-1
992,1,STEP,963809278600,963830274300,20995700,-1
993,1,STEP,963830316400,963851054800,20738400,-1
994,1,STEP,963851094800,963871897400,20802600,-1
995,1,STEP,963871936900,963893358500,21421600,-1
996,1,STEP,963893429800,963914458900,21029100,-1
997,1,STEP,963914497600,963936613900,22116300,-1
998,1,STEP,963936661200,963958461400,21800200,-1
999,1,STEP,963958542300,963980354400,21812100,-1
