Gen,Resource,Stamp,TimeStamp_Start,TimeStamp_End,Duration,Indiv_id
0,1,TransfertToDevice,977171425600,977544444700,373019100,-1
0,1,STEP,977677217300,977694923200,17705900,-1
1,1,STEP,977694977600,977711611400,16633800,-1
2,1,STEP,977711639000,977728472200,16833200,-1
3,1,STEP,977728512700,977745243300,16730600,-1
4,1,STEP,977745281300,977762394000,17112700,-1
5,1,STEP,977762432400,977779858300,17425900,-1
6,1,STEP,977779904900,977797290300,17385400,-1
7,1,STEP,977797336900,977814865900,17529000,-1
8,1,STEP,977814906700,977832385500,17478800,-1
9,1,STEP,977832462500,977849864200,17401700,-1
10,1,STEP,977849892600,977867614900,17722300,-1
11,1,STEP,977867659800,977885068900,17409100,-1
12,1,STEP,977885114000,977902436900,17322900,-1
13,1,STEP,977902478600,977919898400,17419800,-1
14,1,STEP,977919932000,977938069300,18137300,-1
15,1,STEP,977938118200,977957097500,18979300,-1
16,1,STEP,977957141800,977975944900,18803100,-1
17,1,STEP,977975983100,977994566200,18583100,-1
18,1,STEP,977994622400,978012212200,17589800,-1
19,1,STEP,978012269300,978030154800,17885500,-1
20,1,STEP,978030207200,978047993300,17786100,-1
21,1,STEP,978048038300,978065953800,17915500,-1
22,1,STEP,978065998800,978084538100,18539300,-1
23,1,STEP,978084581100,978103872600,19291500,-1
24,1,STEP,978103924600,978123452400,19527800,-1
25,1,STEP,978123511000,978142720800,19209800,-1
26,1,STEP,978142763900,978161649200,18885300,-1
27,1,STEP,978161719900,978180854300,19134400,-1
28,1,STEP,978180912500,978199831000,18918500,-1
29,1,STEP,978199883600,978218934500,19050900,-1
30,1,STEP,978218994600,978237771400,18776800,-1
31,1,STEP,978237817900,978256656700,18838800,-1
32,1,STEP,978256692200,978276073400,19381200,-1
33,1,STEP,978276118600,978295223300,19104700,-1
34,1,STEP,978295280900,978314756200,19475300,-1
35,1,STEP,978314796100,978333693000,18896900,-1
36,1,STEP,978333734600,978352819100,19084500,-1
37,1,STEP,978352850900,978372184800,19333900,-1
38,1,STEP,978372241100,978391909300,19668200,-1
39,1,STEP,978391959600,978412373300,20413700,-1
40,1,STEP,978412423800,978432997000,20573200,-1
41,1,STEP,978433044800,978453171800,20127000,-1
42,1,STEP,978453218100,978473607900,20389800,-1
43,1,STEP,978473646300,978493733800,20087500,-1
44,1,STEP,978493780500,978514048800,20268300,-1
45,1,STEP,978514098200,978534589000,20490800,-1
46,1,STEP,978534642900,978555071100,20428200,-1
47,1,STEP,978555107900,978575613100,20505200,-1
48,1,STEP,978575656400,978596606400,20950000,-1
49,1,STEP,978596647300,978618530700,21883400,-1
50,1,STEP,978618561500,978639853900,21292400,-1
51,1,STEP,978639905100,978660982200,21077100,-1
52,1,STEP,978661027100,978682235800,21208700,-1
53,1,STEP,978682284800,978704139900,21855100,-1
54,1,STEP,978704180400,978725664900,21484500,-1
55,1,STEP,978725717500,978747078500,21361000,-1
56,1,STEP,978747118900,978768376800,21257900,-1
57,1,STEP,978768420800,978790539800,22119000,-1
58,1,STEP,978790583200,978811798600,21215400,-1
59,1,STEP,978811862200,978833331700,21469500,-1
60,1,STEP,978833393000,978854616700,21223700,-1
61,1,STEP,978854665900,978876106300,21440400,-1
62,1,STEP,978876151200,978897583100,21431900,-1
63,1,STEP,978897619600,978918756900,21137300,-1
64,1,STEP,978918803400,978940700600,21897200,-1
65,1,STEP,978940748000,978962347400,21599400,-1
66,1,STEP,978962392700,978983772900,21380200,-1
67,1,STEP,978983810600,979005034400,21223800,-1
68,1,STEP,979005077600,979026919500,21841900,-1
69,1,STEP,979026967300,979048003600,21036300,-1
70,1,STEP,979048046900,979069567500,21520600,-1
71,1,STEP,979069614900,979090929800,21314900,-1
72,1,STEP,979090976900,979112451100,21474200,-1
73,1,STEP,979112499900,979133763200,21263300,-1
74,1,STEP,979133812100,979155202100,21390000,-1
75,1,STEP,979155250400,979176756700,21506300,-1
76,1,STEP,979176796300,979198088500,21292200,-1
77,1,STEP,979198149900,979219870800,21720900,-1
78,1,STEP,979219926100,979241011600,21085500,-1
79,1,STEP,979241066800,979262430000,21363200,-1
80,1,STEP,979262484000,979283746300,21262300,-1
81,1,STEP,979283790100,979305316600,21526500,-1
82,1,STEP,979305355000,979326876100,21521100,-1
83,1,STEP,979326936300,979348420000,21483700,-1
84,1,STEP,979348470800,979369977500,21506700,-1
85,1,STEP,979370022100,979391119900,21097800,-1
86,1,STEP,979391170200,979412148600,20978400,-1
87,1,STEP,979412189100,979433621700,21432600,-1
88,1,STEP,979433668100,979455212400,21544300,-1
89,1,STEP,979455268400,979476768100,21499700,-1
90,1,STEP,979476811200,979498291000,21479800,-1
91,1,STEP,979498340700,979520352800,22012100,-1
92,1,STEP,979520387500,979541686500,21299000,-1
93,1,STEP,979541733600,979563746200,22012600,-1
94,1,STEP,979563801300,979586169100,22367800,-1
95,1,STEP,979586228600,979607862200,21633600,-1
96,1,STEP,979607911100,979629647200,21736100,-1
97,1,STEP,979629693700,979650932300,21238600,-1
98,1,STEP,979650984100,979672026200,21042100,-1
99,1,STEP,979672079500,979693834600,21755100,-1
100,1,STEP,979693880800,979715663500,21782700,-1
101,1,STEP,979715705400,979737706200,22000800,-1
102,1,STEP,979737747500,979760165200,22417700,-1
103,1,STEP,979760215300,979781980500,21765200,-1
104,1,STEP,979782024600,979804202200,22177600,-1
105,1,STEP,979804239200,979826265400,22026200,-1
106,1,STEP,979826316600,979848173200,21856600,-1
107,1,STEP,979848212900,979870104600,21891700,-1
108,1,STEP,979870163500,979892061900,21898400,-1
109,1,STEP,979892132700,979913785200,21652500,-1
110,1,STEP,979913865200,979935621400,21756200,-1
111,1,STEP,979935680000,979957255100,21575100,-1
112,1,STEP,979957339700,979979153200,21813500,-1
113,1,STEP,979979212600,980001458000,22245400,-1
114,1,STEP,980001519100,980023248800,21729700,-1
115,1,STEP,980023308000,980045934700,22626700,-1
116,1,STEP,980045978700,980068841700,22863000,-1
117,1,STEP,980068895700,980090909800,22014100,-1
118,1,STEP,980090958900,980113213100,22254200,-1
119,1,STEP,980113264700,980135378900,22114200,-1
120,1,STEP,980135423600,980158402700,22979100,-1
121,1,STEP,980158457500,980180443300,21985800,-1
122,1,STEP,980180502000,980202677900,22175900,-1
123,1,STEP,980202732600,980225468000,22735400,-1
124,1,STEP,980225511000,980247627900,22116900,-1
125,1,STEP,980247683600,980269773600,22090000,-1
126,1,STEP,980269829100,980291703400,21874300,-1
127,1,STEP,980291756800,980313878600,22121800,-1
128,1,STEP,980313930100,980336123100,22193000,-1
129,1,STEP,980336165000,980358335100,22170100,-1
130,1,STEP,980358374000,980380413300,22039300,-1
131,1,STEP,980380460300,980403257300,22797000,-1
132,1,STEP,980403307300,980425518300,22211000,-1
133,1,STEP,980425563000,980448131700,22568700,-1
134,1,STEP,980448177100,980471072900,22895800,-1
135,1,STEP,980471118600,980493286200,22167600,-1
136,1,STEP,980493330300,980515365400,22035100,-1
137,1,STEP,980515413700,980537626000,22212300,-1
138,1,STEP,980537663500,980560158000,22494500,-1
139,1,STEP,980560201300,980582366300,22165000,-1
140,1,STEP,980582403500,980605076200,22672700,-1
141,1,STEP,980605136100,980628211500,23075400,-1
142,1,STEP,980628266500,980651153200,22886700,-1
143,1,STEP,980651209500,980673658700,22449200,-1
144,1,STEP,980673712500,980695946000,22233500,-1
145,1,STEP,980695989200,980718125600,22136400,-1
146,1,STEP,980718181400,980740832000,22650600,-1
147,1,STEP,980740876700,980763169800,22293100,-1
148,1,STEP,980763208700,980786153000,22944300,-1
149,1,STEP,980786197900,980809084800,22886900,-1
150,1,STEP,980809123800,980832151600,23027800,-1
151,1,STEP,980832203300,980855223500,23020200,-1
152,1,STEP,980855278700,980877754900,22476200,-1
153,1,STEP,980877810200,980899971700,22161500,-1
154,1,STEP,980900013700,980923089500,23075800,-1
155,1,STEP,980923205300,980946086600,22881300,-1
156,1,STEP,980946138600,980968529700,22391100,-1
157,1,STEP,980968571600,980991170300,22598700,-1
158,1,STEP,980991216700,981013902200,22685500,-1
159,1,STEP,981013944100,981036773000,22828900,-1
160,1,STEP,981036822800,981059439200,22616400,-1
161,1,STEP,981059486500,981082260100,22773600,-1
162,1,STEP,981082313100,981104263300,21950200,-1
163,1,STEP,981104301400,981127314100,23012700,-1
164,1,STEP,981127361800,981149794400,22432600,-1
165,1,STEP,981149844500,981172589500,22745000,-1
166,1,STEP,981172635000,981194984800,22349800,-1
167,1,STEP,981195030600,981217213900,22183300,-1
168,1,STEP,981217254200,981239691800,22437600,-1
169,1,STEP,981239736100,981262188400,22452300,-1
170,1,STEP,981262235300,981284577100,22341800,-1
171,1,STEP,981284632900,981306803400,22170500,-1
172,1,STEP,981306870100,981329386700,22516600,-1
173,1,STEP,981329439200,981351942700,22503500,-1
174,1,STEP,981351996400,981374497900,22501500,-1
175,1,STEP,981374546800,981398925200,24378400,-1
176,1,STEP,981398973300,981421922100,22948800,-1
177,1,STEP,981421972600,981444639900,22667300,-1
178,1,STEP,981444689100,981467520800,22831700,-1
179,1,STEP,981467575000,981489624900,22049900,-1
180,1,STEP,981489729100,981512039800,22310700,-1
181,1,STEP,981512107800,981534664300,22556500,-1
182,1,STEP,981534751500,981557504000,22752500,-1
183,1,STEP,981557584900,981580321700,22736800,-1
184,1,STEP,981580382000,981603372300,22990300,-1
185,1,STEP,981603445500,981625741200,22295700,-1
186,1,STEP,981626006800,981647965300,21958500,-1
187,1,STEP,981648063200,981669720300,21657100,-1
188,1,STEP,981669825200,981692669700,22844500,-1
189,1,STEP,981692748800,981715070500,22321700,-1
190,1,STEP,981715145100,981737700200,22555100,-1
191,1,STEP,981737749300,981760292100,22542800,-1
192,1,STEP,981760339100,981783120100,22781000,-1
193,1,STEP,981783182000,981806094000,22912000,-1
194,1,STEP,981806140100,981828813700,22673600,-1
195,1,STEP,981828859900,981851127300,22267400,-1
196,1,STEP,981851159900,981873702100,22542200,-1
197,1,STEP,981873756800,981896537700,22780900,-1
198,1,STEP,981896592000,981919091600,22499600,-1
199,1,STEP,981919137000,981942146500,23009500,-1
200,1,STEP,981942201700,981965888000,23686300,-1
201,1,STEP,981965941900,981988768500,22826600,-1
202,1,STEP,981988817600,982011514600,22697000,-1
203,1,STEP,982011567100,982033972200,22405100,-1
204,1,STEP,982034022200,982057029400,23007200,-1
205,1,STEP,982057076600,982080275700,23199100,-1
206,1,STEP,982080319900,982103456800,23136900,-1
207,1,STEP,982103503400,982125761300,22257900,-1
208,1,STEP,982125811200,982148043700,22232500,-1
209,1,STEP,982148090600,982170000500,21909900,-1
210,1,STEP,982170040600,982192543300,22502700,-1
211,1,STEP,982192602300,982214884700,22282400,-1
212,1,STEP,982214963900,982238174900,23211000,-1
213,1,STEP,982238229500,982260762300,22532800,-1
214,1,STEP,982260824400,982283443500,22619100,-1
215,1,STEP,982283508900,982306485300,22976400,-1
216,1,STEP,982306542400,982328934600,22392200,-1
217,1,STEP,982328981800,982351349200,22367400,-1
218,1,STEP,982351419000,982373679000,22260000,-1
219,1,STEP,982373738200,982396854500,23116300,-1
220,1,STEP,982396907100,982419372700,22465600,-1
221,1,STEP,982419419600,982442145900,22726300,-1
222,1,STEP,982442188400,982465198000,23009600,-1
223,1,STEP,982465242400,982487985300,22742900,-1
224,1,STEP,982488028200,982510627600,22599400,-1
225,1,STEP,982510680200,982533435700,22755500,-1
226,1,STEP,982533495800,982555971000,22475200,-1
227,1,STEP,982556018000,982579174000,23156000,-1
228,1,STEP,982579210200,982602629900,23419700,-1
229,1,STEP,982602686100,982625582700,22896600,-1
230,1,STEP,982625630400,982648142500,22512100,-1
231,1,STEP,982648181200,982670664100,22482900,-1
232,1,STEP,982670701200,982693096900,22395700,-1
233,1,STEP,982693137800,982716135900,22998100,-1
234,1,STEP,982716188300,982739083500,22895200,-1
235,1,STEP,982739152700,982761678700,22526000,-1
236,1,STEP,982761733600,982785294800,23561200,-1
237,1,STEP,982785345500,982808034000,22688500,-1
238,1,STEP,982808075200,982830826900,22751700,-1
239,1,STEP,982830879000,982853448600,22569600,-1
240,1,STEP,982853495500,982877308500,23813000,-1
241,1,STEP,982877349400,982899921800,22572400,-1
242,1,STEP,982899962600,982922571000,22608400,-1
243,1,STEP,982922638400,982945296300,22657900,-1
244,1,STEP,982945351800,982967940200,22588400,-1
245,1,STEP,982967989200,982991124300,23135100,-1
246,1,STEP,982991168400,983014754500,23586100,-1
247,1,STEP,983014806200,983036952400,22146200,-1
248,1,STEP,983037002600,983059425200,22422600,-1
249,1,STEP,983059469800,983081942600,22472800,-1
250,1,STEP,983081990200,983104354600,22364400,-1
251,1,STEP,983104419200,983127048100,22628900,-1
252,1,STEP,983127103300,983150178300,23075000,-1
253,1,STEP,983150228900,983172655800,22426900,-1
254,1,STEP,983172709200,983194790000,22080800,-1
255,1,STEP,983194835300,983217123900,22288600,-1
256,1,STEP,983217173000,983239531600,22358600,-1
257,1,STEP,983239582700,983261964200,22381500,-1
258,1,STEP,983262012100,983284853200,22841100,-1
259,1,STEP,983284898100,983308565200,23667100,-1
260,1,STEP,983308612200,983332024100,23411900,-1
261,1,STEP,983332077400,983355299100,23221700,-1
262,1,STEP,983355353400,983377541400,22188000,-1
263,1,STEP,983377594400,983399809100,22214700,-1
264,1,STEP,983399873100,983422270600,22397500,-1
265,1,STEP,983422347600,983445020800,22673200,-1
266,1,STEP,983445079400,983467923400,22844000,-1
267,1,STEP,983467984600,983491416700,23432100,-1
268,1,STEP,983491477000,983514179100,22702100,-1
269,1,STEP,983514235500,983536378700,22143200,-1
270,1,STEP,983536431900,983559918200,23486300,-1
271,1,STEP,983559981200,983582262700,22281500,-1
272,1,STEP,983582312400,983604952800,22640400,-1
273,1,STEP,983604990600,983627395400,22404800,-1
274,1,STEP,983627439800,983649883100,22443300,-1
275,1,STEP,983649930000,983672931100,23001100,-1
276,1,STEP,983672978800,983695520000,22541200,-1
277,1,STEP,983695562900,983718286800,22723900,-1
278,1,STEP,983718353700,983741587700,23234000,-1
279,1,STEP,983741638900,983764125700,22486800,-1
280,1,STEP,983764174300,983786576700,22402400,-1
281,1,STEP,983786633400,983809025200,22391800,-1
282,1,STEP,983809077700,983831291800,22214100,-1
283,1,STEP,983831352600,983854350600,22998000,-1
284,1,STEP,983854403900,983877061800,22657900,-1
285,1,STEP,983877134500,983899717000,22582500,-1
286,1,STEP,983899760700,983921802700,22042000,-1
287,1,STEP,983921901000,983944488100,22587100,-1
288,1,STEP,983944570500,983966884200,22313700,-1
289,1,STEP,983966945600,983991108600,24163000,-1
290,1,STEP,983991175000,984013782200,22607200,-1
291,1,STEP,984013834100,984036919900,23085800,-1
292,1,STEP,984036966500,984060227400,23260900,-1
293,1,STEP,984060281100,984083500800,23219700,-1
294,1,STEP,984083552600,984105930800,22378200,-1
295,1,STEP,984105983300,984128884800,22901500,-1
296,1,STEP,984128938200,984151444400,22506200,-1
297,1,STEP,984151494800,984174062300,22567500,-1
298,1,STEP,984174118500,984196416200,22297700,-1
299,1,STEP,984196469800,984219660800,23191000,-1
300,1,STEP,984219750100,984242358400,22608300,-1
301,1,STEP,984242414900,984265813200,23398300,-1
302,1,STEP,984265867400,984288074400,22207000,-1
303,1,STEP,984288126700,984311134700,23008000,-1
304,1,STEP,984311206400,984334479000,23272600,-1
305,1,STEP,984334527600,984357527100,22999500,-1
306,1,STEP,984357575900,984380583400,23007500,-1
307,1,STEP,984380650200,984403651000,23000800,-1
308,1,STEP,984403709900,984426515000,22805100,-1
309,1,STEP,984426572100,984450858800,24286700,-1
310,1,STEP,984450921200,984473519700,22598500,-1
311,1,STEP,984473576600,984496779500,23202900,-1
312,1,STEP,984496854600,984519146800,22292200,-1
313,1,STEP,984519200900,984542056400,22855500,-1
314,1,STEP,984542107900,984564805200,22697300,-1
315,1,STEP,984564854400,984587979800,23125400,-1
316,1,STEP,984588056700,984610224100,22167400,-1
317,1,STEP,984610284200,984632940500,22656300,-1
318,1,STEP,984632996200,984656183700,23187500,-1
319,1,STEP,984656235100,984679271000,23035900,-1
320,1,STEP,984679321800,984701613700,22291900,-1
321,1,STEP,984701668700,984724601300,22932600,-1
322,1,STEP,984724655400,984746930500,22275100,-1
323,1,STEP,984746986600,984769511600,22525000,-1
324,1,STEP,984769560900,984792516400,22955500,-1
325,1,STEP,984792565000,984815383800,22818800,-1
326,1,STEP,984815428400,984837601600,22173200,-1
327,1,STEP,984837656200,984860135200,22479000,-1
328,1,STEP,984860200600,984882494000,22293400,-1
329,1,STEP,984882558800,984905301000,22742200,-1
330,1,STEP,984905357300,984927822500,22465200,-1
331,1,STEP,984927887000,984950534000,22647000,-1
332,1,STEP,984950585600,984973413100,22827500,-1
333,1,STEP,984973471600,984995796300,22324700,-1
334,1,STEP,984995861700,985018004200,22142500,-1
335,1,STEP,985018064700,985040899600,22834900,-1
336,1,STEP,985040954200,985065075800,24121600,-1
337,1,STEP,985065124100,985089672500,24548400,-1
338,1,STEP,985089721600,985113529400,23807800,-1
339,1,STEP,985113582500,985137672400,24089900,-1
340,1,STEP,985137726100,985161595700,23869600,-1
341,1,STEP,985161682600,985185958100,24275500,-1
342,1,STEP,985186033300,985209798900,23765600,-1
343,1,STEP,985209886600,985233612000,23725400,-1
344,1,STEP,985233699000,985258423200,24724200,-1
345,1,STEP,985258482500,985283064500,24582000,-1
346,1,STEP,985283124000,985307398500,24274500,-1
347,1,STEP,985307462900,985332541600,25078700,-1
348,1,STEP,985332601200,985355783800,23182600,-1
349,1,STEP,985355836800,985379806100,23969300,-1
350,1,STEP,985379859500,985404043600,24184100,-1
351,1,STEP,985404120600,985428309700,24189100,-1
352,1,STEP,985428372200,985452774400,24402200,-1
353,1,STEP,985452827000,985477364100,24537100,-1
354,1,STEP,985477417000,985501982300,24565300,-1
355,1,STEP,985502027500,985526984900,24957400,-1
356,1,STEP,985527048400,985550925500,23877100,-1
357,1,STEP,985550980100,985575380200,24400100,-1
358,1,STEP,985575435600,985599602000,24166400,-1
359,1,STEP,985599651700,985623871100,24219400,-1
360,1,STEP,985623932800,985648358400,24425600,-1
361,1,STEP,985648406700,985673075400,24668700,-1
362,1,STEP,985673125300,985697146500,24021200,-1
363,1,STEP,985697195900,985721031000,23835100,-1
364,1,STEP,985721082600,985745474500,24391900,-1
365,1,STEP,985745534200,985769538200,24004000,-1
366,1,STEP,985769599400,985794103900,24504500,-1
367,1,STEP,985794158000,985818411600,24253600,-1
368,1,STEP,985818473400,985842360300,23886900,-1
369,1,STEP,985842426300,985866258200,23831900,-1
370,1,STEP,985866318800,985891268400,24949600,-1
371,1,STEP,985891325600,985915839500,24513900,-1
372,1,STEP,985915919100,985939535600,23616500,-1
373,1,STEP,985939596800,985963107600,23510800,-1
374,1,STEP,985963177600,985986953500,23775900,-1
375,1,STEP,985987001600,986010845900,23844300,-1
376,1,STEP,986010904000,986034497000,23593000,-1
377,1,STEP,986034544100,986058688800,24144700,-1
378,1,STEP,986058740900,986082182300,23441400,-1
379,1,STEP,986082227200,986105756300,23529100,-1
380,1,STEP,986105809500,986130080000,24270500,-1
381,1,STEP,986130132400,986154833500,24701100,-1
382,1,STEP,986154888400,986179561300,24672900,-1
383,1,STEP,986179608200,986203563300,23955100,-1
384,1,STEP,986203609300,986228398000,24788700,-1
385,1,STEP,986228471900,986252490600,24018700,-1
386,1,STEP,986252544500,986276541100,23996600,-1
387,1,STEP,986276617400,986300506300,23888900,-1
388,1,STEP,986300566200,986324920500,24354300,-1
389,1,STEP,986324973300,986349478700,24505400,-1
390,1,STEP,986349526100,986373809100,24283000,-1
391,1,STEP,986373861700,986398230700,24369000,-1
392,1,STEP,986398281800,986422050500,23768700,-1
393,1,STEP,986422116700,986445613500,23496800,-1
394,1,STEP,986445671800,986469503700,23831900,-1
395,1,STEP,986469561800,986493424900,23863100,-1
396,1,STEP,986493486300,986517827400,24341100,-1
397,1,STEP,986517881900,986543500900,25619000,-1
398,1,STEP,986543553500,986567388200,23834700,-1
399,1,STEP,986567443900,986591233800,23789900,-1
400,1,STEP,986591296700,986615100200,23803500,-1
401,1,STEP,986615166100,986639282000,24115900,-1
402,1,STEP,986639335800,986663298300,23962500,-1
403,1,STEP,986663354500,986687182500,23828000,-1
404,1,STEP,986687233900,986711647300,24413400,-1
405,1,STEP,986711700900,986736455200,24754300,-1
406,1,STEP,986736507600,986760669200,24161600,-1
407,1,STEP,986760844100,986784468500,23624400,-1
408,1,STEP,986784528000,986808137400,23609400,-1
409,1,STEP,986808196100,986832120300,23924200,-1
410,1,STEP,986832173500,986856448600,24275100,-1
411,1,STEP,986856549200,986881929200,25380000,-1
412,1,STEP,986881996700,986905639700,23643000,-1
413,1,STEP,986905680400,986930035300,24354900,-1
414,1,STEP,986930138600,986955258000,25119400,-1
415,1,STEP,986955308100,986979933600,24625500,-1
416,1,STEP,986979982300,987003868400,23886100,-1
417,1,STEP,987003932900,987028101100,24168200,-1
418,1,STEP,987028166500,987052602100,24435600,-1
419,1,STEP,987052658200,987076514400,23856200,-1
420,1,STEP,987076581300,987100331900,23750600,-1
421,1,STEP,987100399400,987125276000,24876600,-1
422,1,STEP,987125336200,987149269900,23933700,-1
423,1,STEP,987149337700,987174068600,24730900,-1
424,1,STEP,987174131400,987198329200,24197800,-1
425,1,STEP,987198401000,987222431400,24030400,-1
426,1,STEP,987222491700,987246701400,24209700,-1
427,1,STEP,987246752500,987270573200,23820700,-1
428,1,STEP,987270631500,987294904400,24272900,-1
429,1,STEP,987294959500,987318977900,24018400,-1
430,1,STEP,987319025700,987341868600,22842900,-1
431,1,STEP,987341913400,987364733300,22819900,-1
432,1,STEP,987364776200,987387890800,23114600,-1
433,1,STEP,987387938500,987410468400,22529900,-1
434,1,STEP,987410529100,987433222400,22693300,-1
435,1,STEP,987433280300,987456431000,23150700,-1
436,1,STEP,987456502200,987479648000,23145800,-1
437,1,STEP,987479708000,987502870000,23162000,-1
438,1,STEP,987502928700,987525463000,22534300,-1
439,1,STEP,987525542300,987548478300,22936000,-1
440,1,STEP,987548537200,987570932000,22394800,-1
441,1,STEP,987570984500,987593594900,22610400,-1
442,1,STEP,987593663100,987616811600,23148500,-1
443,1,STEP,987616884400,987639366500,22482100,-1
444,1,STEP,987639421600,987662117400,22695800,-1
445,1,STEP,987662175300,987684633600,22458300,-1
446,1,STEP,987684703000,987707296100,22593100,-1
447,1,STEP,987707356000,987730516400,23160400,-1
448,1,STEP,987730577800,987752789500,22211700,-1
449,1,STEP,987752842600,987775531000,22688400,-1
450,1,STEP,987775608900,987798573000,22964100,-1
451,1,STEP,987798622200,987820904400,22282200,-1
452,1,STEP,987820959300,987843768400,22809100,-1
453,1,STEP,987843821300,987866316800,22495500,-1
454,1,STEP,987866366900,987889020400,22653500,-1
455,1,STEP,987889089600,987911238900,22149300,-1
456,1,STEP,987911288900,987933629400,22340500,-1
457,1,STEP,987933682300,987956013700,22331400,-1
458,1,STEP,987956055800,987979011700,22955900,-1
459,1,STEP,987979058900,988002073800,23014900,-1
460,1,STEP,988002121800,988024710300,22588500,-1
461,1,STEP,988024780500,988046944500,22164000,-1
462,1,STEP,988047008800,988069471400,22462600,-1
463,1,STEP,988069527200,988092241100,22713900,-1
464,1,STEP,988092287900,988114546100,22258200,-1
465,1,STEP,988114593300,988137467000,22873700,-1
466,1,STEP,988137519800,988160148800,22629000,-1
467,1,STEP,988160194500,988182692000,22497500,-1
468,1,STEP,988182738800,988205330500,22591700,-1
469,1,STEP,988205371700,988228218600,22846900,-1
470,1,STEP,988228325600,988251627600,23302000,-1
471,1,STEP,988251673100,988274154200,22481100,-1
472,1,STEP,988274205900,988296731000,22525100,-1
473,1,STEP,988296794700,988319682400,22887700,-1
474,1,STEP,988319750600,988342323600,22573000,-1
475,1,STEP,988342386200,988366128700,23742500,-1
476,1,STEP,988366194500,988388929300,22734800,-1
477,1,STEP,988389008200,988411437300,22429100,-1
478,1,STEP,988411493100,988434118300,22625200,-1
479,1,STEP,988434175400,988456583200,22407800,-1
480,1,STEP,988456693700,988479310900,22617200,-1
481,1,STEP,988479367500,988502106700,22739200,-1
482,1,STEP,988502164900,988525156100,22991200,-1
483,1,STEP,988525220900,988547821500,22600600,-1
484,1,STEP,988547884100,988571337800,23453700,-1
485,1,STEP,988571412100,988594235900,22823800,-1
486,1,STEP,988594294500,988616760800,22466300,-1
487,1,STEP,988616827700,988639919900,23092200,-1
488,1,STEP,988639976900,988662510700,22533800,-1
489,1,STEP,988662567600,988686198900,23631300,-1
490,1,STEP,988686255700,988709147800,22892100,-1
491,1,STEP,988709226700,988732493200,23266500,-1
492,1,STEP,988732549500,988755260900,22711400,-1
493,1,STEP,988755319300,988778475500,23156200,-1
494,1,STEP,988778568700,988802445500,23876800,-1
495,1,STEP,988802520000,988824972000,22452000,-1
496,1,STEP,988825029100,988847449300,22420200,-1
497,1,STEP,988847517400,988869710400,22193000,-1
498,1,STEP,988869789300,988892500500,22711200,-1
499,1,STEP,988892552600,988914409600,21857000,-1
500,1,STEP,988914470600,988936500500,22029900,-1
501,1,STEP,988936576900,988958600500,22023600,-1
502,1,STEP,988958668400,988980727200,22058800,-1
503,1,STEP,988980809400,989002942500,22133100,-1
504,1,STEP,989002998900,989025867100,22868200,-1
505,1,STEP,989025928500,989049122800,23194300,-1
506,1,STEP,989049178700,989071929500,22750800,-1
507,1,STEP,989071998600,989094574600,22576000,-1
508,1,STEP,989094653500,989117394700,22741200,-1
509,1,STEP,989117462100,989140134000,22671900,-1
510,1,STEP,989140198400,989162628500,22430100,-1
511,1,STEP,989162674500,989185765200,23090700,-1
512,1,STEP,989185813100,989208179100,22366000,-1
513,1,STEP,989208227500,989230638900,22411400,-1
514,1,STEP,989230681700,989253038300,22356600,-1
515,1,STEP,989253081400,989275642900,22561500,-1
516,1,STEP,989275704000,989298586500,22882500,-1
517,1,STEP,989298636700,989321846900,23210200,-1
518,1,STEP,989321913500,989344625700,22712200,-1
519,1,STEP,989344692800,989367950600,23257800,-1
520,1,STEP,989367999700,989390432900,22433200,-1
521,1,STEP,989390485000,989413900400,23415400,-1
522,1,STEP,989414069200,989438858000,24788800,-1
523,1,STEP,989439002300,989462702100,23699800,-1
524,1,STEP,989462771000,989485395300,22624300,-1
525,1,STEP,989485443800,989508268200,22824400,-1
526,1,STEP,989508324100,989531583200,23259100,-1
527,1,STEP,989531645200,989554128800,22483600,-1
528,1,STEP,989554177900,989576875400,22697500,-1
529,1,STEP,989576928200,989599968500,23040300,-1
530,1,STEP,989600017300,989622381800,22364500,-1
531,1,STEP,989622439800,989645444500,23004700,-1
532,1,STEP,989645492400,989668458300,22965900,-1
533,1,STEP,989668524700,989690828500,22303800,-1
534,1,STEP,989690874500,989713107200,22232700,-1
535,1,STEP,989713163000,989736343100,23180100,-1
536,1,STEP,989736395400,989759839100,23443700,-1
537,1,STEP,989759894500,989784968600,25074100,-1
538,1,STEP,989785023400,989809509500,24486100,-1
539,1,STEP,989809587600,989833897700,24310100,-1
540,1,STEP,989833955700,989857842100,23886400,-1
541,1,STEP,989857892300,989882439700,24547400,-1
542,1,STEP,989882495800,989906528400,24032600,-1
543,1,STEP,989906579300,989930954600,24375300,-1
544,1,STEP,989931008800,989955553400,24544600,-1
545,1,STEP,989955629900,989980054300,24424400,-1
546,1,STEP,989980103800,990004494100,24390300,-1
547,1,STEP,990004544900,990028701600,24156700,-1
548,1,STEP,990028758500,990054397900,25639400,-1
549,1,STEP,990054449300,990078668300,24219000,-1
550,1,STEP,990078716800,990103571500,24854700,-1
551,1,STEP,990103617300,990128504400,24887100,-1
552,1,STEP,990128556600,990152833900,24277300,-1
553,1,STEP,990152903300,990177858400,24955100,-1
554,1,STEP,990177927600,990203121300,25193700,-1
555,1,STEP,990203183000,990227320400,24137400,-1
556,1,STEP,990227394400,990251445000,24050600,-1
557,1,STEP,990251505900,990276161400,24655500,-1
558,1,STEP,990276220300,990301290300,25070000,-1
559,1,STEP,990301360400,990326227000,24866600,-1
560,1,STEP,990326288000,990351081200,24793200,-1
561,1,STEP,990351132400,990375948000,24815600,-1
562,1,STEP,990376000000,990401824700,25824700,-1
563,1,STEP,990401969000,990427095600,25126600,-1
564,1,STEP,990427137300,990451853700,24716400,-1
565,1,STEP,990451923200,990476659400,24736200,-1
566,1,STEP,990476724100,990501750000,25025900,-1
567,1,STEP,990501812100,990526827900,25015800,-1
568,1,STEP,990526887600,990552448300,25560700,-1
569,1,STEP,990552520100,990577873200,25353100,-1
570,1,STEP,990577933400,990602877000,24943600,-1
571,1,STEP,990602925400,990628780100,25854700,-1
572,1,STEP,990628831800,990654330200,25498400,-1
573,1,STEP,990654378600,990679414200,25035600,-1
574,1,STEP,990679485300,990704480800,24995500,-1
575,1,STEP,990704531100,990729440600,24909500,-1
576,1,STEP,990729489600,990754180300,24690700,-1
577,1,STEP,990754244000,990779828100,25584100,-1
578,1,STEP,990779877900,990805481700,25603800,-1
579,1,STEP,990805531600,990830477800,24946200,-1
580,1,STEP,990830541700,990855674300,25132600,-1
581,1,STEP,990855737300,990880795100,25057800,-1
582,1,STEP,990880854000,990905744000,24890000,-1
583,1,STEP,990905791400,990930370500,24579100,-1
584,1,STEP,990930429400,990955069200,24639800,-1
585,1,STEP,990955133800,990979731800,24598000,-1
586,1,STEP,990979790800,991004221600,24430800,-1
587,1,STEP,991004285300,991029252200,24966900,-1
588,1,STEP,991029306300,991053989900,24683600,-1
589,1,STEP,991054049000,991078327000,24278000,-1
590,1,STEP,991078373300,991103449400,25076100,-1
591,1,STEP,991103508300,991128348900,24840600,-1
592,1,STEP,991128402200,991153659800,25257600,-1
593,1,STEP,991153711900,991178033100,24321200,-1
594,1,STEP,991178096300,991203008600,24912300,-1
595,1,STEP,991203064600,991229573200,26508600,-1
596,1,STEP,991229626700,991254589400,24962700,-1
597,1,STEP,991254640300,991279340000,24699700,-1
598,1,STEP,991279387400,991304069900,24682500,-1
599,1,STEP,991304119200,991328825500,24706300,-1
600,1,STEP,991328880100,991353494700,24614600,-1
601,1,STEP,991353549500,991378079200,24529700,-1
602,1,STEP,991378134600,991402428000,24293400,-1
603,1,STEP,991402486100,991427272700,24786600,-1
604,1,STEP,991427347600,991452805800,25458200,-1
605,1,STEP,991452915300,991478281500,25366200,-1
606,1,STEP,991478328000,991503229700,24901700,-1
607,1,STEP,991503288100,991528039400,24751300,-1
608,1,STEP,991528091000,991552878200,24787200,-1
609,1,STEP,991552931100,991577711500,24780400,-1
610,1,STEP,991577756700,991602630600,24873900,-1
611,1,STEP,991602676700,991626165600,23488900,-1
612,1,STEP,991626209600,991649766800,23557200,-1
613,1,STEP,991649834600,991673311800,23477200,-1
614,1,STEP,991673361100,991696867000,23505900,-1
615,1,STEP,991696912400,991720132400,23220000,-1
616,1,STEP,991720191000,991743421800,23230800,-1
617,1,STEP,991743471700,991767569300,24097600,-1
618,1,STEP,991767612700,991790846200,23233500,-1
619,1,STEP,991790894400,991814384500,23490100,-1
620,1,STEP,991814431700,991837559700,23128000,-1
621,1,STEP,991837620400,991860233400,22613000,-1
622,1,STEP,991860302200,991883851600,23549400,-1
623,1,STEP,991883920000,991906439700,22519700,-1
624,1,STEP,991906492300,991929882300,23390000,-1
625,1,STEP,991929935300,991953441200,23505900,-1
626,1,STEP,991953496200,991976763300,23267100,-1
627,1,STEP,991976817100,992000117400,23300300,-1
628,1,STEP,992000172900,992023183900,23011000,-1
629,1,STEP,992023242700,992046170800,22928100,-1
630,1,STEP,992046224600,992069315000,23090400,-1
631,1,STEP,992069367200,992092957900,23590700,-1
632,1,STEP,992093005400,992115941000,22935600,-1
633,1,STEP,992115989100,992140572000,24582900,-1
634,1,STEP,992140619400,992164622200,24002800,-1
635,1,STEP,992164664600,992187851900,23187300,-1
636,1,STEP,992187908900,992211045600,23136700,-1
637,1,STEP,992211089900,992234652400,23562500,-1
638,1,STEP,992234712600,992257609500,22896900,-1
639,1,STEP,992257666400,992281483700,23817300,-1
640,1,STEP,992281534300,992304636900,23102600,-1
641,1,STEP,992304694200,992327425200,22731000,-1
642,1,STEP,992327480100,992351098700,23618600,-1
643,1,STEP,992351155700,992374715900,23560200,-1
644,1,STEP,992374772900,992399035300,24262400,-1
645,1,STEP,992399086300,992423241100,24154800,-1
646,1,STEP,992423324300,992446561000,23236700,-1
647,1,STEP,992446608500,992469266700,22658200,-1
648,1,STEP,992469310800,992493541200,24230400,-1
649,1,STEP,992493593600,992517030200,23436600,-1
650,1,STEP,992517077300,992540485300,23408000,-1
651,1,STEP,992540536900,992563803200,23266300,-1
652,1,STEP,992563858000,992586708000,22850000,-1
653,1,STEP,992586765900,992610293100,23527200,-1
654,1,STEP,992610338700,992633931200,23592500,-1
655,1,STEP,992633975200,992657327900,23352700,-1
656,1,STEP,992657378000,992680355500,22977500,-1
657,1,STEP,992680396800,992703718100,23321300,-1
658,1,STEP,992703769200,992726444100,22674900,-1
659,1,STEP,992726497700,992749587900,23090200,-1
660,1,STEP,992749629900,992772384200,22754300,-1
661,1,STEP,992772427000,992795245700,22818700,-1
662,1,STEP,992795308000,992818209100,22901100,-1
663,1,STEP,992818263500,992841133300,22869800,-1
664,1,STEP,992841175900,992864326800,23150900,-1
665,1,STEP,992864367900,992886943900,22576000,-1
666,1,STEP,992886999800,992909693600,22693800,-1
667,1,STEP,992909737900,992932505800,22767900,-1
668,1,STEP,992932572100,992955301100,22729000,-1
669,1,STEP,992955370100,992978682300,23312200,-1
670,1,STEP,992978733700,993001596700,22863000,-1
671,1,STEP,993001640900,993025259200,23618300,-1
672,1,STEP,993025311200,993048076300,22765100,-1
673,1,STEP,993048122400,993071444700,23322300,-1
674,1,STEP,993071488500,993094872100,23383600,-1
675,1,STEP,993094915200,993117742100,22826900,-1
676,1,STEP,993117790100,993141444800,23654700,-1
677,1,STEP,993141489400,993164289100,22799700,-1
678,1,STEP,993164340800,993187329500,22988700,-1
679,1,STEP,993187383800,993210291300,22907500,-1
680,1,STEP,993210334000,993233419100,23085100,-1
681,1,STEP,993233468200,993256748500,23280300,-1
682,1,STEP,993256795200,993279725400,22930200,-1
683,1,STEP,993279771400,993303348000,23576600,-1
684,1,STEP,993303398200,993326181500,22783300,-1
685,1,STEP,993326242800,993349086200,22843400,-1
686,1,STEP,993349142000,993372391800,23249800,-1
687,1,STEP,993372442700,993394856200,22413500,-1
688,1,STEP,993394904200,993418352100,23447900,-1
689,1,STEP,993418404500,993441911100,23506600,-1
690,1,STEP,993441967200,993465364000,23396800,-1
691,1,STEP,993465425100,993488395200,22970100,-1
692,1,STEP,993488465600,993511606200,23140600,-1
693,1,STEP,993511685300,993534808500,23123200,-1
694,1,STEP,993534892700,993557724800,22832100,-1
695,1,STEP,993557790700,993581629600,23838900,-1
696,1,STEP,993581710400,993605529600,23819200,-1
697,1,STEP,993605611300,993629007000,23395700,-1
698,1,STEP,993629081900,993652519300,23437400,-1
699,1,STEP,993652586900,993675796800,23209900,-1
700,1,STEP,993675866300,993698263400,22397100,-1
701,1,STEP,993698336000,993721058900,22722900,-1
702,1,STEP,993721121800,993743879300,22757500,-1
703,1,STEP,993743936200,993767423400,23487200,-1
704,1,STEP,993767479200,993790191900,22712700,-1
705,1,STEP,993790250000,993813457700,23207700,-1
706,1,STEP,993813508600,993836544800,23036200,-1
707,1,STEP,993836594500,993859179600,22585100,-1
708,1,STEP,993859241500,993882291900,23050400,-1
709,1,STEP,993882349100,993905789900,23440800,-1
710,1,STEP,993905850800,993929029300,23178500,-1
711,1,STEP,993929081000,993952468500,23387500,-1
712,1,STEP,993952521700,993975921100,23399400,-1
713,1,STEP,993975976700,993999191500,23214800,-1
714,1,STEP,993999253500,994022022600,22769100,-1
715,1,STEP,994022081600,994045701900,23620300,-1
716,1,STEP,994045769900,994069238200,23468300,-1
717,1,STEP,994069291600,994091873400,22581800,-1
718,1,STEP,994091923300,994114895300,22972000,-1
719,1,STEP,994114949600,994137602000,22652400,-1
720,1,STEP,994137658900,994160394100,22735200,-1
721,1,STEP,994160447100,994183473700,23026600,-1
722,1,STEP,994183524700,994207107700,23583000,-1
723,1,STEP,994207164300,994230294500,23130200,-1
724,1,STEP,994230346900,994255225300,24878400,-1
725,1,STEP,994255278200,994278793800,23515600,-1
726,1,STEP,994278840500,994301953300,23112800,-1
727,1,STEP,994302009500,994324806600,22797100,-1
728,1,STEP,994324856700,994347370200,22513500,-1
729,1,STEP,994347423200,994370272300,22849100,-1
730,1,STEP,994370333600,994394400100,24066500,-1
731,1,STEP,994394458600,994418553700,24095100,-1
732,1,STEP,994418604100,994442090800,23486700,-1
733,1,STEP,994442136200,994464856500,22720300,-1
734,1,STEP,994464898500,994488570900,23672400,-1
735,1,STEP,994488617500,994511640700,23023200,-1
736,1,STEP,994511692900,994535113200,23420300,-1
737,1,STEP,994535162000,994557830600,22668600,-1
738,1,STEP,994557877100,994581143200,23266100,-1
739,1,STEP,994581197600,994605063900,23866300,-1
740,1,STEP,994605120100,994627451000,22330900,-1
741,1,STEP,994627505400,994650089600,22584200,-1
742,1,STEP,994650152400,994672696300,22543900,-1
743,1,STEP,994672753300,994695615600,22862300,-1
744,1,STEP,994695671700,994718922400,23250700,-1
745,1,STEP,994718977000,994741974300,22997300,-1
746,1,STEP,994742025400,994765028300,23002900,-1
747,1,STEP,994765077700,994788094400,23016700,-1
748,1,STEP,994788147000,994811192400,23045400,-1
749,1,STEP,994811247200,994834436200,23189000,-1
750,1,STEP,994834488700,994857976800,23488100,-1
751,1,STEP,994858029900,994880792300,22762400,-1
752,1,STEP,994880857700,994903849900,22992200,-1
753,1,STEP,994903904500,994926929400,23024900,-1
754,1,STEP,994926984000,994949975500,22991500,-1
755,1,STEP,994950032500,994973583900,23551400,-1
756,1,STEP,994973650000,994996832000,23182000,-1
757,1,STEP,994996889200,995019811500,22922300,-1
758,1,STEP,995019867600,995043196000,23328400,-1
759,1,STEP,995043254800,995066534500,23279700,-1
760,1,STEP,995066628600,995089300800,22672200,-1
761,1,STEP,995089384300,995112039400,22655100,-1
762,1,STEP,995112089700,995134793200,22703500,-1
763,1,STEP,995134842900,995158175100,23332200,-1
764,1,STEP,995158225100,995182124600,23899500,-1
765,1,STEP,995182176800,995204667900,22491100,-1
766,1,STEP,995204721000,995227694800,22973800,-1
767,1,STEP,995227749800,995250726500,22976700,-1
768,1,STEP,995250848500,995275265200,24416700,-1
769,1,STEP,995275432300,995298689900,23257600,-1
770,1,STEP,995298738700,995321255000,22516300,-1
771,1,STEP,995321305000,995344632400,23327400,-1
772,1,STEP,995344711800,995367867700,23155900,-1
773,1,STEP,995367926200,995391803700,23877500,-1
774,1,STEP,995391857100,995414827800,22970700,-1
775,1,STEP,995414909800,995437997100,23087300,-1
776,1,STEP,995438072300,995460740400,22668100,-1
777,1,STEP,995460792500,995484334300,23541800,-1
778,1,STEP,995484393300,995507075100,22681800,-1
779,1,STEP,995507131500,995529637200,22505700,-1
780,1,STEP,995529694300,995552317800,22623500,-1
781,1,STEP,995552372200,995575404600,23032400,-1
782,1,STEP,995575465400,995597990500,22525100,-1
783,1,STEP,995598071600,995621536100,23464500,-1
784,1,STEP,995621594200,995643883500,22289300,-1
785,1,STEP,995643945400,995666486400,22541000,-1
786,1,STEP,995666535100,995689377900,22842800,-1
787,1,STEP,995689429200,995712596900,23167700,-1
788,1,STEP,995712656600,995735084700,22428100,-1
789,1,STEP,995735150200,995758007100,22856900,-1
790,1,STEP,995758062700,995780916400,22853700,-1
791,1,STEP,995780971800,995803710300,22738500,-1
792,1,STEP,995803763500,995827264400,23500900,-1
793,1,STEP,995827312900,995850447300,23134400,-1
794,1,STEP,995850576800,995875207400,24630600,-1
795,1,STEP,995875309600,995898208900,22899300,-1
796,1,STEP,995898252100,995921702100,23450000,-1
797,1,STEP,995921752000,995944835600,23083600,-1
798,1,STEP,995944892700,995968192500,23299800,-1
799,1,STEP,995968237300,995991131700,22894400,-1
800,1,STEP,995991190200,996013966700,22776500,-1
801,1,STEP,996014020100,996037922100,23902000,-1
802,1,STEP,996037977500,996060615200,22637700,-1
803,1,STEP,996060668700,996084292400,23623700,-1
804,1,STEP,996084342300,996107331000,22988700,-1
805,1,STEP,996107388600,996130228900,22840300,-1
806,1,STEP,996130298500,996153744800,23446300,-1
807,1,STEP,996153800600,996177313400,23512800,-1
808,1,STEP,996177400600,996199791000,22390400,-1
809,1,STEP,996199840900,996223205400,23364500,-1
810,1,STEP,996223262200,996245952000,22689800,-1
811,1,STEP,996246000500,996268609000,22608500,-1
812,1,STEP,996268676300,996291632900,22956600,-1
813,1,STEP,996291744800,996314712600,22967800,-1
814,1,STEP,996314800300,996337840300,23040000,-1
815,1,STEP,996337908000,996360050100,22142100,-1
816,1,STEP,996360103900,996383587100,23483200,-1
817,1,STEP,996383671000,996407186400,23515400,-1
818,1,STEP,996407249700,996431368400,24118700,-1
819,1,STEP,996431421700,996454465200,23043500,-1
820,1,STEP,996454524900,996477342600,22817700,-1
821,1,STEP,996477407300,996500145100,22737800,-1
822,1,STEP,996500212000,996523501600,23289600,-1
823,1,STEP,996523570500,996547735200,24164700,-1
824,1,STEP,996547798100,996572037700,24239600,-1
825,1,STEP,996572113900,996601940400,29826500,-1
826,1,STEP,996602024300,996627486100,25461800,-1
827,1,STEP,996627553400,996651272400,23719000,-1
828,1,STEP,996651335100,996675252900,23917800,-1
829,1,STEP,996675313800,996700012100,24698300,-1
830,1,STEP,996700066000,996724708100,24642100,-1
831,1,STEP,996724760100,996748787100,24027000,-1
832,1,STEP,996748839900,996773690200,24850300,-1
833,1,STEP,996773744500,996799254600,25510100,-1
834,1,STEP,996799307300,996824071300,24764000,-1
835,1,STEP,996824128100,996848612400,24484300,-1
836,1,STEP,996848673700,996873709400,25035700,-1
837,1,STEP,996873765000,996898560200,24795200,-1
838,1,STEP,996898610500,996922749600,24139100,-1
839,1,STEP,996922801600,996947381300,24579700,-1
840,1,STEP,996947433100,996972140600,24707500,-1
841,1,STEP,996972202000,996997074700,24872700,-1
842,1,STEP,996997127100,997022363500,25236400,-1
843,1,STEP,997022417300,997047524100,25106800,-1
844,1,STEP,997047573700,997072199700,24626000,-1
845,1,STEP,997072245400,997097468600,25223200,-1
846,1,STEP,997097534300,997121520000,23985700,-1
847,1,STEP,997121577200,997145843900,24266700,-1
848,1,STEP,997145901200,997170083500,24182300,-1
849,1,STEP,997170136000,997195080900,24944900,-1
850,1,STEP,997195137100,997219919800,24782700,-1
851,1,STEP,997219974500,997245047800,25073300,-1
852,1,STEP,997245094600,997269969200,24874600,-1
853,1,STEP,997270021900,997294357800,24335900,-1
854,1,STEP,997294409100,997318649300,24240200,-1
855,1,STEP,997318702600,997343691800,24989200,-1
856,1,STEP,997343744400,997368206500,24462100,-1
857,1,STEP,997368253100,997392545000,24291900,-1
858,1,STEP,997392597300,997416882900,24285600,-1
859,1,STEP,997416928000,997441398700,24470700,-1
860,1,STEP,997441459300,997465831400,24372100,-1
861,1,STEP,997465886300,997490026600,24140300,-1
862,1,STEP,997490086700,997514137200,24050500,-1
863,1,STEP,997514197600,997538869000,24671400,-1
864,1,STEP,997538926900,997563704000,24777100,-1
865,1,STEP,997563753000,997588023000,24270000,-1
866,1,STEP,997588076100,997612581300,24505200,-1
867,1,STEP,997612634000,997636873900,24239900,-1
868,1,STEP,997636928800,997661076000,24147200,-1
869,1,STEP,997661126200,997685960200,24834000,-1
870,1,STEP,997686005300,997710484900,24479600,-1
871,1,STEP,997710546800,997735290900,24744100,-1
872,1,STEP,997735345700,997759405900,24060200,-1
873,1,STEP,997759457100,997783654600,24197500,-1
874,1,STEP,997783709100,997809489000,25779900,-1
875,1,STEP,997809623300,997835466300,25843000,-1
876,1,STEP,997835522600,997860365700,24843100,-1
877,1,STEP,997860416100,997884787900,24371800,-1
878,1,STEP,997884835700,997908854300,24018600,-1
879,1,STEP,997908904400,997932944100,24039700,-1
880,1,STEP,997933000800,997958142800,25142000,-1
881,1,STEP,997958202100,997982038600,23836500,-1
882,1,STEP,997982101500,998006314100,24212600,-1
883,1,STEP,998006385600,998030716500,24330900,-1
884,1,STEP,998030768600,998054663800,23895200,-1
885,1,STEP,998054723000,998079270100,24547100,-1
886,1,STEP,998079326200,998103005300,23679100,-1
887,1,STEP,998103068500,998126975500,23907000,-1
888,1,STEP,998127038900,998150957500,23918600,-1
889,1,STEP,998151021700,998174911200,23889500,-1
890,1,STEP,998174973100,998199233900,24260800,-1
891,1,STEP,998199301200,998223250900,23949700,-1
892,1,STEP,998223313200,998246775000,23461800,-1
893,1,STEP,998246833800,998270813800,23980000,-1
894,1,STEP,998270909400,998295199800,24290400,-1
895,1,STEP,998295263700,998318614300,23350600,-1
896,1,STEP,998318676500,998342530000,23853500,-1
897,1,STEP,998342599500,998366421000,23821500,-1
898,1,STEP,998366496200,998391062200,24566000,-1
899,1,STEP,998391141500,998415086300,23944800,-1
900,1,STEP,998415189400,998439177200,23987800,-1
901,1,STEP,998439228300,998462984400,23756100,-1
902,1,STEP,998463027800,998486992400,23964600,-1
903,1,STEP,998487046600,998511487600,24441000,-1
904,1,STEP,998511538300,998535724000,24185700,-1
905,1,STEP,998535776900,998559827200,24050300,-1
906,1,STEP,998559883800,998583996200,24112400,-1
907,1,STEP,998584048000,998607638000,23590000,-1
908,1,STEP,998607692900,998631372000,23679100,-1
909,1,STEP,998631456200,998655106000,23649800,-1
910,1,STEP,998655184800,998679655500,24470700,-1
911,1,STEP,998679728700,998703370500,23641800,-1
912,1,STEP,998703433900,998727977300,24543400,-1
913,1,STEP,998728081400,998752516000,24434600,-1
914,1,STEP,998752578400,998776912200,24333800,-1
915,1,STEP,998776973100,998801293100,24320000,-1
916,1,STEP,998801349600,998825378800,24029200,-1
917,1,STEP,998825454100,998849592000,24137900,-1
918,1,STEP,998849646900,998873905300,24258400,-1
919,1,STEP,998873983200,998898114100,24130900,-1
920,1,STEP,998898219700,998923975800,25756100,-1
921,1,STEP,998924036900,998948182900,24146000,-1
922,1,STEP,998948235900,998972663900,24428000,-1
923,1,STEP,998972740300,998996744100,24003800,-1
924,1,STEP,998996810500,999020942700,24132200,-1
925,1,STEP,999020995000,999046462600,25467600,-1
926,1,STEP,999046526400,999070850000,24323600,-1
927,1,STEP,999070902800,999095310200,24407400,-1
928,1,STEP,999095366800,999119607200,24240400,-1
929,1,STEP,999119693700,999143503700,23810000,-1
930,1,STEP,999143583800,999167960500,24376700,-1
931,1,STEP,999168020400,999192386200,24365800,-1
932,1,STEP,999192446900,999216749400,24302500,-1
933,1,STEP,999216803800,999241460400,24656600,-1
934,1,STEP,999241527500,999265667900,24140400,-1
935,1,STEP,999265720000,999289514100,23794100,-1
936,1,STEP,999289582800,999313686800,24104000,-1
937,1,STEP,999313760900,999338218400,24457500,-1
938,1,STEP,999338285100,999362558300,24273200,-1
939,1,STEP,999362617400,999386627300,24009900,-1
940,1,STEP,999386693600,999410724300,24030700,-1
941,1,STEP,999410784400,999434907400,24123000,-1
942,1,STEP,999434967900,999459048500,24080600,-1
943,1,STEP,999459107100,999483366300,24259200,-1
944,1,STEP,999483424900,999507458300,24033400,-1
945,1,STEP,999507517000,999532415700,24898700,-1
946,1,STEP,999532479100,999557574100,25095000,-1
947,1,STEP,999557631900,999581973600,24341700,-1
948,1,STEP,999582035000,999606083200,24048200,-1
949,1,STEP,999606138900,999630044800,23905900,-1
950,1,STEP,999630104400,999654459900,24355500,-1
951,1,STEP,999654523700,999678423200,23899500,-1
952,1,STEP,999678484200,999702812800,24328600,-1
953,1,STEP,999702867200,999726822400,23955200,-1
954,1,STEP,999726885300,999750847100,23961800,-1
955,1,STEP,999750902700,999776303800,25401100,-1
956,1,STEP,999776365400,999800620500,24255100,-1
957,1,STEP,999800672100,999824676200,24004100,-1
958,1,STEP,999824737400,999847849600,23112200,-1
959,1,STEP,999847903100,999870582800,22679700,-1
960,1,STEP,999870637500,999893637900,23000400,-1
961,1,STEP,999893697600,999916715800,23018200,-1
962,1,STEP,999916774000,999940053600,23279600,-1
963,1,STEP,999940104800,999963956100,23851300,-1
964,1,STEP,999964016300,999987095700,23079400,-1
965,1,STEP,999987149400,1000010023700,22874300,-1
966,1,STEP,1000010075000,1000032992200,22917200,-1
967,1,STEP,1000033070900,1000055925700,22854800,-1
968,1,STEP,1000055978700,1000079406300,23427600,-1
969,1,STEP,1000079457200,1000102339100,22881900,-1
970,1,STEP,1000102394600,1000125590900,23196300,-1
971,1,STEP,1000125645300,1000148862200,23216900,-1
972,1,STEP,1000148918300,1000171986600,23068300,-1
973,1,STEP,1000172047900,1000194969400,22921500,-1
974,1,STEP,1000195029700,1000218853600,23823900,-1
975,1,STEP,1000218906300,1000241817000,22910700,-1
976,1,STEP,1000241872700,1000264814600,22941900,-1
977,1,STEP,1000264864200,1000289053000,24188800,-1
978,1,STEP,1000289126400,1000312062100,22935700,-1
979,1,STEP,1000312123800,1000335230000,23106200,-1
980,1,STEP,1000335298700,1000358516200,23217500,-1
981,1,STEP,1000358580800,1000381595800,23015000,-1
982,1,STEP,1000381658500,1000405370700,23712200,-1
983,1,STEP,1000405429400,1000428771900,23342500,-1
984,1,STEP,1000428830700,1000452600000,23769300,-1
985,1,STEP,1000452653200,1000475513300,22860100,-1
986,1,STEP,1000475562300,1000498437400,22875100,-1
987,1,STEP,1000498525600,1000522495200,23969600,-1
988,1,STEP,1000522552000,1000546423000,23871000,-1
989,1,STEP,1000546479100,1000569849500,23370400,-1
990,1,STEP,1000569905400,1000592932900,23027500,-1
991,1,STEP,1000592982400,1000616262600,23280200,-1
992,1,STEP,1000616325800,1000639693800,23368000,-1
993,1,STEP,1000639747600,1000663206100,23458500,-1
994,1,STEP,1000663258100,1000686421700,23163600,-1
995,1,STEP,1000686482000,1000709455400,22973400,-1
996,1,STEP,1000709510900,1000733365600,23854700,-1
997,1,STEP,1000733431800,1000756801900,23370100,-1
998,1,STEP,1000756864000,1000779253900,22389900,-1
999,1,STEP,1000779314200,1000802549800,23235600,-1
