Gen,Resource,Stamp,TimeStamp_Start,TimeStamp_End,Duration,Indiv_id
0,1,TransfertToDevice,426957814700,427266570600,308755900,-1
0,1,STEP,427388349000,427391874500,3525500,-1
1,1,STEP,427391945200,427394948800,3003600,-1
2,1,STEP,427395021900,427397792800,2770900,-1
3,1,STEP,427397859100,427400495900,2636800,-1
4,1,STEP,427400539700,427402942800,2403100,-1
5,1,STEP,427402975800,427405617800,2642000,-1
6,1,STEP,427405686400,427408559500,2873100,-1
7,1,STEP,427408601500,427411281900,2680400,-1
8,1,STEP,427411343200,427414320900,2977700,-1
9,1,STEP,427414362800,427416748900,2386100,-1
10,1,STEP,427416823300,427419726100,2902800,-1
11,1,STEP,427419782000,427422499600,2717600,-1
12,1,STEP,427422540400,427425220300,2679900,-1
13,1,STEP,427425277300,427427788600,2511300,-1
14,1,STEP,427427831500,427430716500,2885000,-1
15,1,STEP,427430753900,427433702000,2948100,-1
16,1,STEP,427433759600,427436494500,2734900,-1
17,1,STEP,427436534500,427439239400,2704900,-1
18,1,STEP,427439299100,427441912800,2613700,-1
19,1,STEP,427441957300,427444305400,2348100,-1
20,1,STEP,427444343800,427447051200,2707400,-1
21,1,STEP,427447106800,427449809700,2702900,-1
22,1,STEP,427449849200,427452702000,2852800,-1
23,1,STEP,427452751700,427455504300,2752600,-1
24,1,STEP,427455549900,427458268300,2718400,-1
25,1,STEP,427458311900,427460776500,2464600,-1
26,1,STEP,427460831900,427463441100,2609200,-1
27,1,STEP,427463486300,427466240100,2753800,-1
28,1,STEP,427466308700,427469234400,2925700,-1
29,1,STEP,427469285100,427471694100,2409000,-1
30,1,STEP,427471733100,427474604800,2871700,-1
31,1,STEP,427474666600,427477196100,2529500,-1
32,1,STEP,427477243700,427480090700,2847000,-1
33,1,STEP,427480154300,427483161700,3007400,-1
34,1,STEP,427483203800,427486134500,2930700,-1
35,1,STEP,427486169500,427489245000,3075500,-1
36,1,STEP,427489304500,427492724700,3420200,-1
37,1,STEP,427492760800,427496110900,3350100,-1
38,1,STEP,427496160000,427499345900,3185900,-1
39,1,STEP,427499377100,427502558400,3181300,-1
40,1,STEP,427502607000,427505274100,2667100,-1
41,1,STEP,427505317600,427508020400,2702800,-1
42,1,STEP,427508083200,427510730800,2647600,-1
43,1,STEP,427510769300,427513335200,2565900,-1
44,1,STEP,427513376700,427515960300,2583600,-1
45,1,STEP,427516006900,427518734900,2728000,-1
46,1,STEP,427518769900,427521404900,2635000,-1
47,1,STEP,427521497000,427524180000,2683000,-1
48,1,STEP,427524228500,427526768900,2540400,-1
49,1,STEP,427526806700,427529499400,2692700,-1
50,1,STEP,427529557400,427532197700,2640300,-1
51,1,STEP,427532238800,427534821900,2583100,-1
52,1,STEP,427534865700,427537610900,2745200,-1
53,1,STEP,427537666000,427540246600,2580600,-1
54,1,STEP,427540285100,427542954800,2669700,-1
55,1,STEP,427543010700,427545715800,2705100,-1
56,1,STEP,427545761600,427548429400,2667800,-1
57,1,STEP,427548466200,427551371600,2905400,-1
58,1,STEP,427551439800,427554293300,2853500,-1
59,1,STEP,427554323900,427557051100,2727200,-1
60,1,STEP,427557100400,427559712000,2611600,-1
61,1,STEP,427559744000,427562223300,2479300,-1
62,1,STEP,427562256400,427564896600,2640200,-1
63,1,STEP,427564968000,427567737600,2769600,-1
64,1,STEP,427567788500,427570578300,2789800,-1
65,1,STEP,427570643300,427573617900,2974600,-1
66,1,STEP,427573669200,427576631200,2962000,-1
67,1,STEP,427576678500,427579552600,2874100,-1
68,1,STEP,427579601900,427582932300,3330400,-1
69,1,STEP,427582962800,427586004700,3041900,-1
70,1,STEP,427586054500,427588758700,2704200,-1
71,1,STEP,427588788300,427591652200,2863900,-1
72,1,STEP,427591702100,427594298000,2595900,-1
73,1,STEP,427594341500,427597326700,2985200,-1
74,1,STEP,427597379800,427600093100,2713300,-1
75,1,STEP,427600142400,427603063000,2920600,-1
76,1,STEP,427603105400,427606611500,3506100,-1
77,1,STEP,427606662000,427609744200,3082200,-1
78,1,STEP,427609781500,427613017400,3235900,-1
79,1,STEP,427613076500,427616095100,3018600,-1
80,1,STEP,427616145900,427619188500,3042600,-1
81,1,STEP,427619237200,427622568400,3331200,-1
82,1,STEP,427622605400,427625761800,3156400,-1
83,1,STEP,427625828200,427628958500,3130300,-1
84,1,STEP,427629005300,427632342600,3337300,-1
85,1,STEP,427632405100,427635447500,3042400,-1
86,1,STEP,427635512600,427638808300,3295700,-1
87,1,STEP,427638847000,427642196600,3349600,-1
88,1,STEP,427642252200,427645590400,3338200,-1
89,1,STEP,427645624000,427648562800,2938800,-1
90,1,STEP,427648612300,427651106900,2494600,-1
91,1,STEP,427651138900,427653987100,2848200,-1
92,1,STEP,427654033800,427656553400,2519600,-1
93,1,STEP,427656597100,427659095900,2498800,-1
94,1,STEP,427659127800,427661894700,2766900,-1
95,1,STEP,427661941500,427664461400,2519900,-1
96,1,STEP,427664493600,427667051400,2557800,-1
97,1,STEP,427667089900,427669757800,2667900,-1
98,1,STEP,427669803100,427672427600,2624500,-1
99,1,STEP,427672464300,427675334600,2870300,-1
100,1,STEP,427675398400,427678047900,2649500,-1
101,1,STEP,427678090000,427681161100,3071100,-1
102,1,STEP,427681263100,427684755700,3492600,-1
103,1,STEP,427684804500,427687995000,3190500,-1
104,1,STEP,427688073600,427691256700,3183100,-1
105,1,STEP,427691318300,427694445000,3126700,-1
106,1,STEP,427694496200,427697843400,3347200,-1
107,1,STEP,427697899700,427701288900,3389200,-1
108,1,STEP,427701348300,427704803500,3455200,-1
109,1,STEP,427704864100,427707863600,2999500,-1
110,1,STEP,427707902400,427711115700,3213300,-1
111,1,STEP,427711172500,427714136500,2964000,-1
112,1,STEP,427714176200,427717274600,3098400,-1
113,1,STEP,427717404200,427720311100,2906900,-1
114,1,STEP,427720343800,427723423800,3080000,-1
115,1,STEP,427723468600,427726469000,3000400,-1
116,1,STEP,427726516900,427729539100,3022200,-1
117,1,STEP,427729586100,427732650100,3064000,-1
118,1,STEP,427732705900,427735651200,2945300,-1
119,1,STEP,427735685100,427738887100,3202000,-1
120,1,STEP,427738941300,427741874800,2933500,-1
121,1,STEP,427741906600,427744951500,3044900,-1
122,1,STEP,427745139600,427748265100,3125500,-1
123,1,STEP,427748313600,427751590300,3276700,-1
124,1,STEP,427751651200,427754575300,2924100,-1
125,1,STEP,427754611700,427758026900,3415200,-1
126,1,STEP,427758074700,427761344600,3269900,-1
127,1,STEP,427761398000,427764649200,3251200,-1
128,1,STEP,427764780700,427768030300,3249600,-1
129,1,STEP,427768084100,427770596400,2512300,-1
130,1,STEP,427770624900,427773463900,2839000,-1
131,1,STEP,427773513600,427776142700,2629100,-1
132,1,STEP,427776176800,427779303200,3126400,-1
133,1,STEP,427779360100,427782797400,3437300,-1
134,1,STEP,427782833100,427785751100,2918000,-1
135,1,STEP,427785794800,427788638100,2843300,-1
136,1,STEP,427788682800,427791230600,2547800,-1
137,1,STEP,427791264100,427793891600,2627500,-1
138,1,STEP,427793938900,427796506600,2567700,-1
139,1,STEP,427796540600,427799199700,2659100,-1
140,1,STEP,427799237700,427802176400,2938700,-1
141,1,STEP,427802231600,427804836000,2604400,-1
142,1,STEP,427804872500,427807695400,2822900,-1
143,1,STEP,427807751600,427810422200,2670600,-1
144,1,STEP,427810462900,427813452700,2989800,-1
145,1,STEP,427813536000,427816717800,3181800,-1
146,1,STEP,427816777400,427819925100,3147700,-1
147,1,STEP,427819967900,427822880500,2912600,-1
148,1,STEP,427822930700,427825721900,2791200,-1
149,1,STEP,427825764400,427828993500,3229100,-1
150,1,STEP,427829066800,427832386300,3319500,-1
151,1,STEP,427832426000,427835035300,2609300,-1
152,1,STEP,427835090600,427837711100,2620500,-1
153,1,STEP,427837745600,427840234400,2488800,-1
154,1,STEP,427840264300,427842822800,2558500,-1
155,1,STEP,427842871000,427845435100,2564100,-1
156,1,STEP,427845466800,427847817300,2350500,-1
157,1,STEP,427847856000,427850671400,2815400,-1
158,1,STEP,427850725800,427853321300,2595500,-1
159,1,STEP,427853354400,427856014000,2659600,-1
160,1,STEP,427856074200,427858567900,2493700,-1
161,1,STEP,427858599000,427860877700,2278700,-1
162,1,STEP,427860911600,427863234500,2322900,-1
163,1,STEP,427863299300,427865665900,2366600,-1
164,1,STEP,427865701800,427868011800,2310000,-1
165,1,STEP,427868048000,427870375200,2327200,-1
166,1,STEP,427870425200,427872928700,2503500,-1
167,1,STEP,427872969400,427875661100,2691700,-1
168,1,STEP,427875744700,427878557800,2813100,-1
169,1,STEP,427878609200,427881204400,2595200,-1
170,1,STEP,427881247700,427883581700,2334000,-1
171,1,STEP,427883652900,427886101500,2448600,-1
172,1,STEP,427886143200,427888588600,2445400,-1
173,1,STEP,427888628700,427891106400,2477700,-1
174,1,STEP,427891175700,427893742800,2567100,-1
175,1,STEP,427893773900,427896490500,2716600,-1
176,1,STEP,427896574000,427899039100,2465100,-1
177,1,STEP,427899087200,427901491300,2404100,-1
178,1,STEP,427901528700,427904177300,2648600,-1
179,1,STEP,427904241600,427906820800,2579200,-1
180,1,STEP,427906863700,427909308600,2444900,-1
181,1,STEP,427909340400,427911762400,2422000,-1
182,1,STEP,427911813400,427914067800,2254400,-1
183,1,STEP,427914101000,427916626800,2525800,-1
184,1,STEP,427916662800,427918984200,2321400,-1
185,1,STEP,427919033800,427921544400,2510600,-1
186,1,STEP,427921577200,427924251600,2674400,-1
187,1,STEP,427924295900,427926780700,2484800,-1
188,1,STEP,427926840500,427929676000,2835500,-1
189,1,STEP,427929712800,427932540100,2827300,-1
190,1,STEP,427932613400,427935214700,2601300,-1
191,1,STEP,427935253900,427937667500,2413600,-1
192,1,STEP,427937725500,427940087600,2362100,-1
193,1,STEP,427940138100,427942521400,2383300,-1
194,1,STEP,427942570400,427945256500,2686100,-1
195,1,STEP,427945346800,427947814300,2467500,-1
196,1,STEP,427947870300,427950238000,2367700,-1
197,1,STEP,427950281800,427952733200,2451400,-1
198,1,STEP,427952794000,427955163800,2369800,-1
199,1,STEP,427955209400,427957682600,2473200,-1
200,1,STEP,427957726300,427960310800,2584500,-1
201,1,STEP,427960368100,427962792200,2424100,-1
202,1,STEP,427962858700,427965256400,2397700,-1
203,1,STEP,427965308300,427968043300,2735000,-1
204,1,STEP,427968107700,427970481400,2373700,-1
205,1,STEP,427970519800,427973017700,2497900,-1
206,1,STEP,427973075100,427975794600,2719500,-1
207,1,STEP,427975869100,427978523400,2654300,-1
208,1,STEP,427978589700,427981397200,2807500,-1
209,1,STEP,427981459900,427984346400,2886500,-1
210,1,STEP,427984389300,427987207600,2818300,-1
211,1,STEP,427987262200,427990140700,2878500,-1
212,1,STEP,427990203100,427993434000,3230900,-1
213,1,STEP,427993485100,427996730400,3245300,-1
214,1,STEP,427996765900,427999532300,2766400,-1
215,1,STEP,427999562600,428002249300,2686700,-1
216,1,STEP,428002290600,428004879700,2589100,-1
217,1,STEP,428004909900,428007498800,2588900,-1
218,1,STEP,428007550100,428011055000,3504900,-1
219,1,STEP,428011096000,428014374100,3278100,-1
220,1,STEP,428014416000,428017333000,2917000,-1
221,1,STEP,428017372100,428020254700,2882600,-1
222,1,STEP,428020284700,428023611500,3326800,-1
223,1,STEP,428023659500,428026891400,3231900,-1
224,1,STEP,428026925100,428030379800,3454700,-1
225,1,STEP,428030433500,428033838700,3405200,-1
226,1,STEP,428033881800,428037315200,3433400,-1
227,1,STEP,428037371200,428040622200,3251000,-1
228,1,STEP,428040659200,428043667000,3007800,-1
229,1,STEP,428043710800,428046641500,2930700,-1
230,1,STEP,428046674300,428049602800,2928500,-1
231,1,STEP,428049645800,428052686500,3040700,-1
232,1,STEP,428052717700,428055170200,2452500,-1
233,1,STEP,428055205000,428057639600,2434600,-1
234,1,STEP,428057679900,428059942000,2262100,-1
235,1,STEP,428059969000,428062277700,2308700,-1
236,1,STEP,428062303900,428064658700,2354800,-1
237,1,STEP,428064696700,428067199000,2502300,-1
238,1,STEP,428067228400,428070210400,2982000,-1
239,1,STEP,428070256100,428073310500,3054400,-1
240,1,STEP,428073339800,428076160700,2820900,-1
241,1,STEP,428076190400,428078599100,2408700,-1
242,1,STEP,428078638200,428081020700,2382500,-1
243,1,STEP,428081048500,428083631300,2582800,-1
244,1,STEP,428083668800,428087042400,3373600,-1
245,1,STEP,428087096500,428090210500,3114000,-1
246,1,STEP,428090253300,428093071200,2817900,-1
247,1,STEP,428093116000,428095867700,2751700,-1
248,1,STEP,428095907500,428098378200,2470700,-1
249,1,STEP,428098421800,428101152300,2730500,-1
250,1,STEP,428101190900,428103753100,2562200,-1
251,1,STEP,428103789400,428106583100,2793700,-1
252,1,STEP,428106634900,428109347100,2712200,-1
253,1,STEP,428109386100,428112055200,2669100,-1
254,1,STEP,428112098900,428114450700,2351800,-1
255,1,STEP,428114488100,428116865400,2377300,-1
256,1,STEP,428116917000,428119397500,2480500,-1
257,1,STEP,428119441100,428121825500,2384400,-1
258,1,STEP,428121864900,428124244700,2379800,-1
259,1,STEP,428124284900,428126634200,2349300,-1
260,1,STEP,428126690500,428129088800,2398300,-1
261,1,STEP,428129127800,428131485500,2357700,-1
262,1,STEP,428131525000,428133913000,2388000,-1
263,1,STEP,428133956100,428136356600,2400500,-1
264,1,STEP,428136397600,428139001300,2603700,-1
265,1,STEP,428139027100,428141488000,2460900,-1
266,1,STEP,428141516900,428144001100,2484200,-1
267,1,STEP,428144025800,428146390200,2364400,-1
268,1,STEP,428146418800,428148783000,2364200,-1
269,1,STEP,428148809900,428151259800,2449900,-1
270,1,STEP,428151290600,428153741000,2450400,-1
271,1,STEP,428153773800,428156338900,2565100,-1
272,1,STEP,428156367300,428158819900,2452600,-1
273,1,STEP,428158847000,428161283300,2436300,-1
274,1,STEP,428161313200,428163579600,2266400,-1
275,1,STEP,428163606300,428165857600,2251300,-1
276,1,STEP,428165885600,428168213100,2327500,-1
277,1,STEP,428168249100,428170487900,2238800,-1
278,1,STEP,428170515100,428172753100,2238000,-1
279,1,STEP,428172780100,428175003700,2223600,-1
280,1,STEP,428175034100,428177459900,2425800,-1
281,1,STEP,428177490300,428179954400,2464100,-1
282,1,STEP,428179982100,428182774200,2792100,-1
283,1,STEP,428182867200,428185503400,2636200,-1
284,1,STEP,428185536300,428188275800,2739500,-1
285,1,STEP,428188316000,428190994800,2678800,-1
286,1,STEP,428191039900,428194171800,3131900,-1
287,1,STEP,428194213800,428197385800,3172000,-1
288,1,STEP,428197421800,428200754700,3332900,-1
289,1,STEP,428200786100,428203964200,3178100,-1
290,1,STEP,428203998500,428206844000,2845500,-1
291,1,STEP,428206875300,428209737300,2862000,-1
292,1,STEP,428209769900,428212248600,2478700,-1
293,1,STEP,428212278300,428214970700,2692400,-1
294,1,STEP,428215020900,428217841900,2821000,-1
295,1,STEP,428217903600,428220588400,2684800,-1
296,1,STEP,428220635800,428223357000,2721200,-1
297,1,STEP,428223405700,428226065700,2660000,-1
298,1,STEP,428226123300,428228778800,2655500,-1
299,1,STEP,428228816900,428231910300,3093400,-1
300,1,STEP,428231953400,428234783200,2829800,-1
301,1,STEP,428234812100,428237462800,2650700,-1
302,1,STEP,428237500400,428239975300,2474900,-1
303,1,STEP,428240004500,428242554800,2550300,-1
304,1,STEP,428242584400,428245330900,2746500,-1
305,1,STEP,428245382400,428248246700,2864300,-1
306,1,STEP,428248283300,428251694900,3411600,-1
307,1,STEP,428251742600,428254813700,3071100,-1
308,1,STEP,428254847100,428257914400,3067300,-1
309,1,STEP,428257984900,428261155600,3170700,-1
310,1,STEP,428261200900,428264179300,2978400,-1
311,1,STEP,428264217400,428267052400,2835000,-1
312,1,STEP,428267094600,428269928800,2834200,-1
313,1,STEP,428269963000,428272585200,2622200,-1
314,1,STEP,428272625700,428275188100,2562400,-1
315,1,STEP,428275227700,428277801200,2573500,-1
316,1,STEP,428277835800,428280498600,2662800,-1
317,1,STEP,428280536200,428283466600,2930400,-1
318,1,STEP,428283499600,428286343900,2844300,-1
319,1,STEP,428286386300,428288941400,2555100,-1
320,1,STEP,428288992400,428291832600,2840200,-1
321,1,STEP,428291877200,428294793100,2915900,-1
322,1,STEP,428294835500,428297291100,2455600,-1
323,1,STEP,428297324600,428300009200,2684600,-1
324,1,STEP,428300056700,428302455900,2399200,-1
325,1,STEP,428302485900,428305051200,2565300,-1
326,1,STEP,428305080600,428307605500,2524900,-1
327,1,STEP,428307644200,428310058900,2414700,-1
328,1,STEP,428310089100,428312590400,2501300,-1
329,1,STEP,428312620000,428315208100,2588100,-1
330,1,STEP,428315251500,428317698200,2446700,-1
331,1,STEP,428317729900,428320413700,2683800,-1
332,1,STEP,428320447600,428322901300,2453700,-1
333,1,STEP,428322932400,428325366000,2433600,-1
334,1,STEP,428325395300,428327932800,2537500,-1
335,1,STEP,428327971200,428330506200,2535000,-1
336,1,STEP,428330544500,428333154300,2609800,-1
337,1,STEP,428333186900,428335774300,2587400,-1
338,1,STEP,428335813000,428338315200,2502200,-1
339,1,STEP,428338347300,428341069000,2721700,-1
340,1,STEP,428341121800,428343656500,2534700,-1
341,1,STEP,428343698200,428346199800,2501600,-1
342,1,STEP,428346236000,428348939000,2703000,-1
343,1,STEP,428349000700,428351474300,2473600,-1
344,1,STEP,428351507000,428354021400,2514400,-1
345,1,STEP,428354053600,428356748400,2694800,-1
346,1,STEP,428356800800,428359328400,2527600,-1
347,1,STEP,428359362700,428362133800,2771100,-1
348,1,STEP,428362180000,428365467300,3287300,-1
349,1,STEP,428365513400,428368039100,2525700,-1
350,1,STEP,428368073000,428370688000,2615000,-1
351,1,STEP,428370735200,428373244600,2509400,-1
352,1,STEP,428373278900,428376024100,2745200,-1
353,1,STEP,428376079200,428378669100,2589900,-1
354,1,STEP,428378707600,428381246700,2539100,-1
355,1,STEP,428381279100,428383942300,2663200,-1
356,1,STEP,428383991200,428386527700,2536500,-1
357,1,STEP,428386563500,428389010300,2446800,-1
358,1,STEP,428389043300,428391761200,2717900,-1
359,1,STEP,428391831300,428394406800,2575500,-1
360,1,STEP,428394446200,428397129400,2683200,-1
361,1,STEP,428397182800,428399728200,2545400,-1
362,1,STEP,428399761500,428402251800,2490300,-1
363,1,STEP,428402283800,428404884400,2600600,-1
364,1,STEP,428404950500,428407462600,2512100,-1
365,1,STEP,428407494500,428410010900,2516400,-1
366,1,STEP,428410054800,428412835100,2780300,-1
367,1,STEP,428412883700,428415367400,2483700,-1
368,1,STEP,428415400800,428418072600,2671800,-1
369,1,STEP,428418113300,428420663800,2550500,-1
370,1,STEP,428420697700,428423176200,2478500,-1
371,1,STEP,428423207900,428425862100,2654200,-1
372,1,STEP,428425900600,428428704400,2803800,-1
373,1,STEP,428428762100,428431650400,2888300,-1
374,1,STEP,428431707300,428434542800,2835500,-1
375,1,STEP,428434585100,428437196400,2611300,-1
376,1,STEP,428437235500,428440073100,2837600,-1
377,1,STEP,428440122200,428443438300,3316100,-1
378,1,STEP,428443471100,428446901000,3429900,-1
379,1,STEP,428446940700,428450105500,3164800,-1
380,1,STEP,428450134300,428453318000,3183700,-1
381,1,STEP,428453440900,428456366200,2925300,-1
382,1,STEP,428456399200,428459344600,2945400,-1
383,1,STEP,428459385000,428462568800,3183800,-1
384,1,STEP,428462609400,428465962100,3352700,-1
385,1,STEP,428466025200,428469499400,3474200,-1
386,1,STEP,428469530900,428472606200,3075300,-1
387,1,STEP,428472634800,428475736100,3101300,-1
388,1,STEP,428475773600,428478540700,2767100,-1
389,1,STEP,428478570600,428481391100,2820500,-1
390,1,STEP,428481439900,428484083800,2643900,-1
391,1,STEP,428484119300,428487079300,2960000,-1
392,1,STEP,428487140600,428490265700,3125100,-1
393,1,STEP,428490303700,428493521700,3218000,-1
394,1,STEP,428493567300,428496578700,3011400,-1
395,1,STEP,428496655000,428500783100,4128100,-1
396,1,STEP,428500842800,428503893500,3050700,-1
397,1,STEP,428503941900,428506789700,2847800,-1
398,1,STEP,428506821800,428509534400,2712600,-1
399,1,STEP,428509576800,428512409800,2833000,-1
400,1,STEP,428512442800,428515586200,3143400,-1
401,1,STEP,428515626100,428518262600,2636500,-1
402,1,STEP,428518300200,428521172500,2872300,-1
403,1,STEP,428521204400,428524141200,2936800,-1
404,1,STEP,428524177800,428526917900,2740100,-1
405,1,STEP,428526947500,428529472600,2525100,-1
406,1,STEP,428529511900,428531968700,2456800,-1
407,1,STEP,428531998000,428534415400,2417400,-1
408,1,STEP,428534443500,428537123800,2680300,-1
409,1,STEP,428537166900,428539598400,2431500,-1
410,1,STEP,428539625100,428542157400,2532300,-1
411,1,STEP,428542185900,428544805200,2619300,-1
412,1,STEP,428544835100,428547325800,2490700,-1
413,1,STEP,428547356100,428549885800,2529700,-1
414,1,STEP,428549939600,428552419700,2480100,-1
415,1,STEP,428552459700,428554912900,2453200,-1
416,1,STEP,428554940200,428557473800,2533600,-1
417,1,STEP,428557505700,428559901500,2395800,-1
418,1,STEP,428559946600,428562421700,2475100,-1
419,1,STEP,428562449300,428564986000,2536700,-1
420,1,STEP,428565022800,428567487700,2464900,-1
421,1,STEP,428567522300,428570167000,2644700,-1
422,1,STEP,428570218300,428572725700,2507400,-1
423,1,STEP,428572756700,428575192700,2436000,-1
424,1,STEP,428575221500,428577755300,2533800,-1
425,1,STEP,428577793800,428580232600,2438800,-1
426,1,STEP,428580262400,428582828000,2565600,-1
427,1,STEP,428582867600,428585482200,2614600,-1
428,1,STEP,428585522400,428587938700,2416300,-1
429,1,STEP,428587970600,428590396400,2425800,-1
430,1,STEP,428590425300,428593036100,2610800,-1
431,1,STEP,428593073800,428595561600,2487800,-1
432,1,STEP,428595591100,428598251200,2660100,-1
433,1,STEP,428598301100,428600838000,2536900,-1
434,1,STEP,428600874100,428603420400,2546300,-1
435,1,STEP,428603453800,428606086900,2633100,-1
436,1,STEP,428606122800,428608821500,2698700,-1
437,1,STEP,428608852200,428611702600,2850400,-1
438,1,STEP,428611761100,428614901800,3140700,-1
439,1,STEP,428614947000,428617764300,2817300,-1
440,1,STEP,428617800500,428620449600,2649100,-1
441,1,STEP,428620495800,428623281300,2785500,-1
442,1,STEP,428623312600,428626359300,3046700,-1
443,1,STEP,428626402300,428629173000,2770700,-1
444,1,STEP,428629214700,428631785400,2570700,-1
445,1,STEP,428631815300,428634432100,2616800,-1
446,1,STEP,428634485600,428637225200,2739600,-1
447,1,STEP,428637263700,428639969300,2705600,-1
448,1,STEP,428640034800,428642739500,2704700,-1
449,1,STEP,428642777900,428645435900,2658000,-1
450,1,STEP,428645472500,428648164200,2691700,-1
451,1,STEP,428648209200,428651085500,2876300,-1
452,1,STEP,428651124500,428654102200,2977700,-1
453,1,STEP,428654220200,428657139200,2919000,-1
454,1,STEP,428657177500,428660149300,2971800,-1
455,1,STEP,428660194300,428663249200,3054900,-1
456,1,STEP,428663299300,428666219800,2920500,-1
457,1,STEP,428666263700,428669291300,3027600,-1
458,1,STEP,428669346900,428672289200,2942300,-1
459,1,STEP,428672328800,428675393300,3064500,-1
460,1,STEP,428675445500,428678367000,2921500,-1
461,1,STEP,428678420900,428681524100,3103200,-1
462,1,STEP,428681590900,428684507000,2916100,-1
463,1,STEP,428684540400,428687510500,2970100,-1
464,1,STEP,428687543900,428690592400,3048500,-1
465,1,STEP,428690633100,428693559500,2926400,-1
466,1,STEP,428693589800,428696712200,3122400,-1
467,1,STEP,428696761900,428699682100,2920200,-1
468,1,STEP,428699713200,428702774700,3061500,-1
469,1,STEP,428702826600,428705774200,2947600,-1
470,1,STEP,428705812200,428709013600,3201400,-1
471,1,STEP,428709068400,428712196900,3128500,-1
472,1,STEP,428712232200,428715366600,3134400,-1
473,1,STEP,428715393800,428718624000,3230200,-1
474,1,STEP,428718666100,428721448400,2782300,-1
475,1,STEP,428721478400,428724435000,2956600,-1
476,1,STEP,428724478700,428726994000,2515300,-1
477,1,STEP,428727028400,428729561500,2533100,-1
478,1,STEP,428729597600,428732310500,2712900,-1
479,1,STEP,428732348300,428735114700,2766400,-1
480,1,STEP,428735146300,428738112200,2965900,-1
481,1,STEP,428738153000,428741286600,3133600,-1
482,1,STEP,428741325300,428744320500,2995200,-1
483,1,STEP,428744363800,428747404000,3040200,-1
484,1,STEP,428747440700,428750578800,3138100,-1
485,1,STEP,428750617300,428753813900,3196600,-1
486,1,STEP,428753850400,428757220000,3369600,-1
487,1,STEP,428757289700,428760654100,3364400,-1
488,1,STEP,428760703500,428764016500,3313000,-1
489,1,STEP,428764048500,428767279400,3230900,-1
490,1,STEP,428767319200,428770628900,3309700,-1
491,1,STEP,428770677200,428773693400,3016200,-1
492,1,STEP,428773748100,428776641900,2893800,-1
493,1,STEP,428776674700,428779421400,2746700,-1
494,1,STEP,428779457800,428781992800,2535000,-1
495,1,STEP,428782024900,428784512000,2487100,-1
496,1,STEP,428784543800,428787169600,2625800,-1
497,1,STEP,428787216600,428789716800,2500200,-1
498,1,STEP,428789750500,428792525700,2775200,-1
499,1,STEP,428792562900,428795144700,2581800,-1
500,1,STEP,428795179500,428797720100,2540600,-1
501,1,STEP,428797754500,428800684300,2929800,-1
502,1,STEP,428800740100,428803308100,2568000,-1
503,1,STEP,428803344800,428805972600,2627800,-1
504,1,STEP,428806027600,428808785200,2757600,-1
505,1,STEP,428808833300,428811359400,2526100,-1
506,1,STEP,428811395400,428814519900,3124500,-1
507,1,STEP,428814576300,428817493100,2916800,-1
508,1,STEP,428817523900,428820448100,2924200,-1
509,1,STEP,428820487600,428823471900,2984300,-1
510,1,STEP,428823503900,428826335600,2831700,-1
511,1,STEP,428826365600,428829127600,2762000,-1
512,1,STEP,428829214600,428831681800,2467200,-1
513,1,STEP,428831711400,428834174800,2463400,-1
514,1,STEP,428834206100,428836634100,2428000,-1
515,1,STEP,428836663800,428839213100,2549300,-1
516,1,STEP,428839242300,428841850200,2607900,-1
517,1,STEP,428841893100,428844614600,2721500,-1
518,1,STEP,428844669000,428847240000,2571000,-1
519,1,STEP,428847283100,428850368000,3084900,-1
520,1,STEP,428850411100,428852941900,2530800,-1
521,1,STEP,428852968300,428855840300,2872000,-1
522,1,STEP,428855895000,428858498700,2603700,-1
523,1,STEP,428858532500,428861103500,2571000,-1
524,1,STEP,428861140100,428864430700,3290600,-1
525,1,STEP,428864478700,428867523600,3044900,-1
526,1,STEP,428867553800,428870312200,2758400,-1
527,1,STEP,428870356200,428872857400,2501200,-1
528,1,STEP,428872886300,428875388800,2502500,-1
529,1,STEP,428875418000,428877950600,2532600,-1
530,1,STEP,428877984300,428880440100,2455800,-1
531,1,STEP,428880468800,428883118600,2649800,-1
532,1,STEP,428883151400,428885689400,2538000,-1
533,1,STEP,428885732500,428888193600,2461100,-1
534,1,STEP,428888220700,428890725200,2504500,-1
535,1,STEP,428890761600,428893208500,2446900,-1
536,1,STEP,428893237600,428895786400,2548800,-1
537,1,STEP,428895819300,428898416500,2597200,-1
538,1,STEP,428898464500,428901239300,2774800,-1
539,1,STEP,428901303000,428904344700,3041700,-1
540,1,STEP,428904394600,428906998700,2604100,-1
541,1,STEP,428907029400,428909531800,2502400,-1
542,1,STEP,428909560100,428912083200,2523100,-1
543,1,STEP,428912124800,428914593300,2468500,-1
544,1,STEP,428914624200,428917376200,2752000,-1
545,1,STEP,428917451100,428920384100,2933000,-1
546,1,STEP,428920439600,428923124000,2684400,-1
547,1,STEP,428923157000,428926038200,2881200,-1
548,1,STEP,428926090300,428929324800,3234500,-1
549,1,STEP,428929357100,428932863200,3506100,-1
550,1,STEP,428932912800,428935795600,2882800,-1
551,1,STEP,428935827400,428938730000,2902600,-1
552,1,STEP,428938783200,428941569500,2786300,-1
553,1,STEP,428941635900,428944108600,2472700,-1
554,1,STEP,428944145700,428946775800,2630100,-1
555,1,STEP,428946843700,428949278200,2434500,-1
556,1,STEP,428949306800,428951804000,2497200,-1
557,1,STEP,428951832900,428954362500,2529600,-1
558,1,STEP,428954393200,428956885300,2492100,-1
559,1,STEP,428956945000,428959535900,2590900,-1
560,1,STEP,428959572400,428962055800,2483400,-1
561,1,STEP,428962085800,428964582100,2496300,-1
562,1,STEP,428964611300,428967197500,2586200,-1
563,1,STEP,428967233000,428969726200,2493200,-1
564,1,STEP,428969758400,428972315900,2557500,-1
565,1,STEP,428972349700,428975047900,2698200,-1
566,1,STEP,428975084600,428977557100,2472500,-1
567,1,STEP,428977591600,428980170900,2579300,-1
568,1,STEP,428980204200,428982778700,2574500,-1
569,1,STEP,428982810500,428985302800,2492300,-1
570,1,STEP,428985333600,428987933800,2600200,-1
571,1,STEP,428987977700,428990448000,2470300,-1
572,1,STEP,428990480500,428992978700,2498200,-1
573,1,STEP,428993009400,428995589500,2580100,-1
574,1,STEP,428995625700,428998097500,2471800,-1
575,1,STEP,428998129300,429000779600,2650300,-1
576,1,STEP,429000814700,429003391200,2576500,-1
577,1,STEP,429003429300,429005939400,2510100,-1
578,1,STEP,429005973100,429008587600,2614500,-1
579,1,STEP,429008623600,429011102000,2478400,-1
580,1,STEP,429011134500,429013680200,2545700,-1
581,1,STEP,429013711900,429016298400,2586500,-1
582,1,STEP,429016336200,429018789500,2453300,-1
583,1,STEP,429018820400,429021517400,2697000,-1
584,1,STEP,429021559600,429024118900,2559300,-1
585,1,STEP,429024151600,429026675600,2524000,-1
586,1,STEP,429026708300,429029263600,2555300,-1
587,1,STEP,429029302000,429031801400,2499400,-1
588,1,STEP,429031833100,429034342100,2509000,-1
589,1,STEP,429034373900,429036962100,2588200,-1
590,1,STEP,429037014800,429039551000,2536200,-1
591,1,STEP,429039584700,429042246000,2661300,-1
592,1,STEP,429042293500,429044909500,2616000,-1
593,1,STEP,429044946200,429047449600,2503400,-1
594,1,STEP,429047495300,429050226400,2731100,-1
595,1,STEP,429050262500,429052751900,2489400,-1
596,1,STEP,429052783800,429055317200,2533400,-1
597,1,STEP,429055355500,429058418200,3062700,-1
598,1,STEP,429058476300,429061311200,2834900,-1
599,1,STEP,429061340300,429064014800,2674500,-1
600,1,STEP,429064057100,429066631900,2574800,-1
601,1,STEP,429066664100,429069243200,2579100,-1
602,1,STEP,429069271700,429071879100,2607400,-1
603,1,STEP,429071951900,429074612300,2660400,-1
604,1,STEP,429074660300,429077477200,2816900,-1
605,1,STEP,429077536700,429080200900,2664200,-1
606,1,STEP,429080244300,429082807900,2563600,-1
607,1,STEP,429082847500,429085525000,2677500,-1
608,1,STEP,429085578800,429088450700,2871900,-1
609,1,STEP,429088519900,429091719600,3199700,-1
610,1,STEP,429091791000,429095256500,3465500,-1
611,1,STEP,429095308100,429098407600,3099500,-1
612,1,STEP,429098517100,429101265600,2748500,-1
613,1,STEP,429101322900,429104336900,3014000,-1
614,1,STEP,429104398900,429107367500,2968600,-1
615,1,STEP,429107468300,429110593900,3125600,-1
616,1,STEP,429110641000,429113857600,3216600,-1
617,1,STEP,429113937200,429117283700,3346500,-1
618,1,STEP,429117330200,429120701500,3371300,-1
619,1,STEP,429120780300,429123913500,3133200,-1
620,1,STEP,429123950900,429127297200,3346300,-1
621,1,STEP,429127356800,429130444100,3087300,-1
622,1,STEP,429130489600,429133215400,2725800,-1
623,1,STEP,429133303900,429136511600,3207700,-1
624,1,STEP,429136581200,429139452700,2871500,-1
625,1,STEP,429139522800,429142484900,2962100,-1
626,1,STEP,429142539300,429145597500,3058200,-1
627,1,STEP,429145671500,429148503600,2832100,-1
628,1,STEP,429148587000,429151394400,2807400,-1
629,1,STEP,429151443100,429154205200,2762100,-1
630,1,STEP,429154315300,429156965700,2650400,-1
631,1,STEP,429157017600,429159952300,2934700,-1
632,1,STEP,429159993400,429163105400,3112000,-1
633,1,STEP,429163197100,429166303800,3106700,-1
634,1,STEP,429166359600,429169516500,3156900,-1
635,1,STEP,429169596200,429172790000,3193800,-1
636,1,STEP,429172850800,429176418800,3568000,-1
637,1,STEP,429176536200,429179539600,3003400,-1
638,1,STEP,429179609000,429182894900,3285900,-1
639,1,STEP,429182982500,429186112200,3129700,-1
640,1,STEP,429186179500,429189026800,2847300,-1
641,1,STEP,429189114700,429192447000,3332300,-1
642,1,STEP,429192506800,429195961800,3455000,-1
643,1,STEP,429196077400,429199588500,3511100,-1
644,1,STEP,429199643100,429203139100,3496000,-1
645,1,STEP,429203199500,429206473700,3274200,-1
646,1,STEP,429206521100,429209860100,3339000,-1
647,1,STEP,429209921900,429213190300,3268400,-1
648,1,STEP,429213236700,429216622900,3386200,-1
649,1,STEP,429216674800,429220185800,3511000,-1
650,1,STEP,429220237700,429223645700,3408000,-1
651,1,STEP,429223693200,429226482700,2789500,-1
652,1,STEP,429226533200,429229165200,2632000,-1
653,1,STEP,429229203400,429231657000,2453600,-1
654,1,STEP,429231749000,429234190000,2441000,-1
655,1,STEP,429234231300,429236747900,2516600,-1
656,1,STEP,429236804700,429239213200,2408500,-1
657,1,STEP,429239264400,429241699800,2435400,-1
658,1,STEP,429241743200,429244330100,2586900,-1
659,1,STEP,429244391000,429246909700,2518700,-1
660,1,STEP,429246966000,429249351500,2385500,-1
661,1,STEP,429249392700,429251970400,2577700,-1
662,1,STEP,429252019200,429254662400,2643200,-1
663,1,STEP,429254710200,429257073600,2363400,-1
664,1,STEP,429257175200,429259683500,2508300,-1
665,1,STEP,429259728800,429262125700,2396900,-1
666,1,STEP,429262166300,429264587800,2421500,-1
667,1,STEP,429264640200,429267072500,2432300,-1
668,1,STEP,429267113500,429269508200,2394700,-1
669,1,STEP,429269546000,429272070800,2524800,-1
670,1,STEP,429272130800,429274622700,2491900,-1
671,1,STEP,429274647800,429277031600,2383800,-1
672,1,STEP,429277059200,429279571500,2512300,-1
673,1,STEP,429279608000,429282088400,2480400,-1
674,1,STEP,429282115500,429284589600,2474100,-1
675,1,STEP,429284616300,429287362900,2746600,-1
676,1,STEP,429287418100,429289756600,2338500,-1
677,1,STEP,429289793900,429292290500,2496600,-1
678,1,STEP,429292375000,429294868000,2493000,-1
679,1,STEP,429294907800,429297222500,2314700,-1
680,1,STEP,429297261100,429299707600,2446500,-1
681,1,STEP,429299750400,429302379200,2628800,-1
682,1,STEP,429302416000,429304937100,2521100,-1
683,1,STEP,429304970100,429307526700,2556600,-1
684,1,STEP,429307565700,429309987200,2421500,-1
685,1,STEP,429310015600,429312449800,2434200,-1
686,1,STEP,429312477600,429314836700,2359100,-1
687,1,STEP,429314868500,429317253100,2384600,-1
688,1,STEP,429317294900,429319550900,2256000,-1
689,1,STEP,429319582400,429321957400,2375000,-1
690,1,STEP,429322002300,429324239700,2237400,-1
691,1,STEP,429324269700,429326514900,2245200,-1
692,1,STEP,429326547500,429328906000,2358500,-1
693,1,STEP,429328948400,429331212600,2264200,-1
694,1,STEP,429331247200,429333543100,2295900,-1
695,1,STEP,429333575300,429335865500,2290200,-1
696,1,STEP,429335903600,429338195300,2291700,-1
697,1,STEP,429338233500,429340479300,2245800,-1
698,1,STEP,429340509900,429342857100,2347200,-1
699,1,STEP,429342898400,429345225200,2326800,-1
700,1,STEP,429345256900,429347562300,2305400,-1
701,1,STEP,429347598500,429349934900,2336400,-1
702,1,STEP,429349975400,429352229600,2254200,-1
703,1,STEP,429352262800,429354629000,2366200,-1
704,1,STEP,429354664600,429356970700,2306100,-1
705,1,STEP,429357007800,429359256500,2248700,-1
706,1,STEP,429359287100,429361634100,2347000,-1
707,1,STEP,429361669400,429364011500,2342100,-1
708,1,STEP,429364055200,429366312000,2256800,-1
709,1,STEP,429366344100,429368733200,2389100,-1
710,1,STEP,429368769600,429371138100,2368500,-1
711,1,STEP,429371170200,429373648700,2478500,-1
712,1,STEP,429373680800,429376111100,2430300,-1
713,1,STEP,429376150300,429379870400,3720100,-1
714,1,STEP,429379910500,429383353400,3442900,-1
715,1,STEP,429383388900,429386307200,2918300,-1
716,1,STEP,429386339200,429389195800,2856600,-1
717,1,STEP,429389232200,429391796400,2564200,-1
718,1,STEP,429391832100,429394369300,2537200,-1
719,1,STEP,429394402300,429397177000,2774700,-1
720,1,STEP,429397217900,429399726800,2508900,-1
721,1,STEP,429399759300,429402226000,2466700,-1
722,1,STEP,429402257900,429404947400,2689500,-1
723,1,STEP,429404987600,429407500100,2512500,-1
724,1,STEP,429407535500,429410290100,2754600,-1
725,1,STEP,429410332200,429412919500,2587300,-1
726,1,STEP,429412955100,429415796900,2841800,-1
727,1,STEP,429415833000,429418878100,3045100,-1
728,1,STEP,429418917700,429421662900,2745200,-1
729,1,STEP,429421695800,429424648200,2952400,-1
730,1,STEP,429424701600,429427229000,2527400,-1
731,1,STEP,429427266200,429430109100,2842900,-1
732,1,STEP,429430143500,429433004500,2861000,-1
733,1,STEP,429433043400,429435983500,2940100,-1
734,1,STEP,429436019500,429438791900,2772400,-1
735,1,STEP,429438841300,429441612500,2771200,-1
736,1,STEP,429441652800,429444058700,2405900,-1
737,1,STEP,429444087600,429446751100,2663500,-1
738,1,STEP,429446792800,429449271900,2479100,-1
739,1,STEP,429449301500,429451803600,2502100,-1
740,1,STEP,429451836300,429454558800,2722500,-1
741,1,STEP,429454618700,429457614400,2995700,-1
742,1,STEP,429457663000,429460661700,2998700,-1
743,1,STEP,429460718300,429463385900,2667600,-1
744,1,STEP,429463424900,429466236200,2811300,-1
745,1,STEP,429466285000,429468840400,2555400,-1
746,1,STEP,429468887900,429471836700,2948800,-1
747,1,STEP,429471887000,429474593300,2706300,-1
748,1,STEP,429474667100,429477149900,2482800,-1
749,1,STEP,429477182900,429479808500,2625600,-1
750,1,STEP,429479852800,429482919600,3066800,-1
751,1,STEP,429482969500,429485995600,3026100,-1
752,1,STEP,429486030300,429488728500,2698200,-1
753,1,STEP,429488783200,429491281400,2498200,-1
754,1,STEP,429491317700,429494053900,2736200,-1
755,1,STEP,429494106400,429496769900,2663500,-1
756,1,STEP,429496820100,429499300100,2480000,-1
757,1,STEP,429499333800,429502183800,2850000,-1
758,1,STEP,429502237100,429504816600,2579500,-1
759,1,STEP,429504854400,429507632700,2778300,-1
760,1,STEP,429507721100,429510615200,2894100,-1
761,1,STEP,429510680100,429513704300,3024200,-1
762,1,STEP,429513733600,429516643000,2909400,-1
763,1,STEP,429516692700,429519414100,2721400,-1
764,1,STEP,429519456400,429522356400,2900000,-1
765,1,STEP,429522394700,429525447200,3052500,-1
766,1,STEP,429525496300,429528732500,3236200,-1
767,1,STEP,429528807900,429531715400,2907500,-1
768,1,STEP,429531761700,429534536100,2774400,-1
769,1,STEP,429534564200,429537612900,3048700,-1
770,1,STEP,429537665400,429540498800,2833400,-1
771,1,STEP,429540530900,429543436900,2906000,-1
772,1,STEP,429543484900,429546302000,2817100,-1
773,1,STEP,429546339600,429549217600,2878000,-1
774,1,STEP,429549301600,429552291900,2990300,-1
775,1,STEP,429552341700,429555212900,2871200,-1
776,1,STEP,429555249500,429558240900,2991400,-1
777,1,STEP,429558291800,429561164700,2872900,-1
778,1,STEP,429561196400,429564154600,2958200,-1
779,1,STEP,429564196300,429567136900,2940600,-1
780,1,STEP,429567179400,429570600400,3421000,-1
781,1,STEP,429570650800,429573842800,3192000,-1
782,1,STEP,429573890300,429577109200,3218900,-1
783,1,STEP,429577158100,429580226800,3068700,-1
784,1,STEP,429580274400,429583156300,2881900,-1
785,1,STEP,429583187200,429586332600,3145400,-1
786,1,STEP,429586388400,429589381500,2993100,-1
787,1,STEP,429589411500,429591868200,2456700,-1
788,1,STEP,429591906100,429594539500,2633400,-1
789,1,STEP,429594571900,429597010000,2438100,-1
790,1,STEP,429597040100,429599698800,2658700,-1
791,1,STEP,429599738000,429602578600,2840600,-1
792,1,STEP,429602622600,429605446200,2823600,-1
793,1,STEP,429605488600,429608535400,3046800,-1
794,1,STEP,429608577400,429611520800,2943400,-1
795,1,STEP,429611561500,429614550900,2989400,-1
796,1,STEP,429614591500,429617495600,2904100,-1
797,1,STEP,429617534100,429620616600,3082500,-1
798,1,STEP,429620670800,429623564300,2893500,-1
799,1,STEP,429623596900,429626527800,2930900,-1
800,1,STEP,429626572000,429629497200,2925200,-1
801,1,STEP,429629530900,429632414100,2883200,-1
802,1,STEP,429632453000,429635649900,3196900,-1
803,1,STEP,429635692200,429638215200,2523000,-1
804,1,STEP,429638244400,429640800700,2556300,-1
805,1,STEP,429640844900,429643471800,2626900,-1
806,1,STEP,429643502100,429645983800,2481700,-1
807,1,STEP,429646021100,429648596100,2575000,-1
808,1,STEP,429648660900,429651243200,2582300,-1
809,1,STEP,429651288900,429653996600,2707700,-1
810,1,STEP,429654062300,429656572900,2510600,-1
811,1,STEP,429656608800,429659209400,2600600,-1
812,1,STEP,429659240300,429661807800,2567500,-1
813,1,STEP,429661850200,429664532400,2682200,-1
814,1,STEP,429664591300,429667358900,2767600,-1
815,1,STEP,429667412000,429669847900,2435900,-1
816,1,STEP,429669887500,429672536900,2649400,-1
817,1,STEP,429672580000,429675158300,2578300,-1
818,1,STEP,429675214800,429677790300,2575500,-1
819,1,STEP,429677825400,429680428600,2603200,-1
820,1,STEP,429680462100,429683228900,2766800,-1
821,1,STEP,429683280400,429685937200,2656800,-1
822,1,STEP,429685972500,429689316700,3344200,-1
823,1,STEP,429689363700,429692435600,3071900,-1
824,1,STEP,429692470900,429695334800,2863900,-1
825,1,STEP,429695383900,429698134600,2750700,-1
826,1,STEP,429698180700,429700878400,2697700,-1
827,1,STEP,429700910600,429703524700,2614100,-1
828,1,STEP,429703571500,429706094800,2523300,-1
829,1,STEP,429706130400,429708918200,2787800,-1
830,1,STEP,429708975900,429711671100,2695200,-1
831,1,STEP,429711714200,429714398900,2684700,-1
832,1,STEP,429714433500,429717363600,2930100,-1
833,1,STEP,429717420400,429719985700,2565300,-1
834,1,STEP,429720019200,429722687800,2668600,-1
835,1,STEP,429722740700,429725710800,2970100,-1
836,1,STEP,429725761700,429728720500,2958800,-1
837,1,STEP,429728762100,429731811800,3049700,-1
838,1,STEP,429731862900,429734487400,2624500,-1
839,1,STEP,429734524400,429737289000,2764600,-1
840,1,STEP,429737350500,429739986100,2635600,-1
841,1,STEP,429740022100,429742942500,2920400,-1
842,1,STEP,429742975200,429745847600,2872400,-1
843,1,STEP,429745906000,429748699600,2793600,-1
844,1,STEP,429748735200,429751598300,2863100,-1
845,1,STEP,429751651800,429754313800,2662000,-1
846,1,STEP,429754350000,429757056200,2706200,-1
847,1,STEP,429757113500,429760121200,3007700,-1
848,1,STEP,429760180200,429763024600,2844400,-1
849,1,STEP,429763075500,429765943000,2867500,-1
850,1,STEP,429766013500,429768501600,2488100,-1
851,1,STEP,429768542500,429771129300,2586800,-1
852,1,STEP,429771175400,429773973400,2798000,-1
853,1,STEP,429774039400,429777003100,2963700,-1
854,1,STEP,429777039900,429780112700,3072800,-1
855,1,STEP,429780236700,429783136300,2899600,-1
856,1,STEP,429783193600,429785934000,2740400,-1
857,1,STEP,429786009100,429789140000,3130900,-1
858,1,STEP,429789196100,429792412900,3216800,-1
859,1,STEP,429792482100,429795515300,3033200,-1
860,1,STEP,429795580500,429798572100,2991600,-1
861,1,STEP,429798636700,429801868500,3231800,-1
862,1,STEP,429801935300,429805006300,3071000,-1
863,1,STEP,429805077300,429808461600,3384300,-1
864,1,STEP,429808532700,429811637700,3105000,-1
865,1,STEP,429811699400,429814808800,3109400,-1
866,1,STEP,429814878600,429817675300,2796700,-1
867,1,STEP,429817734500,429820651100,2916600,-1
868,1,STEP,429820727100,429823863600,3136500,-1
869,1,STEP,429823930700,429827091700,3161000,-1
870,1,STEP,429827151100,429830247700,3096600,-1
871,1,STEP,429830305600,429833467500,3161900,-1
872,1,STEP,429833516100,429836468200,2952100,-1
873,1,STEP,429836536800,429839801600,3264800,-1
874,1,STEP,429839845500,429842833200,2987700,-1
875,1,STEP,429842895900,429845739300,2843400,-1
876,1,STEP,429845801300,429849064500,3263200,-1
877,1,STEP,429849140400,429851975200,2834800,-1
878,1,STEP,429852036900,429854985100,2948200,-1
879,1,STEP,429855132000,429858246000,3114000,-1
880,1,STEP,429858307700,429861072700,2765000,-1
881,1,STEP,429861114700,429864079500,2964800,-1
882,1,STEP,429864138800,429867223100,3084300,-1
883,1,STEP,429867268600,429870428200,3159600,-1
884,1,STEP,429870484900,429873606300,3121400,-1
885,1,STEP,429873633900,429876602900,2969000,-1
886,1,STEP,429876644800,429879072000,2427200,-1
887,1,STEP,429879099900,429881656700,2556800,-1
888,1,STEP,429881684400,429884365400,2681000,-1
889,1,STEP,429884404200,429886921600,2517400,-1
890,1,STEP,429886974500,429889819500,2845000,-1
891,1,STEP,429889862100,429892615700,2753600,-1
892,1,STEP,429892657100,429895354500,2697400,-1
893,1,STEP,429895383000,429898624600,3241600,-1
894,1,STEP,429898666200,429901983700,3317500,-1
895,1,STEP,429902018500,429904980500,2962000,-1
896,1,STEP,429905019200,429907875800,2856600,-1
897,1,STEP,429907907100,429910823300,2916200,-1
898,1,STEP,429910862100,429913717700,2855600,-1
899,1,STEP,429913746900,429916647300,2900400,-1
900,1,STEP,429916683100,429919203600,2520500,-1
901,1,STEP,429919238300,429921691500,2453200,-1
902,1,STEP,429921720800,429924459000,2738200,-1
903,1,STEP,429924495800,429927172400,2676600,-1
904,1,STEP,429927203100,429930199900,2996800,-1
905,1,STEP,429930229100,429933028200,2799100,-1
906,1,STEP,429933064200,429935603200,2539000,-1
907,1,STEP,429935633200,429938444800,2811600,-1
908,1,STEP,429938499100,429940963900,2464800,-1
909,1,STEP,429940993700,429943452300,2458600,-1
910,1,STEP,429943481700,429945998400,2516700,-1
911,1,STEP,429946033900,429948765300,2731400,-1
912,1,STEP,429948803500,429951534200,2730700,-1
913,1,STEP,429951565600,429954522400,2956800,-1
914,1,STEP,429954565000,429957353000,2788000,-1
915,1,STEP,429957382800,429960006200,2623400,-1
916,1,STEP,429960041600,429962551400,2509800,-1
917,1,STEP,429962588700,429965228900,2640200,-1
918,1,STEP,429965261900,429967882600,2620700,-1
919,1,STEP,429967919300,429970379500,2460200,-1
920,1,STEP,429970408500,429973034900,2626400,-1
921,1,STEP,429973066300,429975538300,2472000,-1
922,1,STEP,429975569000,429978211000,2642000,-1
923,1,STEP,429978241500,429980808600,2567100,-1
924,1,STEP,429980848500,429983309700,2461200,-1
925,1,STEP,429983338800,429985812700,2473900,-1
926,1,STEP,429985843900,429988515700,2671800,-1
927,1,STEP,429988549200,429991040500,2491300,-1
928,1,STEP,429991070300,429993807800,2737500,-1
929,1,STEP,429993853300,429996539200,2685900,-1
930,1,STEP,429996573600,429999056200,2482600,-1
931,1,STEP,429999085700,430001659100,2573400,-1
932,1,STEP,430001699600,430004146900,2447300,-1
933,1,STEP,430004177300,430006658700,2481400,-1
934,1,STEP,430006690100,430009364900,2674800,-1
935,1,STEP,430009400000,430011877100,2477100,-1
936,1,STEP,430011906900,430014706500,2799600,-1
937,1,STEP,430014745900,430017269600,2523700,-1
938,1,STEP,430017301600,430020474500,3172900,-1
939,1,STEP,430020512500,430023382000,2869500,-1
940,1,STEP,430023414700,430025956300,2541600,-1
941,1,STEP,430025987100,430028698600,2711500,-1
942,1,STEP,430028738800,430031264400,2525600,-1
943,1,STEP,430031296100,430033752200,2456100,-1
944,1,STEP,430033782200,430036344300,2562100,-1
945,1,STEP,430036386400,430038830000,2443600,-1
946,1,STEP,430038860300,430041302100,2441800,-1
947,1,STEP,430041332100,430044029200,2697100,-1
948,1,STEP,430044072600,430046812100,2739500,-1
949,1,STEP,430046840000,430049447600,2607600,-1
950,1,STEP,430049484500,430051870400,2385900,-1
951,1,STEP,430051899600,430054339300,2439700,-1
952,1,STEP,430054368000,430056978800,2610800,-1
953,1,STEP,430057019900,430059502600,2482700,-1
954,1,STEP,430059534300,430061991300,2457000,-1
955,1,STEP,430062020300,430064740400,2720100,-1
956,1,STEP,430064778600,430067353800,2575200,-1
957,1,STEP,430067387600,430070170200,2782600,-1
958,1,STEP,430070205600,430073347800,3142200,-1
959,1,STEP,430073392500,430076489700,3097200,-1
960,1,STEP,430076522400,430079311700,2789300,-1
961,1,STEP,430079346800,430081870800,2524000,-1
962,1,STEP,430081902200,430084525300,2623100,-1
963,1,STEP,430084560800,430087143000,2582200,-1
964,1,STEP,430087182100,430089747900,2565800,-1
965,1,STEP,430089781500,430092444600,2663100,-1
966,1,STEP,430092486300,430094990800,2504500,-1
967,1,STEP,430095040400,430097627000,2586600,-1
968,1,STEP,430097660400,430100251400,2591000,-1
969,1,STEP,430100286000,430102894300,2608300,-1
970,1,STEP,430102943800,430105660300,2716500,-1
971,1,STEP,430105713500,430108224800,2511300,-1
972,1,STEP,430108261000,430110715900,2454900,-1
973,1,STEP,430110746100,430113374600,2628500,-1
974,1,STEP,430113411200,430115867900,2456700,-1
975,1,STEP,430115899600,430118525900,2626300,-1
976,1,STEP,430118563700,430121203000,2639300,-1
977,1,STEP,430121237900,430123734500,2496600,-1
978,1,STEP,430123766800,430126442700,2675900,-1
979,1,STEP,430126480000,430128963100,2483100,-1
980,1,STEP,430128996600,430131513400,2516800,-1
981,1,STEP,430131546000,430134226200,2680200,-1
982,1,STEP,430134271900,430136772900,2501000,-1
983,1,STEP,430136808500,430139615800,2807300,-1
984,1,STEP,430139652600,430142255100,2602500,-1
985,1,STEP,430142292100,430145282000,2989900,-1
986,1,STEP,430145314000,430148070000,2756000,-1
987,1,STEP,430148108300,430151062900,2954600,-1
988,1,STEP,430151099400,430153985300,2885900,-1
989,1,STEP,430154023200,430156527800,2504600,-1
990,1,STEP,430156562900,430159030600,2467700,-1
991,1,STEP,430159076100,430161747800,2671700,-1
992,1,STEP,430161786200,430164395200,2609000,-1
993,1,STEP,430164430600,430166955500,2524900,-1
994,1,STEP,430166989800,430169654500,2664700,-1
995,1,STEP,430169699900,430172205600,2505700,-1
996,1,STEP,430172240100,430175284900,3044800,-1
997,1,STEP,430175338500,430177813800,2475300,-1
998,1,STEP,430177843800,430180637900,2794100,-1
999,1,STEP,430180665600,430183232600,2567000,-1
