Gen,Resource,Stamp,TimeStamp_Start,TimeStamp_End,Duration,Indiv_id
0,1,TransfertToDevice,750579315000,750654674000,75359000,-1
0,1,STEP,750685877200,750688469200,2592000,-1
1,1,STEP,750688581500,750690991200,2409700,-1
2,1,STEP,750691045600,750693041800,1996200,-1
3,1,STEP,750693075700,750695094500,2018800,-1
4,1,STEP,750695138000,750697179100,2041100,-1
5,1,STEP,750697232000,750699172000,1940000,-1
6,1,STEP,750699207200,750701141100,1933900,-1
7,1,STEP,750701175000,750703340600,2165600,-1
8,1,STEP,750703407300,750705335000,1927700,-1
9,1,STEP,750705370900,750707247300,1876400,-1
10,1,STEP,750707281000,750709576800,2295800,-1
11,1,STEP,750709627400,750711872600,2245200,-1
12,1,STEP,750711918000,750714155300,2237300,-1
13,1,STEP,750714189900,750716282000,2092100,-1
14,1,STEP,750716359200,750718266200,1907000,-1
15,1,STEP,750718302000,750720094600,1792600,-1
16,1,STEP,750720122900,750721923700,1800800,-1
17,1,STEP,750721947600,750723828000,1880400,-1
18,1,STEP,750723867400,750725677000,1809600,-1
19,1,STEP,750725704100,750727512100,1808000,-1
20,1,STEP,750727537200,750729379800,1842600,-1
21,1,STEP,750729408000,750731295000,1887000,-1
22,1,STEP,750731356200,750733166300,1810100,-1
23,1,STEP,750733191700,750734978800,1787100,-1
24,1,STEP,750735002700,750736863800,1861100,-1
25,1,STEP,750736902300,750738784800,1882500,-1
26,1,STEP,750738841700,750740633300,1791600,-1
27,1,STEP,750740659600,750742459900,1800300,-1
28,1,STEP,750742483900,750744324500,1840600,-1
29,1,STEP,750744363700,750746198600,1834900,-1
30,1,STEP,750746248800,750747971400,1722600,-1
31,1,STEP,750747999800,750749685800,1686000,-1
32,1,STEP,750749712800,750751429900,1717100,-1
33,1,STEP,750751471800,750753278300,1806500,-1
34,1,STEP,750753307800,750755018600,1710800,-1
35,1,STEP,750755043400,750756764300,1720900,-1
36,1,STEP,750756787700,750758561400,1773700,-1
37,1,STEP,750758603300,750760336500,1733200,-1
38,1,STEP,750760367400,750762083900,1716500,-1
39,1,STEP,750762124000,750763816600,1692600,-1
40,1,STEP,750763843800,750765868400,2024600,-1
41,1,STEP,750765917300,750767821800,1904500,-1
42,1,STEP,750767859100,750769988200,2129100,-1
43,1,STEP,750770019300,750772026100,2006800,-1
44,1,STEP,750772095800,750774016400,1920600,-1
45,1,STEP,750774062300,750776018900,1956600,-1
46,1,STEP,750776047200,750778166600,2119400,-1
47,1,STEP,750778200100,750780185800,1985700,-1
48,1,STEP,750780240000,750782247500,2007500,-1
49,1,STEP,750782274800,750784139000,1864200,-1
50,1,STEP,750784163700,750786324800,2161100,-1
51,1,STEP,750786367000,750788293200,1926200,-1
52,1,STEP,750788328700,750790035500,1706800,-1
53,1,STEP,750790062800,750791994600,1931800,-1
54,1,STEP,750792036100,750794077800,2041700,-1
55,1,STEP,750794141700,750795885000,1743300,-1
56,1,STEP,750795915900,750797630000,1714100,-1
57,1,STEP,750797655800,750799515300,1859500,-1
58,1,STEP,750799560200,750801359100,1798900,-1
59,1,STEP,750801428400,750803341300,1912900,-1
60,1,STEP,750803377800,750805071700,1693900,-1
61,1,STEP,750805097100,750806833300,1736200,-1
62,1,STEP,750806880900,750808742600,1861700,-1
63,1,STEP,750808781600,750810578500,1796900,-1
64,1,STEP,750810610600,750812369400,1758800,-1
65,1,STEP,750812394800,750814578400,2183600,-1
66,1,STEP,750814638400,750816753000,2114600,-1
67,1,STEP,750816788600,750818840800,2052200,-1
68,1,STEP,750818866400,750820866800,2000400,-1
69,1,STEP,750820915400,750823045300,2129900,-1
70,1,STEP,750823084500,750825067600,1983100,-1
71,1,STEP,750825096600,750827065900,1969300,-1
72,1,STEP,750827104500,750829178600,2074100,-1
73,1,STEP,750829253300,750831076600,1823300,-1
74,1,STEP,750831110600,750832781700,1671100,-1
75,1,STEP,750832809400,750834697400,1888000,-1
76,1,STEP,750834754800,750836825600,2070800,-1
77,1,STEP,750836872900,750838853600,1980700,-1
78,1,STEP,750838898000,750841567700,2669700,-1
79,1,STEP,750841650800,750844568300,2917500,-1
80,1,STEP,750844633300,750847263700,2630400,-1
81,1,STEP,750847328300,750850077900,2749600,-1
82,1,STEP,750850140100,750852521000,2380900,-1
83,1,STEP,750852571700,750855071100,2499400,-1
84,1,STEP,750855155700,750857791200,2635500,-1
85,1,STEP,750857856100,750860166100,2310000,-1
86,1,STEP,750860215600,750862783100,2567500,-1
87,1,STEP,750862858300,750865256700,2398400,-1
88,1,STEP,750865306300,750867719700,2413400,-1
89,1,STEP,750867762600,750870398100,2635500,-1
90,1,STEP,750870459600,750873047400,2587800,-1
91,1,STEP,750873100500,750875497400,2396900,-1
92,1,STEP,750875632400,750878128900,2496500,-1
93,1,STEP,750878206400,750880764800,2558400,-1
94,1,STEP,750880828800,750883290200,2461400,-1
95,1,STEP,750883391500,750886107800,2716300,-1
96,1,STEP,750886165500,750888559900,2394400,-1
97,1,STEP,750888616300,750891106700,2490400,-1
98,1,STEP,750891171800,750893911800,2740000,-1
99,1,STEP,750894004800,750896631500,2626700,-1
100,1,STEP,750896752600,750899783000,3030400,-1
101,1,STEP,750899842500,750902591900,2749400,-1
102,1,STEP,750902638700,750904938700,2300000,-1
103,1,STEP,750905003100,750906896600,1893500,-1
104,1,STEP,750906943400,750908630800,1687400,-1
105,1,STEP,750908663100,750910478000,1814900,-1
106,1,STEP,750910562600,750912521900,1959300,-1
107,1,STEP,750912624600,750914711200,2086600,-1
108,1,STEP,750914754600,750916914000,2159400,-1
109,1,STEP,750916966300,750919512100,2545800,-1
110,1,STEP,750919595100,750921537400,1942300,-1
111,1,STEP,750921592300,750923565800,1973500,-1
112,1,STEP,750923625000,750925540900,1915900,-1
113,1,STEP,750925603100,750927768000,2164900,-1
114,1,STEP,750927823400,750929616700,1793300,-1
115,1,STEP,750929652800,750931539200,1886400,-1
116,1,STEP,750931628700,750933727400,2098700,-1
117,1,STEP,750933807300,750935577400,1770100,-1
118,1,STEP,750935611100,750937385100,1774000,-1
119,1,STEP,750937429200,750939443800,2014600,-1
120,1,STEP,750939529300,750941592100,2062800,-1
121,1,STEP,750941642900,750943707500,2064600,-1
122,1,STEP,750943748200,750945849000,2100800,-1
123,1,STEP,750945962000,750947793800,1831800,-1
124,1,STEP,750947885200,750949597400,1712200,-1
125,1,STEP,750949633300,750951332200,1698900,-1
126,1,STEP,750951387400,750953320100,1932700,-1
127,1,STEP,750953397400,750955300300,1902900,-1
128,1,STEP,750955353700,750956867500,1513800,-1
129,1,STEP,750956899600,750958475300,1575700,-1
130,1,STEP,750958531100,750960435300,1904200,-1
131,1,STEP,750960523700,750962223000,1699300,-1
132,1,STEP,750962274500,750963786600,1512100,-1
133,1,STEP,750963821000,750965462900,1641900,-1
134,1,STEP,750965528800,750967343000,1814200,-1
135,1,STEP,750967436500,750969069600,1633100,-1
136,1,STEP,750969116100,750970650800,1534700,-1
137,1,STEP,750970686800,750972298900,1612100,-1
138,1,STEP,750972355400,750974216800,1861400,-1
139,1,STEP,750974275200,750975915000,1639800,-1
140,1,STEP,750975961300,750977511700,1550400,-1
141,1,STEP,750977545000,750979063600,1518600,-1
142,1,STEP,750979091000,750980781500,1690500,-1
143,1,STEP,750980848400,750982476300,1627900,-1
144,1,STEP,750982671600,750984320900,1649300,-1
145,1,STEP,750984355600,750985905500,1549900,-1
146,1,STEP,750985938600,750987610600,1672000,-1
147,1,STEP,750987699400,750989334900,1635500,-1
148,1,STEP,750989426000,750991027900,1601900,-1
149,1,STEP,750991056000,750992590400,1534400,-1
150,1,STEP,750992615400,750994373900,1758500,-1
151,1,STEP,750994502600,750996115400,1612800,-1
152,1,STEP,750996166900,750997671800,1504900,-1
153,1,STEP,750997697400,750999249000,1551600,-1
154,1,STEP,750999277200,751000874000,1596800,-1
155,1,STEP,751000920400,751002526800,1606400,-1
156,1,STEP,751002583400,751004164600,1581200,-1
157,1,STEP,751004202500,751005740200,1537700,-1
158,1,STEP,751005767400,751007367700,1600300,-1
159,1,STEP,751007432400,751009118100,1685700,-1
160,1,STEP,751009174500,751010862000,1687500,-1
161,1,STEP,751010905300,751012457600,1552300,-1
162,1,STEP,751012487900,751014257100,1769200,-1
163,1,STEP,751014317200,751016368300,2051100,-1
164,1,STEP,751016461400,751018057300,1595900,-1
165,1,STEP,751018100400,751019908700,1808300,-1
166,1,STEP,751019952400,751021817500,1865100,-1
167,1,STEP,751021962300,751023691800,1729500,-1
168,1,STEP,751023758200,751025334000,1575800,-1
169,1,STEP,751025367700,751026869600,1501900,-1
170,1,STEP,751026898800,751028688800,1790000,-1
171,1,STEP,751028774600,751030590400,1815800,-1
172,1,STEP,751030667900,751032371500,1703600,-1
173,1,STEP,751032410700,751033898600,1487900,-1
174,1,STEP,751033926800,751035869800,1943000,-1
175,1,STEP,751035979900,751037998400,2018500,-1
176,1,STEP,751038089100,751039634800,1545700,-1
177,1,STEP,751039664700,751041163100,1498400,-1
178,1,STEP,751041189200,751042947600,1758400,-1
179,1,STEP,751043065400,751044771900,1706500,-1
180,1,STEP,751044842000,751046648700,1806700,-1
181,1,STEP,751046683700,751048419100,1735400,-1
182,1,STEP,751048457900,751050296000,1838100,-1
183,1,STEP,751050357700,751052027900,1670200,-1
184,1,STEP,751052116700,751053928400,1811700,-1
185,1,STEP,751053960800,751055794700,1833900,-1
186,1,STEP,751055850300,751057549100,1698800,-1
187,1,STEP,751057610600,751059259500,1648900,-1
188,1,STEP,751059316500,751060893000,1576500,-1
189,1,STEP,751060939100,751062735400,1796300,-1
190,1,STEP,751062780000,751064445000,1665000,-1
191,1,STEP,751064513200,751066122600,1609400,-1
192,1,STEP,751066176600,751067736700,1560100,-1
193,1,STEP,751067766400,751069293200,1526800,-1
194,1,STEP,751069317500,751071270000,1952500,-1
195,1,STEP,751071364600,751073315400,1950800,-1
196,1,STEP,751073371200,751075671800,2300600,-1
197,1,STEP,751075712400,751077780400,2068000,-1
198,1,STEP,751077928600,751079569800,1641200,-1
199,1,STEP,751079701300,751081356600,1655300,-1
200,1,STEP,751081399900,751082960900,1561000,-1
201,1,STEP,751082999500,751084669700,1670200,-1
202,1,STEP,751084750200,751086411100,1660900,-1
203,1,STEP,751086490000,751088325100,1835100,-1
204,1,STEP,751088367300,751090140800,1773500,-1
205,1,STEP,751090169700,751092187700,2018000,-1
206,1,STEP,751092295500,751094511600,2216100,-1
207,1,STEP,751094581500,751096710700,2129200,-1
208,1,STEP,751096757600,751098447100,1689500,-1
209,1,STEP,751098533500,751100220400,1686900,-1
210,1,STEP,751100316300,751102021600,1705300,-1
211,1,STEP,751102067000,751103576400,1509400,-1
212,1,STEP,751103606600,751105458000,1851400,-1
213,1,STEP,751105608000,751107448900,1840900,-1
214,1,STEP,751107556300,751109476000,1919700,-1
215,1,STEP,751109517200,751111319700,1802500,-1
216,1,STEP,751111354400,751113359700,2005300,-1
217,1,STEP,751113425200,751115345300,1920100,-1
218,1,STEP,751115397000,751117100700,1703700,-1
219,1,STEP,751117133200,751119096200,1963000,-1
220,1,STEP,751119202800,751121049700,1846900,-1
221,1,STEP,751121124800,751122922300,1797500,-1
222,1,STEP,751122964600,751124858600,1894000,-1
223,1,STEP,751124900200,751126582700,1682500,-1
224,1,STEP,751126667300,751128455000,1787700,-1
225,1,STEP,751128530100,751130224200,1694100,-1
226,1,STEP,751130258300,751131890800,1632500,-1
227,1,STEP,751131919300,751133851400,1932100,-1
228,1,STEP,751133920100,751135749400,1829300,-1
229,1,STEP,751135793900,751137571200,1777300,-1
230,1,STEP,751137602100,751139591700,1989600,-1
231,1,STEP,751139660100,751141727400,2067300,-1
232,1,STEP,751141785800,751143448500,1662700,-1
233,1,STEP,751143479700,751144987700,1508000,-1
234,1,STEP,751145014500,751146742600,1728100,-1
235,1,STEP,751146816600,751148558000,1741400,-1
236,1,STEP,751148631700,751150475600,1843900,-1
237,1,STEP,751150514600,751152200100,1685500,-1
238,1,STEP,751152233600,751153973500,1739900,-1
239,1,STEP,751154070300,751155894600,1824300,-1
240,1,STEP,751155977500,751157969200,1991700,-1
241,1,STEP,751158003100,751160026700,2023600,-1
242,1,STEP,751160081200,751161925900,1844700,-1
243,1,STEP,751161978700,751163803800,1825100,-1
244,1,STEP,751163845300,751165632400,1787100,-1
245,1,STEP,751165675600,751167992400,2316800,-1
246,1,STEP,751168143000,751169871200,1728200,-1
247,1,STEP,751169947500,751171485400,1537900,-1
248,1,STEP,751171516400,751173059100,1542700,-1
249,1,STEP,751173089500,751174698100,1608600,-1
250,1,STEP,751174782700,751176422200,1639500,-1
251,1,STEP,751176482400,751178023000,1540600,-1
252,1,STEP,751178055000,751179582300,1527300,-1
253,1,STEP,751179611100,751181136100,1525000,-1
254,1,STEP,751181170000,751182984000,1814000,-1
255,1,STEP,751183036300,751184701300,1665000,-1
256,1,STEP,751184757200,751186270600,1513400,-1
257,1,STEP,751186296600,751188132100,1835500,-1
258,1,STEP,751188206200,751190097400,1891200,-1
259,1,STEP,751190166000,751191721200,1555200,-1
260,1,STEP,751191758100,751193589400,1831300,-1
261,1,STEP,751193625500,751195467800,1842300,-1
262,1,STEP,751195545300,751197204300,1659000,-1
263,1,STEP,751197267300,751198851000,1583700,-1
264,1,STEP,751198890100,751200407800,1517700,-1
265,1,STEP,751200435300,751201966300,1531000,-1
266,1,STEP,751201998100,751203723300,1725200,-1
267,1,STEP,751203773100,751205457600,1684500,-1
268,1,STEP,751205499200,751207313500,1814300,-1
269,1,STEP,751207359900,751209170700,1810800,-1
270,1,STEP,751209214800,751210853100,1638300,-1
271,1,STEP,751210909900,751212499000,1589100,-1
272,1,STEP,751212537800,751214192700,1654900,-1
273,1,STEP,751214232000,751215901900,1669900,-1
274,1,STEP,751215958300,751217787600,1829300,-1
275,1,STEP,751217867200,751220082200,2215000,-1
276,1,STEP,751220143100,751221725400,1582300,-1
277,1,STEP,751221758900,751223426000,1667100,-1
278,1,STEP,751223503500,751225143600,1640100,-1
279,1,STEP,751225206900,751226736800,1529900,-1
280,1,STEP,751226773700,751228448000,1674300,-1
281,1,STEP,751228473300,751230472000,1998700,-1
282,1,STEP,751230587000,751232959300,2372300,-1
283,1,STEP,751233003000,751234833400,1830400,-1
284,1,STEP,751234859300,751236479100,1619800,-1
285,1,STEP,751236511200,751238114800,1603600,-1
286,1,STEP,751238177400,751239954800,1777400,-1
287,1,STEP,751240002300,751241765900,1763600,-1
288,1,STEP,751241796000,751243581000,1785000,-1
289,1,STEP,751243617900,751245424900,1807000,-1
290,1,STEP,751245492000,751247003500,1511500,-1
291,1,STEP,751247039300,751248589800,1550500,-1
292,1,STEP,751248621600,751250346000,1724400,-1
293,1,STEP,751250381300,751252137000,1755700,-1
294,1,STEP,751252183600,751254007000,1823400,-1
295,1,STEP,751254037700,751255756300,1718600,-1
296,1,STEP,751255781600,751257463200,1681600,-1
297,1,STEP,751257500300,751259387700,1887400,-1
298,1,STEP,751259448600,751261403600,1955000,-1
299,1,STEP,751261444600,751263362900,1918300,-1
300,1,STEP,751263392100,751265041000,1648900,-1
301,1,STEP,751265094600,751266737800,1643200,-1
302,1,STEP,751266779600,751268289100,1509500,-1
303,1,STEP,751268314800,751269816700,1501900,-1
304,1,STEP,751269848400,751271430000,1581600,-1
305,1,STEP,751271478100,751273042800,1564700,-1
306,1,STEP,751273097100,751274612800,1515700,-1
307,1,STEP,751274643600,751276309600,1666000,-1
308,1,STEP,751276337900,751278389000,2051100,-1
309,1,STEP,751278471200,751280769400,2298200,-1
310,1,STEP,751280838900,751283027700,2188800,-1
311,1,STEP,751283074400,751285601400,2527000,-1
312,1,STEP,751285728600,751288040000,2311400,-1
313,1,STEP,751288146000,751290322600,2176600,-1
314,1,STEP,751290361800,751292631800,2270000,-1
315,1,STEP,751292730900,751294854300,2123400,-1
316,1,STEP,751294913600,751296678200,1764600,-1
317,1,STEP,751296709800,751298511700,1801900,-1
318,1,STEP,751298540700,751300473600,1932900,-1
319,1,STEP,751300550200,751302256000,1705800,-1
320,1,STEP,751302293900,751303870500,1576600,-1
321,1,STEP,751303899000,751305446500,1547500,-1
322,1,STEP,751305475600,751307239200,1763600,-1
323,1,STEP,751307316000,751308938400,1622400,-1
324,1,STEP,751309017900,751310706500,1688600,-1
325,1,STEP,751310740900,751312281300,1540400,-1
326,1,STEP,751312311800,751314077500,1765700,-1
327,1,STEP,751314137400,751315818900,1681500,-1
328,1,STEP,751315909700,751317467600,1557900,-1
329,1,STEP,751317499100,751319159400,1660300,-1
330,1,STEP,751319196000,751321021300,1825300,-1
331,1,STEP,751321107900,751322857600,1749700,-1
332,1,STEP,751322950800,751324605700,1654900,-1
333,1,STEP,751324639300,751326499600,1860300,-1
334,1,STEP,751326549600,751328405200,1855600,-1
335,1,STEP,751328465700,751330110400,1644700,-1
336,1,STEP,751330155600,751331759900,1604300,-1
337,1,STEP,751331789800,751333564900,1775100,-1
338,1,STEP,751333626400,751335436300,1809900,-1
339,1,STEP,751335504500,751337154100,1649600,-1
340,1,STEP,751337196200,751338746500,1550300,-1
341,1,STEP,751338783800,751340448600,1664800,-1
342,1,STEP,751340478000,751342510900,2032900,-1
343,1,STEP,751342607400,751344482200,1874800,-1
344,1,STEP,751344528000,751346316800,1788800,-1
345,1,STEP,751346345000,751348449100,2104100,-1
346,1,STEP,751348556800,751350298700,1741900,-1
347,1,STEP,751350368400,751352022500,1654100,-1
348,1,STEP,751352053700,751354044400,1990700,-1
349,1,STEP,751354093800,751356048200,1954400,-1
350,1,STEP,751356135800,751357796000,1660200,-1
351,1,STEP,751357863600,751359411600,1548000,-1
352,1,STEP,751359440600,751360969500,1528900,-1
353,1,STEP,751360994600,751362725000,1730400,-1
354,1,STEP,751362797000,751364698800,1901800,-1
355,1,STEP,751364791500,751366301600,1510100,-1
356,1,STEP,751366329400,751368178300,1848900,-1
357,1,STEP,751368212900,751370128900,1916000,-1
358,1,STEP,751370204900,751371780900,1576000,-1
359,1,STEP,751371823600,751373518600,1695000,-1
360,1,STEP,751373563600,751375184900,1621300,-1
361,1,STEP,751375230300,751377329200,2098900,-1
362,1,STEP,751377405600,751379303200,1897600,-1
363,1,STEP,751379365200,751380963400,1598200,-1
364,1,STEP,751381014400,751382766700,1752300,-1
365,1,STEP,751382859600,751384634800,1775200,-1
366,1,STEP,751384732000,751386385300,1653300,-1
367,1,STEP,751386436700,751387986900,1550200,-1
368,1,STEP,751388016500,751389836300,1819800,-1
369,1,STEP,751389932700,751391757600,1824900,-1
370,1,STEP,751391843200,751393566200,1723000,-1
371,1,STEP,751393608300,751395268800,1660500,-1
372,1,STEP,751395299500,751397264500,1965000,-1
373,1,STEP,751397385800,751399072800,1687000,-1
374,1,STEP,751399134900,751400738800,1603900,-1
375,1,STEP,751400773300,751402583300,1810000,-1
376,1,STEP,751402629800,751404593300,1963500,-1
377,1,STEP,751404688300,751406426900,1738600,-1
378,1,STEP,751406501100,751408110300,1609200,-1
379,1,STEP,751408139200,751409661500,1522300,-1
380,1,STEP,751409688200,751411448400,1760200,-1
381,1,STEP,751411538900,751414184500,2645600,-1
382,1,STEP,751414247100,751416492800,2245700,-1
383,1,STEP,751416536200,751418905300,2369100,-1
384,1,STEP,751418968200,751421330500,2362300,-1
385,1,STEP,751421391100,751423484300,2093200,-1
386,1,STEP,751423521600,751425997800,2476200,-1
387,1,STEP,751426064700,751428214600,2149900,-1
388,1,STEP,751428262400,751430366600,2104200,-1
389,1,STEP,751430408400,751432979700,2571300,-1
390,1,STEP,751433045500,751435248700,2203200,-1
391,1,STEP,751435296200,751437428800,2132600,-1
392,1,STEP,751437469300,751439914000,2444700,-1
393,1,STEP,751439968900,751442136700,2167800,-1
394,1,STEP,751442182300,751444274600,2092300,-1
395,1,STEP,751444312500,751446860700,2548200,-1
396,1,STEP,751446914700,751449037700,2123000,-1
397,1,STEP,751449083700,751451633500,2549800,-1
398,1,STEP,751451669800,751453735700,2065900,-1
399,1,STEP,751453794000,751455748400,1954400,-1
400,1,STEP,751455783900,751457977000,2193100,-1
401,1,STEP,751458001300,751460063500,2062200,-1
402,1,STEP,751460125300,751461862300,1737000,-1
403,1,STEP,751461919200,751463590000,1670800,-1
404,1,STEP,751463615100,751465338400,1723300,-1
405,1,STEP,751465363100,751467011300,1648200,-1
406,1,STEP,751467067000,751469188800,2121800,-1
407,1,STEP,751469238300,751471293400,2055100,-1
408,1,STEP,751471325200,751473061300,1736100,-1
409,1,STEP,751473122100,751474841800,1719700,-1
410,1,STEP,751474915300,751476511000,1595700,-1
411,1,STEP,751476549500,751478568800,2019300,-1
412,1,STEP,751478593100,751480298800,1705700,-1
413,1,STEP,751480358900,751481960400,1601500,-1
414,1,STEP,751481992800,751483468400,1475600,-1
415,1,STEP,751483493600,751485015500,1521900,-1
416,1,STEP,751485046300,751486826600,1780300,-1
417,1,STEP,751486930900,751488786200,1855300,-1
418,1,STEP,751488873600,751490457800,1584200,-1
419,1,STEP,751490502100,751492091900,1589800,-1
420,1,STEP,751492131900,751493843200,1711300,-1
421,1,STEP,751493913700,751495716400,1802700,-1
422,1,STEP,751495796500,751497387500,1591000,-1
423,1,STEP,751497423800,751498926000,1502200,-1
424,1,STEP,751498951900,751501226600,2274700,-1
425,1,STEP,751501350600,751503265200,1914600,-1
426,1,STEP,751503343100,751504872300,1529200,-1
427,1,STEP,751504914300,751506487300,1573000,-1
428,1,STEP,751506526100,751508347500,1821400,-1
429,1,STEP,751508505400,751510281700,1776300,-1
430,1,STEP,751510403700,751512187400,1783700,-1
431,1,STEP,751512229800,751513843200,1613400,-1
432,1,STEP,751513892500,751515726200,1833700,-1
433,1,STEP,751515814600,751517670800,1856200,-1
434,1,STEP,751517779900,751519339800,1559900,-1
435,1,STEP,751519400400,751521221500,1821100,-1
436,1,STEP,751521301000,751523385500,2084500,-1
437,1,STEP,751523476000,751525256600,1780600,-1
438,1,STEP,751525313600,751526930600,1617000,-1
439,1,STEP,751526967400,751528953200,1985800,-1
440,1,STEP,751529132800,751531036300,1903500,-1
441,1,STEP,751531138800,751533102000,1963200,-1
442,1,STEP,751533160100,751534990600,1830500,-1
443,1,STEP,751535060900,751537160600,2099700,-1
444,1,STEP,751537252500,751539274100,2021600,-1
445,1,STEP,751539336200,751541109500,1773300,-1
446,1,STEP,751541165400,751543042500,1877100,-1
447,1,STEP,751543182400,751545304300,2121900,-1
448,1,STEP,751545415800,751547727100,2311300,-1
449,1,STEP,751547796400,751549743200,1946800,-1
450,1,STEP,751549884000,751551647600,1763600,-1
451,1,STEP,751551745500,751553496800,1751300,-1
452,1,STEP,751553555100,751555205200,1650100,-1
453,1,STEP,751555253600,751557466700,2213100,-1
454,1,STEP,751557558200,751560104200,2546000,-1
455,1,STEP,751560178500,751562300300,2121800,-1
456,1,STEP,751562364300,751564141500,1777200,-1
457,1,STEP,751564251000,751566405800,2154800,-1
458,1,STEP,751566523400,751568263700,1740300,-1
459,1,STEP,751568322500,751570350600,2028100,-1
460,1,STEP,751570515400,751572836100,2320700,-1
461,1,STEP,751572938700,751574991100,2052400,-1
462,1,STEP,751575037600,751576797900,1760300,-1
463,1,STEP,751576908800,751579120200,2211400,-1
464,1,STEP,751579226600,751580922500,1695900,-1
465,1,STEP,751580979100,751582905800,1926700,-1
466,1,STEP,751582959700,751585124000,2164300,-1
467,1,STEP,751585232700,751587492700,2260000,-1
468,1,STEP,751587553700,751589588500,2034800,-1
469,1,STEP,751589639000,751591923100,2284100,-1
470,1,STEP,751592021200,751594007800,1986600,-1
471,1,STEP,751594109800,751595758400,1648600,-1
472,1,STEP,751595804800,751597735200,1930400,-1
473,1,STEP,751597836000,751599860000,2024000,-1
474,1,STEP,751599932400,751601617800,1685400,-1
475,1,STEP,751601666600,751603290200,1623600,-1
476,1,STEP,751603334000,751605176800,1842800,-1
477,1,STEP,751605281300,751607263500,1982200,-1
478,1,STEP,751607332400,751608958400,1626000,-1
479,1,STEP,751609001200,751610702400,1701200,-1
480,1,STEP,751610742000,751612615000,1873000,-1
481,1,STEP,751612700700,751614419200,1718500,-1
482,1,STEP,751614522100,751616085000,1562900,-1
483,1,STEP,751616119200,751617608600,1489400,-1
484,1,STEP,751617634500,751619561200,1926700,-1
485,1,STEP,751619656300,751621406700,1750400,-1
486,1,STEP,751621516800,751623054600,1537800,-1
487,1,STEP,751623084000,751624699900,1615900,-1
488,1,STEP,751624725100,751626492800,1767700,-1
489,1,STEP,751626573200,751628424500,1851300,-1
490,1,STEP,751628519700,751630315700,1796000,-1
491,1,STEP,751630352600,751632471900,2119300,-1
492,1,STEP,751632711800,751634605900,1894100,-1
493,1,STEP,751634677800,751636351700,1673900,-1
494,1,STEP,751636391000,751637905300,1514300,-1
495,1,STEP,751637934900,751639669600,1734700,-1
496,1,STEP,751639739800,751641468300,1728500,-1
497,1,STEP,751641549000,751643100900,1551900,-1
498,1,STEP,751643141700,751644703200,1561500,-1
499,1,STEP,751644739500,751646258600,1519100,-1
500,1,STEP,751646317500,751648156100,1838600,-1
501,1,STEP,751648218400,751650096300,1877900,-1
502,1,STEP,751650142600,751651890900,1748300,-1
503,1,STEP,751651917400,751653917400,2000000,-1
504,1,STEP,751654007400,751656027400,2020000,-1
505,1,STEP,751656110900,751657679100,1568200,-1
506,1,STEP,751657708700,751659172800,1464100,-1
507,1,STEP,751659198900,751661340900,2142000,-1
508,1,STEP,751661425300,751663621100,2195800,-1
509,1,STEP,751663667400,751665736600,2069200,-1
510,1,STEP,751665765400,751667864900,2099500,-1
511,1,STEP,751667900400,751670016800,2116400,-1
512,1,STEP,751670061000,751672146000,2085000,-1
513,1,STEP,751672172200,751674114900,1942700,-1
514,1,STEP,751674150600,751675812900,1662300,-1
515,1,STEP,751675847400,751677499100,1651700,-1
516,1,STEP,751677529600,751679166900,1637300,-1
517,1,STEP,751679197700,751680915300,1717600,-1
518,1,STEP,751680954100,751682748500,1794400,-1
519,1,STEP,751682801100,751684474000,1672900,-1
520,1,STEP,751684520100,751686167300,1647200,-1
521,1,STEP,751686202900,751687851100,1648200,-1
522,1,STEP,751687888000,751689755000,1867000,-1
523,1,STEP,751689890700,751691725700,1835000,-1
524,1,STEP,751691773300,751693498600,1725300,-1
525,1,STEP,751693541200,751695257300,1716100,-1
526,1,STEP,751695309300,751697171700,1862400,-1
527,1,STEP,751697226400,751698962600,1736200,-1
528,1,STEP,751699006500,751700664700,1658200,-1
529,1,STEP,751700702700,751702372400,1669700,-1
530,1,STEP,751702419600,751704234900,1815300,-1
531,1,STEP,751704290900,751705926900,1636000,-1
532,1,STEP,751705968700,751707653700,1685000,-1
533,1,STEP,751707704400,751709420400,1716000,-1
534,1,STEP,751709466000,751711163000,1697000,-1
535,1,STEP,751711209400,751712871400,1662000,-1
536,1,STEP,751712912800,751714556200,1643400,-1
537,1,STEP,751714590100,751716335400,1745300,-1
538,1,STEP,751716375100,751718044100,1669000,-1
539,1,STEP,751718095400,751719763600,1668200,-1
540,1,STEP,751719803800,751721506500,1702700,-1
541,1,STEP,751721540500,751723264600,1724100,-1
542,1,STEP,751723312700,751725102600,1789900,-1
543,1,STEP,751725164800,751726833500,1668700,-1
544,1,STEP,751726869200,751728585100,1715900,-1
545,1,STEP,751728622800,751730289100,1666300,-1
546,1,STEP,751730336900,751731976900,1640000,-1
547,1,STEP,751732016900,751733694700,1677800,-1
548,1,STEP,751733732200,751735372700,1640500,-1
549,1,STEP,751735434600,751737243200,1808600,-1
550,1,STEP,751737285800,751738937200,1651400,-1
551,1,STEP,751738991300,751740689700,1698400,-1
552,1,STEP,751740729600,751742352100,1622500,-1
553,1,STEP,751742383400,751744164200,1780800,-1
554,1,STEP,751744209200,751745897700,1688500,-1
555,1,STEP,751745943900,751747574200,1630300,-1
556,1,STEP,751747607200,751749261300,1654100,-1
557,1,STEP,751749291800,751751055300,1763500,-1
558,1,STEP,751751185300,751753125300,1940000,-1
559,1,STEP,751753166700,751755226800,2060100,-1
560,1,STEP,751755252900,751757318200,2065300,-1
561,1,STEP,751757345800,751759428300,2082500,-1
562,1,STEP,751759456400,751761181600,1725200,-1
563,1,STEP,751761218300,751762687100,1468800,-1
564,1,STEP,751762712300,751764219100,1506800,-1
565,1,STEP,751764244300,751765786000,1541700,-1
566,1,STEP,751765812300,751767329400,1517100,-1
567,1,STEP,751767353300,751768872400,1519100,-1
568,1,STEP,751768896100,751770365800,1469700,-1
569,1,STEP,751770391200,751772015300,1624100,-1
570,1,STEP,751772042700,751773588900,1546200,-1
571,1,STEP,751773620500,751775155900,1535400,-1
572,1,STEP,751775180700,751776653300,1472600,-1
573,1,STEP,751776677100,751778244400,1567300,-1
574,1,STEP,751778273600,751779800000,1526400,-1
575,1,STEP,751779837600,751781417200,1579600,-1
576,1,STEP,751781462900,751783045500,1582600,-1
577,1,STEP,751783077500,751784557700,1480200,-1
578,1,STEP,751784582000,751786204500,1622500,-1
579,1,STEP,751786267500,751787856300,1588800,-1
580,1,STEP,751787884600,751789420000,1535400,-1
581,1,STEP,751789447200,751790970300,1523100,-1
582,1,STEP,751790996200,751792524200,1528000,-1
583,1,STEP,751792590800,751794211800,1621000,-1
584,1,STEP,751794263800,751795795300,1531500,-1
585,1,STEP,751795854000,751797438100,1584100,-1
586,1,STEP,751797473000,751799134700,1661700,-1
587,1,STEP,751799174800,751801045400,1870600,-1
588,1,STEP,751801141600,751802883900,1742300,-1
589,1,STEP,751802928100,751804685100,1757000,-1
590,1,STEP,751804716300,751806600400,1884100,-1
591,1,STEP,751806659200,751808612200,1953000,-1
592,1,STEP,751808671000,751810193800,1522800,-1
593,1,STEP,751810232400,751811763300,1530900,-1
594,1,STEP,751811788200,751813504700,1716500,-1
595,1,STEP,751813559200,751815214300,1655100,-1
596,1,STEP,751815262600,751817021100,1758500,-1
597,1,STEP,751817086100,751818820800,1734700,-1
598,1,STEP,751818876100,751820604000,1727900,-1
599,1,STEP,751820669300,751822432300,1763000,-1
600,1,STEP,751822477200,751824240400,1763200,-1
601,1,STEP,751824287600,751826014400,1726800,-1
602,1,STEP,751826056500,751827821000,1764500,-1
603,1,STEP,751827910100,751829544700,1634600,-1
604,1,STEP,751829586100,751831112900,1526800,-1
605,1,STEP,751831145900,751832714500,1568600,-1
606,1,STEP,751832757900,751834357900,1600000,-1
607,1,STEP,751834412600,751836230800,1818200,-1
608,1,STEP,751836285100,751837858900,1573800,-1
609,1,STEP,751837895600,751839562100,1666500,-1
610,1,STEP,751839609700,751841377900,1768200,-1
611,1,STEP,751841438600,751843216900,1778300,-1
612,1,STEP,751843269700,751844827100,1557400,-1
613,1,STEP,751844875500,751846450800,1575300,-1
614,1,STEP,751846494200,751848196700,1702500,-1
615,1,STEP,751848245600,751849990800,1745200,-1
616,1,STEP,751850057200,751851593600,1536400,-1
617,1,STEP,751851631600,751853242100,1610500,-1
618,1,STEP,751853314800,751854902400,1587600,-1
619,1,STEP,751854949300,751856752500,1803200,-1
620,1,STEP,751856821900,751858403700,1581800,-1
621,1,STEP,751858450700,751859997100,1546400,-1
622,1,STEP,751860073400,751862056500,1983100,-1
623,1,STEP,751862112800,751863907400,1794600,-1
624,1,STEP,751863954800,751865550500,1595700,-1
625,1,STEP,751865598900,751867153700,1554800,-1
626,1,STEP,751867194300,751868934300,1740000,-1
627,1,STEP,751868989800,751870782400,1792600,-1
628,1,STEP,751870835800,751872423200,1587400,-1
629,1,STEP,751872464100,751874377300,1913200,-1
630,1,STEP,751874423800,751876191700,1767900,-1
631,1,STEP,751876251200,751877932100,1680900,-1
632,1,STEP,751877974700,751879522600,1547900,-1
633,1,STEP,751879564700,751881193900,1629200,-1
634,1,STEP,751881241000,751882743500,1502500,-1
635,1,STEP,751882782600,751884467000,1684400,-1
636,1,STEP,751884525900,751886118100,1592200,-1
637,1,STEP,751886156100,751887651100,1495000,-1
638,1,STEP,751887698700,751889446700,1748000,-1
639,1,STEP,751889526200,751891421200,1895000,-1
640,1,STEP,751891542600,751893256300,1713700,-1
641,1,STEP,751893311800,751894876500,1564700,-1
642,1,STEP,751894951500,751896683400,1731900,-1
643,1,STEP,751896740000,751898620100,1880100,-1
644,1,STEP,751898671200,751900233800,1562600,-1
645,1,STEP,751900272300,751902186800,1914500,-1
646,1,STEP,751902230700,751904030100,1799400,-1
647,1,STEP,751904144800,751905850000,1705200,-1
648,1,STEP,751905902800,751907601900,1699100,-1
649,1,STEP,751907647000,751909283600,1636600,-1
650,1,STEP,751909318200,751911031100,1712900,-1
651,1,STEP,751911087400,751912793400,1706000,-1
652,1,STEP,751912837000,751914493000,1656000,-1
653,1,STEP,751914534700,751916186500,1651800,-1
654,1,STEP,751916220400,751917869900,1649500,-1
655,1,STEP,751917922100,751919603700,1681600,-1
656,1,STEP,751919650500,751921356200,1705700,-1
657,1,STEP,751921399400,751923078900,1679500,-1
658,1,STEP,751923118700,751924843600,1724900,-1
659,1,STEP,751924914900,751926643600,1728700,-1
660,1,STEP,751926695900,751928448700,1752800,-1
661,1,STEP,751928497800,751930502300,2004500,-1
662,1,STEP,751930619600,751932762200,2142600,-1
663,1,STEP,751932822800,751934626000,1803200,-1
664,1,STEP,751934718600,751936446800,1728200,-1
665,1,STEP,751936497700,751938182100,1684400,-1
666,1,STEP,751938238400,751940006500,1768100,-1
667,1,STEP,751940082200,751941766800,1684600,-1
668,1,STEP,751941818900,751943649400,1830500,-1
669,1,STEP,751943700400,751945451400,1751000,-1
670,1,STEP,751945515000,751947344500,1829500,-1
671,1,STEP,751947407400,751949236300,1828900,-1
672,1,STEP,751949283100,751950959400,1676300,-1
673,1,STEP,751950994800,751953190700,2195900,-1
674,1,STEP,751953277600,751955547200,2269600,-1
675,1,STEP,751955591500,751957777800,2186300,-1
676,1,STEP,751957822700,751960261500,2438800,-1
677,1,STEP,751960343600,751962910800,2567200,-1
678,1,STEP,751962962900,751965416500,2453600,-1
679,1,STEP,751965483400,751967491100,2007700,-1
680,1,STEP,751967570500,751969879300,2308800,-1
681,1,STEP,751969942700,751971679000,1736300,-1
682,1,STEP,751971728600,751973477700,1749100,-1
683,1,STEP,751973563300,751975222300,1659000,-1
684,1,STEP,751975270000,751976851000,1581000,-1
685,1,STEP,751976888900,751978498600,1609700,-1
686,1,STEP,751978556700,751980177300,1620600,-1
687,1,STEP,751980223100,751981863100,1640000,-1
688,1,STEP,751981909100,751983478200,1569100,-1
689,1,STEP,751983524800,751985099000,1574200,-1
690,1,STEP,751985148000,751986826700,1678700,-1
691,1,STEP,751986874100,751988661800,1787700,-1
692,1,STEP,751988711300,751990217500,1506200,-1
693,1,STEP,751990250300,751991761600,1511300,-1
694,1,STEP,751991801700,751993469000,1667300,-1
695,1,STEP,751993499200,751995067400,1568200,-1
696,1,STEP,751995131800,751996710600,1578800,-1
697,1,STEP,751996741100,751998254300,1513200,-1
698,1,STEP,751998295500,751999828200,1532700,-1
699,1,STEP,751999853600,752001426900,1573300,-1
700,1,STEP,752001482400,752002997600,1515200,-1
701,1,STEP,752003039700,752004604300,1564600,-1
702,1,STEP,752004642600,752006185400,1542800,-1
703,1,STEP,752006214100,752007813600,1599500,-1
704,1,STEP,752007848000,752009472200,1624200,-1
705,1,STEP,752009514200,752010999100,1484900,-1
706,1,STEP,752011023300,752012559000,1535700,-1
707,1,STEP,752012585800,752014114200,1528400,-1
708,1,STEP,752014138900,752015731500,1592600,-1
709,1,STEP,752015796800,752017363800,1567000,-1
710,1,STEP,752017391100,752018910400,1519300,-1
711,1,STEP,752018934300,752020543700,1609400,-1
712,1,STEP,752020576700,752022287900,1711200,-1
713,1,STEP,752022395500,752024110200,1714700,-1
714,1,STEP,752024148300,752025788700,1640400,-1
715,1,STEP,752025816900,752027502300,1685400,-1
716,1,STEP,752027527900,752029471200,1943300,-1
717,1,STEP,752029520300,752031097400,1577100,-1
718,1,STEP,752031130300,752032808100,1677800,-1
719,1,STEP,752032849600,752034511700,1662100,-1
720,1,STEP,752034537600,752036297400,1759800,-1
721,1,STEP,752036395900,752038550900,2155000,-1
722,1,STEP,752038667800,752040355700,1687900,-1
723,1,STEP,752040414500,752042480300,2065800,-1
724,1,STEP,752042543700,752045905200,3361500,-1
725,1,STEP,752046145200,752048306500,2161300,-1
726,1,STEP,752048364500,752050166600,1802100,-1
727,1,STEP,752050292600,752052019800,1727200,-1
728,1,STEP,752052089300,752054054300,1965000,-1
729,1,STEP,752054178900,752055963000,1784100,-1
730,1,STEP,752056040600,752057789400,1748800,-1
731,1,STEP,752057891700,752059785900,1894200,-1
732,1,STEP,752059866800,752061854200,1987400,-1
733,1,STEP,752061915000,752064061100,2146100,-1
734,1,STEP,752064175400,752066039200,1863800,-1
735,1,STEP,752066148100,752068304600,2156500,-1
736,1,STEP,752068345600,752070387600,2042000,-1
737,1,STEP,752070441900,752072267000,1825100,-1
738,1,STEP,752072315400,752073848900,1533500,-1
739,1,STEP,752073887500,752075447500,1560000,-1
740,1,STEP,752075494300,752077314400,1820100,-1
741,1,STEP,752077374200,752079452600,2078400,-1
742,1,STEP,752079522200,752081258100,1735900,-1
743,1,STEP,752081316100,752083044800,1728700,-1
744,1,STEP,752083078000,752084742300,1664300,-1
745,1,STEP,752084801300,752086586400,1785100,-1
746,1,STEP,752086645200,752088680100,2034900,-1
747,1,STEP,752088707400,752090208500,1501100,-1
748,1,STEP,752090234000,752091793100,1559100,-1
749,1,STEP,752091837700,752093311500,1473800,-1
750,1,STEP,752093335700,752094792100,1456400,-1
751,1,STEP,752094815800,752096274800,1459000,-1
752,1,STEP,752096298600,752097829600,1531000,-1
753,1,STEP,752097867300,752099434200,1566900,-1
754,1,STEP,752099479200,752100952700,1473500,-1
755,1,STEP,752100979800,752102510200,1530400,-1
756,1,STEP,752102541300,752104037300,1496000,-1
757,1,STEP,752104061900,752105689600,1627700,-1
758,1,STEP,752105725500,752107186100,1460600,-1
759,1,STEP,752107211100,752108740800,1529700,-1
760,1,STEP,752108767100,752110274300,1507200,-1
761,1,STEP,752110299600,752111833300,1533700,-1
762,1,STEP,752111865500,752113365300,1499800,-1
763,1,STEP,752113390300,752114878400,1488100,-1
764,1,STEP,752114902400,752116383800,1481400,-1
765,1,STEP,752116407700,752117875100,1467400,-1
766,1,STEP,752117898600,752119478500,1579900,-1
767,1,STEP,752119511500,752120991800,1480300,-1
768,1,STEP,752121023600,752122497500,1473900,-1
769,1,STEP,752122521700,752124002300,1480600,-1
770,1,STEP,752124026200,752125699800,1673600,-1
771,1,STEP,752125727800,752127293300,1565500,-1
772,1,STEP,752127316900,752128839400,1522500,-1
773,1,STEP,752128862800,752130354900,1492100,-1
774,1,STEP,752130379500,752131864700,1485200,-1
775,1,STEP,752131888700,752133397300,1508600,-1
776,1,STEP,752133433200,752134905800,1472600,-1
777,1,STEP,752134929700,752136423200,1493500,-1
778,1,STEP,752136446400,752137911800,1465400,-1
779,1,STEP,752137935100,752139588500,1653400,-1
780,1,STEP,752139627700,752141133100,1505400,-1
781,1,STEP,752141157200,752142661400,1504200,-1
782,1,STEP,752142686000,752144154600,1468600,-1
783,1,STEP,752144178700,752145668800,1490100,-1
784,1,STEP,752145692300,752147487100,1794800,-1
785,1,STEP,752147521700,752149546400,2024700,-1
786,1,STEP,752149572100,752151073000,1500900,-1
787,1,STEP,752151096700,752152625900,1529200,-1
788,1,STEP,752152649800,752154226700,1576900,-1
789,1,STEP,752154257900,752155775000,1517100,-1
790,1,STEP,752155800200,752157303700,1503500,-1
791,1,STEP,752157327100,752158831100,1504000,-1
792,1,STEP,752158854400,752160577200,1722800,-1
793,1,STEP,752160605300,752162201100,1595800,-1
794,1,STEP,752162225000,752163733500,1508500,-1
795,1,STEP,752163757000,752165244900,1487900,-1
796,1,STEP,752165268600,752166831800,1563200,-1
797,1,STEP,752166859100,752168461500,1602400,-1
798,1,STEP,752168490700,752169968000,1477300,-1
799,1,STEP,752169992500,752171552800,1560300,-1
800,1,STEP,752171577400,752173061000,1483600,-1
801,1,STEP,752173085200,752174617500,1532300,-1
802,1,STEP,752174644900,752176173800,1528900,-1
803,1,STEP,752176197800,752177681400,1483600,-1
804,1,STEP,752177704900,752179180200,1475300,-1
805,1,STEP,752179203600,752180930200,1726600,-1
806,1,STEP,752180958200,752182547600,1589400,-1
807,1,STEP,752182572600,752184058900,1486300,-1
808,1,STEP,752184082500,752185557900,1475400,-1
809,1,STEP,752185581500,752187134200,1552700,-1
810,1,STEP,752187165000,752188741300,1576300,-1
811,1,STEP,752188785600,752190310600,1525000,-1
812,1,STEP,752190338600,752191845300,1506700,-1
813,1,STEP,752191869700,752193395600,1525900,-1
814,1,STEP,752193419300,752195140300,1721000,-1
815,1,STEP,752195176600,752196788600,1612000,-1
816,1,STEP,752196813900,752198333500,1519600,-1
817,1,STEP,752198357000,752199875200,1518200,-1
818,1,STEP,752199900000,752201447900,1547900,-1
819,1,STEP,752201483100,752203273700,1790600,-1
820,1,STEP,752203319500,752204875600,1556100,-1
821,1,STEP,752204900900,752206406500,1505600,-1
822,1,STEP,752206430500,752207926900,1496400,-1
823,1,STEP,752207959700,752209578900,1619200,-1
824,1,STEP,752209627400,752211210500,1583100,-1
825,1,STEP,752211238700,752212876800,1638100,-1
826,1,STEP,752212907600,752214389700,1482100,-1
827,1,STEP,752214415100,752216126400,1711300,-1
828,1,STEP,752216170800,752217860000,1689200,-1
829,1,STEP,752217885900,752219407500,1521600,-1
830,1,STEP,752219434900,752220921600,1486700,-1
831,1,STEP,752220945400,752222603000,1657600,-1
832,1,STEP,752222629800,752224330200,1700400,-1
833,1,STEP,752224356200,752226224900,1868700,-1
834,1,STEP,752226248900,752228060400,1811500,-1
835,1,STEP,752228083800,752229740600,1656800,-1
836,1,STEP,752229773100,752231411700,1638600,-1
837,1,STEP,752231436200,752232994100,1557900,-1
838,1,STEP,752233018500,752234517300,1498800,-1
839,1,STEP,752234542800,752236256200,1713400,-1
840,1,STEP,752236283500,752237817800,1534300,-1
841,1,STEP,752237846700,752239348700,1502000,-1
842,1,STEP,752239380200,752240873900,1493700,-1
843,1,STEP,752240898700,752242374600,1475900,-1
844,1,STEP,752242398500,752243926400,1527900,-1
845,1,STEP,752243955700,752245531700,1576000,-1
846,1,STEP,752245555800,752247091100,1535300,-1
847,1,STEP,752247115000,752248611400,1496400,-1
848,1,STEP,752248634800,752250205400,1570600,-1
849,1,STEP,752250240700,752251831400,1590700,-1
850,1,STEP,752251860000,752253335000,1475000,-1
851,1,STEP,752253364900,752254824000,1459100,-1
852,1,STEP,752254847900,752256334900,1487000,-1
853,1,STEP,752256366100,752257891600,1525500,-1
854,1,STEP,752257926700,752259450500,1523800,-1
855,1,STEP,752259476900,752260998500,1521600,-1
856,1,STEP,752261022500,752262563100,1540600,-1
857,1,STEP,752262587900,752264265700,1677800,-1
858,1,STEP,752264294500,752265893600,1599100,-1
859,1,STEP,752265921300,752267391300,1470000,-1
860,1,STEP,752267415100,752268899400,1484300,-1
861,1,STEP,752268923200,752270421700,1498500,-1
862,1,STEP,752270446400,752271979900,1533500,-1
863,1,STEP,752272009600,752273561800,1552200,-1
864,1,STEP,752273586100,752275128700,1542600,-1
865,1,STEP,752275152400,752276771300,1618900,-1
866,1,STEP,752276795300,752278553100,1757800,-1
867,1,STEP,752278583300,752280093600,1510300,-1
868,1,STEP,752280119100,752281629100,1510000,-1
869,1,STEP,752281656700,752283158100,1501400,-1
870,1,STEP,752283183200,752284655500,1472300,-1
871,1,STEP,752284679100,752286339200,1660100,-1
872,1,STEP,752286368200,752287841300,1473100,-1
873,1,STEP,752287865000,752289368400,1503400,-1
874,1,STEP,752289400600,752290889900,1489300,-1
875,1,STEP,752290914800,752292616700,1701900,-1
876,1,STEP,752292645300,752294362500,1717200,-1
877,1,STEP,752294386600,752296061100,1674500,-1
878,1,STEP,752296084600,752297879600,1795000,-1
879,1,STEP,752297909200,752299653800,1744600,-1
880,1,STEP,752299683000,752301399900,1716900,-1
881,1,STEP,752301424100,752303112900,1688800,-1
882,1,STEP,752303136800,752305060600,1923800,-1
883,1,STEP,752305085600,752306911700,1826100,-1
884,1,STEP,752306955400,752308696100,1740700,-1
885,1,STEP,752308723400,752310552800,1829400,-1
886,1,STEP,752310580800,752312430300,1849500,-1
887,1,STEP,752312456500,752314412200,1955700,-1
888,1,STEP,752314465100,752316159600,1694500,-1
889,1,STEP,752316186800,752317969500,1782700,-1
890,1,STEP,752317994600,752319770400,1775800,-1
891,1,STEP,752319798000,752321896000,2098000,-1
892,1,STEP,752321940300,752323789900,1849600,-1
893,1,STEP,752323818500,752325831600,2013100,-1
894,1,STEP,752325862000,752328053200,2191200,-1
895,1,STEP,752328122400,752329861100,1738700,-1
896,1,STEP,752329919000,752331741100,1822100,-1
897,1,STEP,752331777500,752333731900,1954400,-1
898,1,STEP,752333763000,752335630100,1867100,-1
899,1,STEP,752335732100,752337431300,1699200,-1
900,1,STEP,752337476000,752339514800,2038800,-1
901,1,STEP,752339573400,752341623600,2050200,-1
902,1,STEP,752341724900,752343529100,1804200,-1
903,1,STEP,752343574500,752345310700,1736200,-1
904,1,STEP,752345350100,752347441600,2091500,-1
905,1,STEP,752347489100,752349711900,2222800,-1
906,1,STEP,752349765300,752351866600,2101300,-1
907,1,STEP,752351924200,752354078100,2153900,-1
908,1,STEP,752354120000,752356299000,2179000,-1
909,1,STEP,752356398100,752358451100,2053000,-1
910,1,STEP,752358488900,752360830700,2341800,-1
911,1,STEP,752360903300,752363092700,2189400,-1
912,1,STEP,752363206100,752365015000,1808900,-1
913,1,STEP,752365077600,752367349900,2272300,-1
914,1,STEP,752367469100,752369487800,2018700,-1
915,1,STEP,752369569800,752371734200,2164400,-1
916,1,STEP,752371845500,752374087700,2242200,-1
917,1,STEP,752374142900,752376515000,2372100,-1
918,1,STEP,752376633700,752378921600,2287900,-1
919,1,STEP,752378972700,752380863500,1890800,-1
920,1,STEP,752380920100,752382923000,2002900,-1
921,1,STEP,752383003700,752385444700,2441000,-1
922,1,STEP,752385515200,752387801000,2285800,-1
923,1,STEP,752387901300,752389956300,2055000,-1
924,1,STEP,752390016300,752392146900,2130600,-1
925,1,STEP,752392305100,752394717700,2412600,-1
926,1,STEP,752394794300,752397075200,2280900,-1
927,1,STEP,752397159300,752399024100,1864800,-1
928,1,STEP,752399127200,752401339800,2212600,-1
929,1,STEP,752401387700,752403616500,2228800,-1
930,1,STEP,752403692200,752405779400,2087200,-1
931,1,STEP,752405877900,752407717900,1840000,-1
932,1,STEP,752407765200,752409984500,2219300,-1
933,1,STEP,752410123000,752412358500,2235500,-1
934,1,STEP,752412454700,752414530800,2076100,-1
935,1,STEP,752414618400,752416573800,1955400,-1
936,1,STEP,752416626300,752418929700,2303400,-1
937,1,STEP,752419013900,752421358600,2344700,-1
938,1,STEP,752421414700,752423966800,2552100,-1
939,1,STEP,752424048100,752426268800,2220700,-1
940,1,STEP,752426344700,752428690300,2345600,-1
941,1,STEP,752428739600,752430935300,2195700,-1
942,1,STEP,752431010500,752433169500,2159000,-1
943,1,STEP,752433288000,752435471700,2183700,-1
944,1,STEP,752435531100,752437803900,2272800,-1
945,1,STEP,752437878500,752440019200,2140700,-1
946,1,STEP,752440116100,752442319800,2203700,-1
947,1,STEP,752442373600,752444116700,1743100,-1
948,1,STEP,752444166400,752445948000,1781600,-1
949,1,STEP,752446018200,752447727300,1709100,-1
950,1,STEP,752447806400,752449505200,1698800,-1
951,1,STEP,752449561800,752451396000,1834200,-1
952,1,STEP,752451442600,752453222500,1779900,-1
953,1,STEP,752453286300,752454893500,1607200,-1
954,1,STEP,752454961900,752456507800,1545900,-1
955,1,STEP,752456549800,752458455100,1905300,-1
956,1,STEP,752458537300,752460514500,1977200,-1
957,1,STEP,752460603100,752462217800,1614700,-1
958,1,STEP,752462269300,752463823700,1554400,-1
959,1,STEP,752463878300,752465640500,1762200,-1
960,1,STEP,752465719100,752467441100,1722000,-1
961,1,STEP,752467504100,752469104500,1600400,-1
962,1,STEP,752469146200,752470881100,1734900,-1
963,1,STEP,752470927500,752472846500,1919000,-1
964,1,STEP,752472936000,752474941600,2005600,-1
965,1,STEP,752475028100,752477014700,1986600,-1
966,1,STEP,752477063000,752478559500,1496500,-1
967,1,STEP,752478588200,752480407100,1818900,-1
968,1,STEP,752480487500,752482110300,1622800,-1
969,1,STEP,752482188800,752484020200,1831400,-1
970,1,STEP,752484057500,752485747400,1689900,-1
971,1,STEP,752485787500,752487835200,2047700,-1
972,1,STEP,752487908300,752489919600,2011300,-1
973,1,STEP,752489969400,752491941100,1971700,-1
974,1,STEP,752491991500,752493957600,1966100,-1
975,1,STEP,752494019700,752496143700,2124000,-1
976,1,STEP,752496223800,752498100400,1876600,-1
977,1,STEP,752498151900,752499838000,1686100,-1
978,1,STEP,752499898000,752501731000,1833000,-1
979,1,STEP,752501788300,752503322100,1533800,-1
980,1,STEP,752503349200,752504899700,1550500,-1
981,1,STEP,752504925700,752506453400,1527700,-1
982,1,STEP,752506476900,752508125200,1648300,-1
983,1,STEP,752508219000,752509946400,1727400,-1
984,1,STEP,752510016100,752511561900,1545800,-1
985,1,STEP,752511587500,752513115700,1528200,-1
986,1,STEP,752513140000,752515053900,1913900,-1
987,1,STEP,752515140900,752516748600,1607700,-1
988,1,STEP,752516814000,752518376000,1562000,-1
989,1,STEP,752518410400,752520228600,1818200,-1
990,1,STEP,752520284900,752522017900,1733000,-1
991,1,STEP,752522075600,752523990100,1914500,-1
992,1,STEP,752524056700,752525707600,1650900,-1
993,1,STEP,752525737500,752527753800,2016300,-1
994,1,STEP,752527833400,752530053300,2219900,-1
995,1,STEP,752530110000,752531734100,1624100,-1
996,1,STEP,752531778300,752533354900,1576600,-1
997,1,STEP,752533387000,752535319200,1932200,-1
998,1,STEP,752535397000,752537324100,1927100,-1
999,1,STEP,752537387200,752539212300,1825100,-1
