Gen,Resource,Stamp,TimeStamp_Start,TimeStamp_End,Duration,Indiv_id
0,1,TransfertToDevice,346998611700,348563197800,1564586100,-1
0,1,STEP,349007249500,349066929100,59679600,-1
1,1,STEP,349066976600,349126356400,59379800,-1
2,1,STEP,349126410300,349185923400,59513100,-1
3,1,STEP,349185970400,349245340100,59369700,-1
4,1,STEP,349245394400,349304915100,59520700,-1
5,1,STEP,349304969400,349364187700,59218300,-1
6,1,STEP,349364249000,349423578500,59329500,-1
7,1,STEP,349423634000,349483523800,59889800,-1
8,1,STEP,349483576200,349543473000,59896800,-1
9,1,STEP,349543532600,349603397400,59864800,-1
10,1,STEP,349603456300,349663040800,59584500,-1
11,1,STEP,349663090600,349722994700,59904100,-1
12,1,STEP,349723043100,349782970400,59927300,-1
13,1,STEP,349783025100,349842895200,59870100,-1
14,1,STEP,349842943700,349902618800,59675100,-1
15,1,STEP,349902664000,349962537600,59873600,-1
16,1,STEP,349962591000,350022493600,59902600,-1
17,1,STEP,350022543900,350082080400,59536500,-1
18,1,STEP,350082127900,350141789600,59661700,-1
19,1,STEP,350141836400,350201637100,59800700,-1
20,1,STEP,350201685700,350262305700,60620000,-1
21,1,STEP,350262430300,350322742700,60312400,-1
22,1,STEP,350322789000,350382737500,59948500,-1
23,1,STEP,350382790900,350442620700,59829800,-1
24,1,STEP,350442673700,350502394700,59721000,-1
25,1,STEP,350502449500,350561912500,59463000,-1
26,1,STEP,350561990900,350621440100,59449200,-1
27,1,STEP,350621488000,350681306600,59818600,-1
28,1,STEP,350681355200,350740978300,59623100,-1
29,1,STEP,350741023800,350800671400,59647600,-1
30,1,STEP,350800720700,350860601300,59880600,-1
31,1,STEP,350860648100,350920600800,59952700,-1
32,1,STEP,350920650000,350980477600,59827600,-1
33,1,STEP,350980525800,351040446000,59920200,-1
34,1,STEP,351040495500,351100359500,59864000,-1
35,1,STEP,351100404600,351160231700,59827100,-1
36,1,STEP,351160276300,351219965700,59689400,-1
37,1,STEP,351220038400,351279708100,59669700,-1
38,1,STEP,351279754300,351339722900,59968600,-1
39,1,STEP,351339777000,351399777500,60000500,-1
40,1,STEP,351399825900,351459619600,59793700,-1
41,1,STEP,351459668200,351519385900,59717700,-1
42,1,STEP,351519436700,351579189500,59752800,-1
43,1,STEP,351579242000,351638781000,59539000,-1
44,1,STEP,351638861900,351698248200,59386300,-1
45,1,STEP,351698332800,351757849700,59516900,-1
46,1,STEP,351757910000,351817313400,59403400,-1
47,1,STEP,351817365300,351877205000,59839700,-1
48,1,STEP,351877260600,351936878900,59618300,-1
49,1,STEP,351936930600,351996647000,59716400,-1
50,1,STEP,351996697100,352056557100,59860000,-1
51,1,STEP,352056608200,352116551700,59943500,-1
52,1,STEP,352116600700,352176453500,59852800,-1
53,1,STEP,352176507200,352236400600,59893400,-1
54,1,STEP,352236447900,352296439100,59991200,-1
55,1,STEP,352296490800,352356400600,59909800,-1
56,1,STEP,352356454300,352416299000,59844700,-1
57,1,STEP,352416346700,352476320100,59973400,-1
58,1,STEP,352476384700,352536050500,59665800,-1
59,1,STEP,352536098600,352595635000,59536400,-1
60,1,STEP,352595691800,352655651200,59959400,-1
61,1,STEP,352655698900,352715555800,59856900,-1
62,1,STEP,352715606500,352775594500,59988000,-1
63,1,STEP,352775666100,352835206900,59540800,-1
64,1,STEP,352835261500,352894668700,59407200,-1
65,1,STEP,352894721400,352954332000,59610600,-1
66,1,STEP,352954381100,353014313100,59932000,-1
67,1,STEP,353014375200,353074368600,59993400,-1
68,1,STEP,353074418600,353134243400,59824800,-1
69,1,STEP,353134297300,353194302500,60005200,-1
70,1,STEP,353194350500,353254235800,59885300,-1
71,1,STEP,353254282200,353314078900,59796700,-1
72,1,STEP,353314127800,353374143200,60015400,-1
73,1,STEP,353374191000,353434049300,59858300,-1
74,1,STEP,353434096300,353494001700,59905400,-1
75,1,STEP,353494051800,353553886600,59834800,-1
76,1,STEP,353553958500,353613624400,59665900,-1
77,1,STEP,353613671600,353673537300,59865700,-1
78,1,STEP,353673587600,353733461800,59874200,-1
79,1,STEP,353733508800,353793360800,59852000,-1
80,1,STEP,353793410100,353853235400,59825300,-1
81,1,STEP,353853292800,353913255800,59963000,-1
82,1,STEP,353913304900,353972903200,59598300,-1
83,1,STEP,353972965200,354032462600,59497400,-1
84,1,STEP,354032539100,354092301000,59761900,-1
85,1,STEP,354092351700,354152307200,59955500,-1
86,1,STEP,354152361100,354212214200,59853100,-1
87,1,STEP,354212261900,354272026700,59764800,-1
88,1,STEP,354272081900,354331910500,59828600,-1
89,1,STEP,354331976300,354391836900,59860600,-1
90,1,STEP,354391887900,354451751000,59863100,-1
91,1,STEP,354451796100,354511585300,59789200,-1
92,1,STEP,354511636900,354571281100,59644200,-1
93,1,STEP,354571323600,354631200500,59876900,-1
94,1,STEP,354631317800,354691590500,60272700,-1
95,1,STEP,354691637600,354751452000,59814400,-1
96,1,STEP,354751499900,354811340500,59840600,-1
97,1,STEP,354811387500,354871231400,59843900,-1
98,1,STEP,354871277100,354930917100,59640000,-1
99,1,STEP,354930965600,354990913300,59947700,-1
100,1,STEP,354990967300,355050744600,59777300,-1
101,1,STEP,355050795400,355110579000,59783600,-1
102,1,STEP,355110640000,355170123200,59483200,-1
103,1,STEP,355170181300,355229479900,59298600,-1
104,1,STEP,355229545000,355289395900,59850900,-1
105,1,STEP,355289445200,355349274500,59829300,-1
106,1,STEP,355349323900,355409209800,59885900,-1
107,1,STEP,355409258300,355469141500,59883200,-1
108,1,STEP,355469185100,355529240800,60055700,-1
109,1,STEP,355529290800,355589185300,59894500,-1
110,1,STEP,355589237100,355649045700,59808600,-1
111,1,STEP,355649094400,355709030600,59936200,-1
112,1,STEP,355709076200,355768919600,59843400,-1
113,1,STEP,355768972200,355828795800,59823600,-1
114,1,STEP,355828842200,355888679600,59837400,-1
115,1,STEP,355888726000,355948673500,59947500,-1
116,1,STEP,355948722700,356008779300,60056600,-1
117,1,STEP,356008831900,356068696100,59864200,-1
118,1,STEP,356068749100,356128685800,59936700,-1
119,1,STEP,356128733500,356188881400,60147900,-1
120,1,STEP,356188943400,356248870900,59927500,-1
121,1,STEP,356249012300,356308759900,59747600,-1
122,1,STEP,356308817500,356367977100,59159600,-1
123,1,STEP,356368033200,356427698900,59665700,-1
124,1,STEP,356427748600,356487554600,59806000,-1
125,1,STEP,356487620100,356547504100,59884000,-1
126,1,STEP,356547551100,356607195600,59644500,-1
127,1,STEP,356607244200,356666910100,59665900,-1
128,1,STEP,356666960300,356727169300,60209000,-1
129,1,STEP,356727219900,356787505200,60285300,-1
130,1,STEP,356787550200,356847818900,60268700,-1
131,1,STEP,356847870100,356908103800,60233700,-1
132,1,STEP,356908157700,356968265300,60107600,-1
133,1,STEP,356968314700,357028507800,60193100,-1
134,1,STEP,357028559300,357088858900,60299600,-1
135,1,STEP,357088905800,357148942000,60036200,-1
136,1,STEP,357148993000,357209143400,60150400,-1
137,1,STEP,357209199400,357269556400,60357000,-1
138,1,STEP,357269606100,357329782800,60176700,-1
139,1,STEP,357329839200,357389902500,60063300,-1
140,1,STEP,357389959300,357449825500,59866200,-1
141,1,STEP,357449875300,357509579800,59704500,-1
142,1,STEP,357509628900,357569752500,60123600,-1
143,1,STEP,357569801300,357630093100,60291800,-1
144,1,STEP,357630138200,357690433600,60295400,-1
145,1,STEP,357690484400,357750844700,60360300,-1
146,1,STEP,357750895600,357811074000,60178400,-1
147,1,STEP,357811133900,357871407300,60273400,-1
148,1,STEP,357871461500,357931652100,60190600,-1
149,1,STEP,357931725500,357991881500,60156000,-1
150,1,STEP,357991927900,358052025200,60097300,-1
151,1,STEP,358052073700,358112164500,60090800,-1
152,1,STEP,358112218900,358172222000,60003100,-1
153,1,STEP,358172271700,358232570800,60299100,-1
154,1,STEP,358232619000,358292939900,60320900,-1
155,1,STEP,358292986800,358353204600,60217800,-1
156,1,STEP,358353250500,358413674700,60424200,-1
157,1,STEP,358413720300,358473896500,60176200,-1
158,1,STEP,358473950600,358534003600,60053000,-1
159,1,STEP,358534062000,358593952900,59890900,-1
160,1,STEP,358594006700,358653737900,59731200,-1
161,1,STEP,358653796300,358713581300,59785000,-1
162,1,STEP,358713632200,358773664000,60031800,-1
163,1,STEP,358773715100,358833748500,60033400,-1
164,1,STEP,358833804200,358893643900,59839700,-1
165,1,STEP,358893695500,358953439900,59744400,-1
166,1,STEP,358953512800,359013489300,59976500,-1
167,1,STEP,359013545900,359073689700,60143800,-1
168,1,STEP,359073735900,359133957100,60221200,-1
169,1,STEP,359134004100,359194215400,60211300,-1
170,1,STEP,359194264300,359254398600,60134300,-1
171,1,STEP,359254446400,359314773100,60326700,-1
172,1,STEP,359314820100,359375083300,60263200,-1
173,1,STEP,359375133300,359435423200,60289900,-1
174,1,STEP,359435469400,359495751600,60282200,-1
175,1,STEP,359495798900,359556138400,60339500,-1
176,1,STEP,359556188500,359616214100,60025600,-1
177,1,STEP,359616279300,359676140900,59861600,-1
178,1,STEP,359676196300,359736219900,60023600,-1
179,1,STEP,359736270600,359796415600,60145000,-1
180,1,STEP,359796473100,359856561100,60088000,-1
181,1,STEP,359856607600,359916772200,60164600,-1
182,1,STEP,359916887700,359977189300,60301600,-1
183,1,STEP,359977247900,360037332000,60084100,-1
184,1,STEP,360037384500,360097720400,60335900,-1
185,1,STEP,360097778300,360157828300,60050000,-1
186,1,STEP,360157876200,360218169900,60293700,-1
187,1,STEP,360218217000,360278631500,60414500,-1
188,1,STEP,360278683200,360338867000,60183800,-1
189,1,STEP,360338934900,360399104000,60169100,-1
190,1,STEP,360399159000,360459326600,60167600,-1
191,1,STEP,360459372100,360519466200,60094100,-1
192,1,STEP,360519515400,360579651200,60135800,-1
193,1,STEP,360579694300,360640017700,60323400,-1
194,1,STEP,360640064400,360700313600,60249200,-1
195,1,STEP,360700360000,360760299100,59939100,-1
196,1,STEP,360760350800,360820269100,59918300,-1
197,1,STEP,360820332300,360880114100,59781800,-1
198,1,STEP,360880165400,360940084700,59919300,-1
199,1,STEP,360940134900,361000059400,59924500,-1
200,1,STEP,361000108500,361060331200,60222700,-1
201,1,STEP,361060379700,361120590500,60210800,-1
202,1,STEP,361120639300,361180685400,60046100,-1
203,1,STEP,361180740600,361240885800,60145200,-1
204,1,STEP,361240946600,361301125700,60179100,-1
205,1,STEP,361301171700,361361451600,60279900,-1
206,1,STEP,361361498100,361421828000,60329900,-1
207,1,STEP,361421878800,361481992400,60113600,-1
208,1,STEP,361482042000,361542288400,60246400,-1
209,1,STEP,361542352900,361602585400,60232500,-1
210,1,STEP,361602632500,361662817800,60185300,-1
211,1,STEP,361662872100,361722959100,60087000,-1
212,1,STEP,361723007200,361783264900,60257700,-1
213,1,STEP,361783400800,361843565200,60164400,-1
214,1,STEP,361843619800,361903432000,59812200,-1
215,1,STEP,361903514100,361963156800,59642700,-1
216,1,STEP,361963211000,362022740800,59529800,-1
217,1,STEP,362022800100,362082557500,59757400,-1
218,1,STEP,362082621200,362142385500,59764300,-1
219,1,STEP,362142440100,362202453600,60013500,-1
220,1,STEP,362202502600,362262628000,60125400,-1
221,1,STEP,362262673600,362323080200,60406600,-1
222,1,STEP,362323126500,362383277000,60150500,-1
223,1,STEP,362383326300,362443661200,60334900,-1
224,1,STEP,362443713200,362503948400,60235200,-1
225,1,STEP,362503996200,362564296500,60300300,-1
226,1,STEP,362564343900,362624702400,60358500,-1
227,1,STEP,362624755800,362685369600,60613800,-1
228,1,STEP,362685417200,362745583800,60166600,-1
229,1,STEP,362745630500,362805755700,60125200,-1
230,1,STEP,362805805600,362865964200,60158600,-1
231,1,STEP,362866008800,362926212000,60203200,-1
232,1,STEP,362926257500,362986492700,60235200,-1
233,1,STEP,362986560300,363046824900,60264600,-1
234,1,STEP,363046878800,363106724000,59845200,-1
235,1,STEP,363106781000,363166876600,60095600,-1
236,1,STEP,363166927600,363227091600,60164000,-1
237,1,STEP,363227140000,363287363100,60223100,-1
238,1,STEP,363287413900,363347752600,60338700,-1
239,1,STEP,363347798800,363408008800,60210000,-1
240,1,STEP,363408054700,363468313900,60259200,-1
241,1,STEP,363468361800,363528273900,59912100,-1
242,1,STEP,363528316600,363588383700,60067100,-1
243,1,STEP,363588431000,363648444400,60013400,-1
244,1,STEP,363648490300,363708629000,60138700,-1
245,1,STEP,363708676200,363768806600,60130400,-1
246,1,STEP,363768853800,363828991200,60137400,-1
247,1,STEP,363829040200,363889222300,60182100,-1
248,1,STEP,363889269900,363950642600,61372700,-1
249,1,STEP,363950695300,364010917100,60221800,-1
250,1,STEP,364010987500,364070852700,59865200,-1
251,1,STEP,364070917100,364130669300,59752200,-1
252,1,STEP,364130722000,364190834900,60112900,-1
253,1,STEP,364190888700,364250995900,60107200,-1
254,1,STEP,364251050400,364310769000,59718600,-1
255,1,STEP,364310828800,364370847500,60018700,-1
256,1,STEP,364370898000,364431202800,60304800,-1
257,1,STEP,364431255800,364491364200,60108400,-1
258,1,STEP,364491412900,364551594300,60181400,-1
259,1,STEP,364551641000,364611883500,60242500,-1
260,1,STEP,364611933300,364672071300,60138000,-1
261,1,STEP,364672118500,364732095900,59977400,-1
262,1,STEP,364732149600,364792297600,60148000,-1
263,1,STEP,364792345500,364852588000,60242500,-1
264,1,STEP,364852640200,364912846100,60205900,-1
265,1,STEP,364912895800,364972846200,59950400,-1
266,1,STEP,364972893500,365033277600,60384100,-1
267,1,STEP,365033326800,365093839100,60512300,-1
268,1,STEP,365093888400,365154221300,60332900,-1
269,1,STEP,365154275500,365214409500,60134000,-1
270,1,STEP,365214460600,365274610800,60150200,-1
271,1,STEP,365274663600,365334273000,59609400,-1
272,1,STEP,365334327900,365394423700,60095800,-1
273,1,STEP,365394479400,365454440800,59961400,-1
274,1,STEP,365454492600,365514358200,59865600,-1
275,1,STEP,365514411300,365574553200,60141900,-1
276,1,STEP,365574602800,365635044600,60441800,-1
277,1,STEP,365635123300,365695389200,60265900,-1
278,1,STEP,365695442300,365755661400,60219100,-1
279,1,STEP,365755704600,365816132900,60428300,-1
280,1,STEP,365816188500,365876423000,60234500,-1
281,1,STEP,365876474900,365936585600,60110700,-1
282,1,STEP,365936634200,365996757800,60123600,-1
283,1,STEP,365996814700,366057006000,60191300,-1
284,1,STEP,366057052000,366117288800,60236800,-1
285,1,STEP,366117347800,366177518400,60170600,-1
286,1,STEP,366177564000,366237590300,60026300,-1
287,1,STEP,366237637600,366297810600,60173000,-1
288,1,STEP,366297866700,366357887000,60020300,-1
289,1,STEP,366357944600,366418221600,60277000,-1
290,1,STEP,366418285600,366478313100,60027500,-1
291,1,STEP,366478371500,366538618200,60246700,-1
292,1,STEP,366538671600,366598452400,59780800,-1
293,1,STEP,366598497800,366658558100,60060300,-1
294,1,STEP,366658622200,366718858100,60235900,-1
295,1,STEP,366718910300,366779158400,60248100,-1
296,1,STEP,366779218600,366839298500,60079900,-1
297,1,STEP,366839354200,366899438500,60084300,-1
298,1,STEP,366899483800,366959635400,60151600,-1
299,1,STEP,366959688800,367020028600,60339800,-1
300,1,STEP,367020078400,367080421000,60342600,-1
301,1,STEP,367080467700,367140755800,60288100,-1
302,1,STEP,367140808600,367200808400,59999800,-1
303,1,STEP,367200858000,367260843500,59985500,-1
304,1,STEP,367260898400,367321015900,60117500,-1
305,1,STEP,367321062000,367381142000,60080000,-1
306,1,STEP,367381201100,367441333400,60132300,-1
307,1,STEP,367441380500,367501628900,60248400,-1
308,1,STEP,367501679100,367562057500,60378400,-1
309,1,STEP,367562107800,367622205900,60098100,-1
310,1,STEP,367622258700,367682576100,60317400,-1
311,1,STEP,367682626400,367742534600,59908200,-1
312,1,STEP,367742589900,367802510000,59920100,-1
313,1,STEP,367802564400,367862701400,60137000,-1
314,1,STEP,367862755400,367922809100,60053700,-1
315,1,STEP,367922859000,367983065200,60206200,-1
316,1,STEP,367983111900,368043345300,60233400,-1
317,1,STEP,368043393200,368103715500,60322300,-1
318,1,STEP,368103764300,368164079200,60314900,-1
319,1,STEP,368164123300,368224394000,60270700,-1
320,1,STEP,368224442600,368284657600,60215000,-1
321,1,STEP,368284705100,368344886500,60181400,-1
322,1,STEP,368344936200,368405058000,60121800,-1
323,1,STEP,368405101800,368465224100,60122300,-1
324,1,STEP,368465276400,368525407300,60130900,-1
325,1,STEP,368525457900,368585469300,60011400,-1
326,1,STEP,368585530600,368645618600,60088000,-1
327,1,STEP,368645688400,368705530400,59842000,-1
328,1,STEP,368705586600,368765675400,60088800,-1
329,1,STEP,368765743400,368825700900,59957500,-1
330,1,STEP,368825763100,368886048900,60285800,-1
331,1,STEP,368886101900,368946156100,60054200,-1
332,1,STEP,368946205000,369006346800,60141800,-1
333,1,STEP,369006394500,369066565800,60171300,-1
334,1,STEP,369066629300,369126972400,60343100,-1
335,1,STEP,369127024600,369187194700,60170100,-1
336,1,STEP,369187244500,369247383600,60139100,-1
337,1,STEP,369247428300,369307674300,60246000,-1
338,1,STEP,369307723200,369368114700,60391500,-1
339,1,STEP,369368164200,369428401500,60237300,-1
340,1,STEP,369428451100,369489079700,60628600,-1
341,1,STEP,369489169600,369549246800,60077200,-1
342,1,STEP,369549395200,369609651700,60256500,-1
343,1,STEP,369609746300,369669967600,60221300,-1
344,1,STEP,369670108700,369730005800,59897100,-1
345,1,STEP,369730074600,369790210300,60135700,-1
346,1,STEP,369790287400,369850162300,59874900,-1
347,1,STEP,369850231200,369910390100,60158900,-1
348,1,STEP,369910457600,369970492200,60034600,-1
349,1,STEP,369970552600,370030769900,60217300,-1
350,1,STEP,370030818600,370091043700,60225100,-1
351,1,STEP,370091109800,370151178300,60068500,-1
352,1,STEP,370151222900,370211363400,60140500,-1
353,1,STEP,370211427600,370271599500,60171900,-1
354,1,STEP,370271703700,370331878400,60174700,-1
355,1,STEP,370331955500,370391816600,59861100,-1
356,1,STEP,370391924000,370451935900,60011900,-1
357,1,STEP,370452006600,370511967400,59960800,-1
358,1,STEP,370512034100,370572125300,60091200,-1
359,1,STEP,370572188300,370632465800,60277500,-1
360,1,STEP,370632535000,370692772100,60237100,-1
361,1,STEP,370692840100,370753079700,60239600,-1
362,1,STEP,370753176500,370813250700,60074200,-1
363,1,STEP,370813342000,370873552600,60210600,-1
364,1,STEP,370873623200,370933955300,60332100,-1
365,1,STEP,370934070600,370994317700,60247100,-1
366,1,STEP,370994372900,371054699600,60326700,-1
367,1,STEP,371054766700,371114822600,60055900,-1
368,1,STEP,371114872600,371175255000,60382400,-1
369,1,STEP,371175336500,371235692500,60356000,-1
370,1,STEP,371235750800,371295714900,59964100,-1
371,1,STEP,371295771600,371355996300,60224700,-1
372,1,STEP,371356050500,371416104500,60054000,-1
373,1,STEP,371416165700,371476298000,60132300,-1
374,1,STEP,371476363000,371536566000,60203000,-1
375,1,STEP,371536694200,371597043000,60348800,-1
376,1,STEP,371597140600,371657421300,60280700,-1
377,1,STEP,371657561900,371718094900,60533000,-1
378,1,STEP,371718187200,371778531000,60343800,-1
379,1,STEP,371778603900,371838812100,60208200,-1
380,1,STEP,371838864900,371898873700,60008800,-1
381,1,STEP,371898952600,371959160600,60208000,-1
382,1,STEP,371959242300,372019393500,60151200,-1
383,1,STEP,372019480300,372079594600,60114300,-1
384,1,STEP,372079666600,372139488800,59822200,-1
385,1,STEP,372139562800,372199365500,59802700,-1
386,1,STEP,372199417100,372259221000,59803900,-1
387,1,STEP,372259273400,372319219000,59945600,-1
388,1,STEP,372319271800,372379301900,60030100,-1
389,1,STEP,372379354400,372439454300,60099900,-1
390,1,STEP,372439499600,372499715700,60216100,-1
391,1,STEP,372499765800,372560029800,60264000,-1
392,1,STEP,372560080100,372620392200,60312100,-1
393,1,STEP,372620438800,372680564200,60125400,-1
394,1,STEP,372680615300,372740839100,60223800,-1
395,1,STEP,372740886900,372801238500,60351600,-1
396,1,STEP,372801290800,372861765700,60474900,-1
397,1,STEP,372861822200,372922063100,60240900,-1
398,1,STEP,372922113600,372982411000,60297400,-1
399,1,STEP,372982459600,373042849600,60390000,-1
400,1,STEP,373042896700,373103156900,60260200,-1
401,1,STEP,373103211800,373163261200,60049400,-1
402,1,STEP,373163308400,373223472900,60164500,-1
403,1,STEP,373223521300,373283198700,59677400,-1
404,1,STEP,373283257400,373343154700,59897300,-1
405,1,STEP,373343224700,373403349100,60124400,-1
406,1,STEP,373403402300,373463741600,60339300,-1
407,1,STEP,373463790200,373524079000,60288800,-1
408,1,STEP,373524129900,373584451700,60321800,-1
409,1,STEP,373584496700,373644693000,60196300,-1
410,1,STEP,373644740600,373704891800,60151200,-1
411,1,STEP,373704937400,373765079200,60141800,-1
412,1,STEP,373765129400,373825338100,60208700,-1
413,1,STEP,373825380700,373885593300,60212600,-1
414,1,STEP,373885644500,373946095300,60450800,-1
415,1,STEP,373946143100,374006406100,60263000,-1
416,1,STEP,374006456400,374066652400,60196000,-1
417,1,STEP,374066715300,374126992600,60277300,-1
418,1,STEP,374127054500,374187315700,60261200,-1
419,1,STEP,374187366100,374247242400,59876300,-1
420,1,STEP,374247297600,374307441400,60143800,-1
421,1,STEP,374307494100,374367581800,60087700,-1
422,1,STEP,374367638200,374427887800,60249600,-1
423,1,STEP,374427951700,374488096600,60144900,-1
424,1,STEP,374488151800,374548277900,60126100,-1
425,1,STEP,374548326700,374608456100,60129400,-1
426,1,STEP,374608503900,374668621400,60117500,-1
427,1,STEP,374668670500,374728769200,60098700,-1
428,1,STEP,374728820600,374788661400,59840800,-1
429,1,STEP,374788731300,374848837900,60106600,-1
430,1,STEP,374849019000,374909247800,60228800,-1
431,1,STEP,374909301600,374969499800,60198200,-1
432,1,STEP,374969546500,375029737800,60191300,-1
433,1,STEP,375029786000,375090119100,60333100,-1
434,1,STEP,375090164800,375150439000,60274200,-1
435,1,STEP,375150484300,375210635000,60150700,-1
436,1,STEP,375210686300,375270865400,60179100,-1
437,1,STEP,375270914500,375331126800,60212300,-1
438,1,STEP,375331176000,375391552000,60376000,-1
439,1,STEP,375391601900,375451577100,59975200,-1
440,1,STEP,375451640700,375511517800,59877100,-1
441,1,STEP,375511589900,375571423700,59833800,-1
442,1,STEP,375571485100,375631372700,59887600,-1
443,1,STEP,375631441300,375691408900,59967600,-1
444,1,STEP,375691464000,375751291400,59827400,-1
445,1,STEP,375751345000,375811331600,59986600,-1
446,1,STEP,375811391300,375871340900,59949600,-1
447,1,STEP,375871402300,375931401900,59999600,-1
448,1,STEP,375931454200,375991527400,60073200,-1
449,1,STEP,375991589900,376051641300,60051400,-1
450,1,STEP,376051699400,376111722400,60023000,-1
451,1,STEP,376111782100,376171544500,59762400,-1
452,1,STEP,376171607300,376231411400,59804100,-1
453,1,STEP,376231463200,376291297700,59834500,-1
454,1,STEP,376291347100,376351381700,60034600,-1
455,1,STEP,376351427400,376411701200,60273800,-1
456,1,STEP,376411749100,376471820000,60070900,-1
457,1,STEP,376471908100,376532054500,60146400,-1
458,1,STEP,376532102800,376592674400,60571600,-1
459,1,STEP,376592733900,376653558700,60824800,-1
460,1,STEP,376653607300,376714444800,60837500,-1
461,1,STEP,376714494300,376775510100,61015800,-1
462,1,STEP,376775555500,376836412600,60857100,-1
463,1,STEP,376836464600,376897381100,60916500,-1
464,1,STEP,376897438300,376958360900,60922600,-1
465,1,STEP,376958420000,377019087900,60667900,-1
466,1,STEP,377019137600,377080047300,60909700,-1
467,1,STEP,377080097900,377140913400,60815500,-1
468,1,STEP,377140985900,377201930700,60944800,-1
469,1,STEP,377201995900,377263021800,61025900,-1
470,1,STEP,377263069900,377324222700,61152800,-1
471,1,STEP,377324283600,377385452300,61168700,-1
472,1,STEP,377385503400,377446242800,60739400,-1
473,1,STEP,377446300200,377507502600,61202400,-1
474,1,STEP,377507568800,377568731500,61162700,-1
475,1,STEP,377568788400,377629622700,60834300,-1
476,1,STEP,377629677100,377689955300,60278200,-1
477,1,STEP,377690009200,377750336500,60327300,-1
478,1,STEP,377750401700,377810901500,60499800,-1
479,1,STEP,377810953600,377871702700,60749100,-1
480,1,STEP,377871767800,377932544300,60776500,-1
481,1,STEP,377932631600,377993369300,60737700,-1
482,1,STEP,377993444200,378053848600,60404400,-1
483,1,STEP,378053943000,378114669800,60726800,-1
484,1,STEP,378114745600,378175230900,60485300,-1
485,1,STEP,378175298900,378236112900,60814000,-1
486,1,STEP,378236252100,378297512200,61260100,-1
487,1,STEP,378297591800,378370569600,72977800,-1
488,1,STEP,378370646100,378431556800,60910700,-1
489,1,STEP,378431624200,378492362000,60737800,-1
490,1,STEP,378492428000,378552571100,60143100,-1
491,1,STEP,378552658400,378613649200,60990800,-1
492,1,STEP,378613736600,378674058100,60321500,-1
493,1,STEP,378674143900,378734466100,60322200,-1
494,1,STEP,378734533300,378794919100,60385800,-1
495,1,STEP,378795030600,378855681600,60651000,-1
496,1,STEP,378855779600,378916349600,60570000,-1
497,1,STEP,378916414400,378976915100,60500700,-1
498,1,STEP,378976980000,379037614200,60634200,-1
499,1,STEP,379037690500,379098025000,60334500,-1
500,1,STEP,379098107200,379158639900,60532700,-1
501,1,STEP,379158703200,379219665700,60962500,-1
502,1,STEP,379219762900,379280540100,60777200,-1
503,1,STEP,379280639800,379341201100,60561300,-1
504,1,STEP,379341294300,379402069400,60775100,-1
505,1,STEP,379402133600,379462499200,60365600,-1
506,1,STEP,379462570300,379523277900,60707600,-1
507,1,STEP,379523347600,379584035800,60688200,-1
508,1,STEP,379584108300,379644464100,60355800,-1
509,1,STEP,379644528700,379705054500,60525800,-1
510,1,STEP,379705124700,379765843100,60718400,-1
511,1,STEP,379766007100,379826806000,60798900,-1
512,1,STEP,379826884500,379888630400,61745900,-1
513,1,STEP,379888702700,379950640800,61938100,-1
514,1,STEP,379950708900,380013275800,62566900,-1
515,1,STEP,380013405600,380075883200,62477600,-1
516,1,STEP,380075968800,380137027100,61058300,-1
517,1,STEP,380137108100,380197929600,60821500,-1
518,1,STEP,380198027600,380259364800,61337200,-1
519,1,STEP,380259453000,380320279800,60826800,-1
520,1,STEP,380320381700,380381442900,61061200,-1
521,1,STEP,380381501200,380442459900,60958700,-1
522,1,STEP,380442547800,380503610100,61062300,-1
523,1,STEP,380503698000,380564932400,61234400,-1
524,1,STEP,380565025300,380626445000,61419700,-1
525,1,STEP,380626576300,380688539200,61962900,-1
526,1,STEP,380688618100,380750379800,61761700,-1
527,1,STEP,380750444200,380811823000,61378800,-1
528,1,STEP,380811874700,380873129700,61255000,-1
529,1,STEP,380873298700,380934559400,61260700,-1
530,1,STEP,380934658700,380995842300,61183600,-1
531,1,STEP,380995900200,381057408200,61508000,-1
532,1,STEP,381057471300,381118829200,61357900,-1
533,1,STEP,381120372800,381185245800,64873000,-1
534,1,STEP,381185365100,381247390200,62025100,-1
535,1,STEP,381247479000,381308589800,61110800,-1
536,1,STEP,381308684700,381370051200,61366500,-1
537,1,STEP,381370190200,381431083900,60893700,-1
538,1,STEP,381431158500,381491842000,60683500,-1
539,1,STEP,381491924400,381553052800,61128400,-1
540,1,STEP,381553106000,381614477300,61371300,-1
541,1,STEP,381614536000,381676161700,61625700,-1
542,1,STEP,381676324100,381738198200,61874100,-1
543,1,STEP,381738253000,381799810300,61557300,-1
544,1,STEP,381799886100,381861201800,61315700,-1
545,1,STEP,381861261400,381922394800,61133400,-1
546,1,STEP,381922477800,381983853300,61375500,-1
547,1,STEP,381983908200,382045121300,61213100,-1
548,1,STEP,382045234700,382106706100,61471400,-1
549,1,STEP,382106779000,382167824600,61045600,-1
550,1,STEP,382167908100,382228927200,61019100,-1
551,1,STEP,382228997500,382290176800,61179300,-1
552,1,STEP,382290230600,382351457500,61226900,-1
553,1,STEP,382351528900,382412507700,60978800,-1
554,1,STEP,382412597300,382473485600,60888300,-1
555,1,STEP,382473576800,382534450700,60873900,-1
556,1,STEP,382534516000,382595415800,60899800,-1
557,1,STEP,382595469900,382656493300,61023400,-1
558,1,STEP,382656569700,382717811900,61242200,-1
559,1,STEP,382717871600,382779177000,61305400,-1
560,1,STEP,382779243600,382840802800,61559200,-1
561,1,STEP,382840862100,382902152800,61290700,-1
562,1,STEP,382902227800,382963701200,61473400,-1
563,1,STEP,382963759700,383025155300,61395600,-1
564,1,STEP,383025208200,383086837100,61628900,-1
565,1,STEP,383086888400,383148515300,61626900,-1
566,1,STEP,383148625700,383210112400,61486700,-1
567,1,STEP,383210165000,383271324200,61159200,-1
568,1,STEP,383271380600,383332682000,61301400,-1
569,1,STEP,383332739200,383393702700,60963500,-1
570,1,STEP,383393773000,383454995800,61222800,-1
571,1,STEP,383455047600,383516476700,61429100,-1
572,1,STEP,383516525900,383577933100,61407200,-1
573,1,STEP,383577989100,383639348100,61359000,-1
574,1,STEP,383639406200,383700617000,61210800,-1
575,1,STEP,383700672600,383761983300,61310700,-1
576,1,STEP,383762037500,383823215400,61177900,-1
577,1,STEP,383823266500,383884642300,61375800,-1
578,1,STEP,383884766400,383946781800,62015400,-1
579,1,STEP,383946911200,384008381700,61470500,-1
580,1,STEP,384008438600,384069497100,61058500,-1
581,1,STEP,384069562100,384130848200,61286100,-1
582,1,STEP,384130900900,384192275200,61374300,-1
583,1,STEP,384192325200,384253958000,61632800,-1
584,1,STEP,384254009900,384315511300,61501400,-1
585,1,STEP,384315573200,384376675300,61102100,-1
586,1,STEP,384376733200,384437801000,61067800,-1
587,1,STEP,384437896700,384499278200,61381500,-1
588,1,STEP,384499333900,384560664400,61330500,-1
589,1,STEP,384560716900,384621873400,61156500,-1
590,1,STEP,384621951200,384683408600,61457400,-1
591,1,STEP,384683464700,384744687800,61223100,-1
592,1,STEP,384744752000,384805881600,61129600,-1
593,1,STEP,384805954000,384867170100,61216100,-1
594,1,STEP,384867220800,384928358500,61137700,-1
595,1,STEP,384928411600,384989638400,61226800,-1
596,1,STEP,384989698700,385050920800,61222100,-1
597,1,STEP,385050978700,385112401500,61422800,-1
598,1,STEP,385112460900,385173610200,61149300,-1
599,1,STEP,385173674200,385234839800,61165600,-1
600,1,STEP,385234886800,385296051500,61164700,-1
601,1,STEP,385296105800,385357771600,61665800,-1
602,1,STEP,385357829100,385419286800,61457700,-1
603,1,STEP,385419340300,385480576400,61236100,-1
604,1,STEP,385480633400,385541950500,61317100,-1
605,1,STEP,385542044000,385603355100,61311100,-1
606,1,STEP,385603407900,385664699400,61291500,-1
607,1,STEP,385664761500,385726282000,61520500,-1
608,1,STEP,385726336800,385787789900,61453100,-1
609,1,STEP,385787845500,385849329400,61483900,-1
610,1,STEP,385849386500,385910570800,61184300,-1
611,1,STEP,385910628600,385971970300,61341700,-1
612,1,STEP,385972031100,386033604100,61573000,-1
613,1,STEP,386033702500,386095302100,61599600,-1
614,1,STEP,386095351200,386156785300,61434100,-1
615,1,STEP,386156860000,386217928800,61068800,-1
616,1,STEP,386217985000,386278763600,60778600,-1
617,1,STEP,386278839100,386339801200,60962100,-1
618,1,STEP,386339857700,386400849200,60991500,-1
619,1,STEP,386400910100,386462072800,61162700,-1
620,1,STEP,386462123900,386526751000,64627100,-1
621,1,STEP,386526826100,386588240700,61414600,-1
622,1,STEP,386588294400,386649703700,61409300,-1
623,1,STEP,386649781900,386711291100,61509200,-1
624,1,STEP,386711368100,386772967100,61599000,-1
625,1,STEP,386773025300,386835343600,62318300,-1
626,1,STEP,386835463500,386897870700,62407200,-1
627,1,STEP,386898001800,386959992200,61990400,-1
628,1,STEP,386960121400,387021233600,61112200,-1
629,1,STEP,387021315900,387082653800,61337900,-1
630,1,STEP,387082717700,387143640200,60922500,-1
631,1,STEP,387143696200,387204777100,61080900,-1
632,1,STEP,387204860000,387265841000,60981000,-1
633,1,STEP,387265892100,387327002600,61110500,-1
634,1,STEP,387327052100,387388146000,61093900,-1
635,1,STEP,387388198000,387449674900,61476900,-1
636,1,STEP,387449767300,387511020600,61253300,-1
637,1,STEP,387511087200,387572324900,61237700,-1
638,1,STEP,387572392400,387633786000,61393600,-1
639,1,STEP,387633857900,387696259400,62401500,-1
640,1,STEP,387696326900,387758945700,62618800,-1
641,1,STEP,387759051400,387821582200,62530800,-1
642,1,STEP,387821674300,387884134500,62460200,-1
643,1,STEP,387884226000,387946722800,62496800,-1
644,1,STEP,387946804500,388009201000,62396500,-1
645,1,STEP,388009330800,388071698500,62367700,-1
646,1,STEP,388071791200,388134124200,62333000,-1
647,1,STEP,388134229900,388196375800,62145900,-1
648,1,STEP,388196439400,388258523900,62084500,-1
649,1,STEP,388258829800,388321496100,62666300,-1
650,1,STEP,388321557100,388384430300,62873200,-1
651,1,STEP,388384495600,388447352200,62856600,-1
652,1,STEP,388447508200,388510388200,62880000,-1
653,1,STEP,388510445200,388572893000,62447800,-1
654,1,STEP,388572949700,388635302700,62353000,-1
655,1,STEP,388635402200,388698160700,62758500,-1
656,1,STEP,388698248500,388760648200,62399700,-1
657,1,STEP,388760703300,388823821300,63118000,-1
658,1,STEP,388823917500,388886542200,62624700,-1
659,1,STEP,388886598500,388949186300,62587800,-1
660,1,STEP,388949242800,389012125700,62882900,-1
661,1,STEP,389012182000,389074947000,62765000,-1
662,1,STEP,389075005600,389137343000,62337400,-1
663,1,STEP,389137402000,389199808300,62406300,-1
664,1,STEP,389199860900,389262427800,62566900,-1
665,1,STEP,389262489400,389324910400,62421000,-1
666,1,STEP,389324968300,389388158000,63189700,-1
667,1,STEP,389388254800,389450456800,62202000,-1
668,1,STEP,389450511500,389513269600,62758100,-1
669,1,STEP,389513343100,389575857300,62514200,-1
670,1,STEP,389575932200,389638304300,62372100,-1
671,1,STEP,389638372400,389700702500,62330100,-1
672,1,STEP,389700784000,389762958700,62174700,-1
673,1,STEP,389763030700,389825890500,62859800,-1
674,1,STEP,389825961200,389888360600,62399400,-1
675,1,STEP,389888411900,389951192200,62780300,-1
676,1,STEP,389951263100,390014010500,62747400,-1
677,1,STEP,390014082900,390076509700,62426800,-1
678,1,STEP,390076567900,390139324800,62756900,-1
679,1,STEP,390139396400,390202038100,62641700,-1
680,1,STEP,390202108400,390264615200,62506800,-1
681,1,STEP,390264682300,390327342000,62659700,-1
682,1,STEP,390327416500,390389783200,62366700,-1
683,1,STEP,390389887200,390452151600,62264400,-1
684,1,STEP,390452227800,390514770100,62542300,-1
685,1,STEP,390514832400,390577439600,62607200,-1
686,1,STEP,390577519600,390639948600,62429000,-1
687,1,STEP,390640022900,390702880700,62857800,-1
688,1,STEP,390702931300,390765948500,63017200,-1
689,1,STEP,390766176000,390828919600,62743600,-1
690,1,STEP,390828981300,390891577300,62596000,-1
691,1,STEP,390891632500,390954052800,62420300,-1
692,1,STEP,390954109600,391016784800,62675200,-1
693,1,STEP,391016849200,391079064300,62215100,-1
694,1,STEP,391079129600,391141551800,62422200,-1
695,1,STEP,391141608400,391204379000,62770600,-1
696,1,STEP,391204442700,391267129500,62686800,-1
697,1,STEP,391267189000,391329838000,62649000,-1
698,1,STEP,391329895000,391392622500,62727500,-1
699,1,STEP,391392681300,391455574900,62893600,-1
700,1,STEP,391455754500,391518098900,62344400,-1
701,1,STEP,391518164900,391580932300,62767400,-1
702,1,STEP,391580989800,391643589200,62599400,-1
703,1,STEP,391643643600,391706301200,62657600,-1
704,1,STEP,391706353400,391768786100,62432700,-1
705,1,STEP,391768845100,391831197600,62352500,-1
706,1,STEP,391831257700,391893693000,62435300,-1
707,1,STEP,391893744700,391956363400,62618700,-1
708,1,STEP,391956422700,392019540600,63117900,-1
709,1,STEP,392019662600,392082364400,62701800,-1
710,1,STEP,392082424700,392145313800,62889100,-1
711,1,STEP,392145813200,392208402900,62589700,-1
712,1,STEP,392208458200,392271139300,62681100,-1
713,1,STEP,392271215100,392334115900,62900800,-1
714,1,STEP,392334195400,392397132800,62937400,-1
715,1,STEP,392397203800,392459451600,62247800,-1
716,1,STEP,392459536100,392522347000,62810900,-1
717,1,STEP,392522428900,392584576600,62147700,-1
718,1,STEP,392584640100,392646864500,62224400,-1
719,1,STEP,392646932000,392709303300,62371300,-1
720,1,STEP,392709370900,392771717300,62346400,-1
721,1,STEP,392771808800,392834181400,62372600,-1
722,1,STEP,392834239400,392897227300,62987900,-1
723,1,STEP,392897321500,392959804400,62482900,-1
724,1,STEP,392959876800,393022392600,62515800,-1
725,1,STEP,393022453600,393085102300,62648700,-1
726,1,STEP,393085160000,393147382900,62222900,-1
727,1,STEP,393147441200,393209511600,62070400,-1
728,1,STEP,393209572600,393272182000,62609400,-1
729,1,STEP,393272242900,393334589200,62346300,-1
730,1,STEP,393334656200,393397354200,62698000,-1
731,1,STEP,393397414800,393459926000,62511200,-1
732,1,STEP,393460021100,393522800800,62779700,-1
733,1,STEP,393522925100,393586874900,63949800,-1
734,1,STEP,393586965600,393650390400,63424800,-1
735,1,STEP,393650471500,393712629900,62158400,-1
736,1,STEP,393712712500,393774836900,62124400,-1
737,1,STEP,393774915600,393837083700,62168100,-1
738,1,STEP,393837199900,393899542400,62342500,-1
739,1,STEP,393899622700,393962284200,62661500,-1
740,1,STEP,393962377500,394025513400,63135900,-1
741,1,STEP,394025581900,394087845800,62263900,-1
742,1,STEP,394087916900,394150155000,62238100,-1
743,1,STEP,394150237000,394212355700,62118700,-1
744,1,STEP,394212428300,394275080900,62652600,-1
745,1,STEP,394275144000,394337881800,62737800,-1
746,1,STEP,394337940600,394400402500,62461900,-1
747,1,STEP,394400452800,394462880400,62427600,-1
748,1,STEP,394462937500,394525444100,62506600,-1
749,1,STEP,394525490500,394588027900,62537400,-1
750,1,STEP,394588081300,394650873800,62792500,-1
751,1,STEP,394650945500,394713787500,62842000,-1
752,1,STEP,394713883700,394776585700,62702000,-1
753,1,STEP,394776644000,394839463000,62819000,-1
754,1,STEP,394839519500,394902108800,62589300,-1
755,1,STEP,394902169100,394964542600,62373500,-1
756,1,STEP,394964600800,395027016900,62416100,-1
757,1,STEP,395027071400,395089853700,62782300,-1
758,1,STEP,395089914800,395152613100,62698300,-1
759,1,STEP,395152665800,395215737900,63072100,-1
760,1,STEP,395215790100,395278537200,62747100,-1
761,1,STEP,395278586800,395341335800,62749000,-1
762,1,STEP,395341394300,395404133100,62738800,-1
763,1,STEP,395404188100,395466466100,62278000,-1
764,1,STEP,395466512600,395528925000,62412400,-1
765,1,STEP,395528977700,395591555900,62578200,-1
766,1,STEP,395591613800,395654209200,62595400,-1
767,1,STEP,395654267700,395716668100,62400400,-1
768,1,STEP,395716723800,395779348400,62624600,-1
769,1,STEP,395779410200,395842341500,62931300,-1
770,1,STEP,395842406900,395905094600,62687700,-1
771,1,STEP,395905158700,395967835000,62676300,-1
772,1,STEP,395967889200,396030294300,62405100,-1
773,1,STEP,396030363700,396092657000,62293300,-1
774,1,STEP,396092718500,396155265900,62547400,-1
775,1,STEP,396155330300,396217928500,62598200,-1
776,1,STEP,396217987500,396280616000,62628500,-1
777,1,STEP,396280685800,396343615600,62929800,-1
778,1,STEP,396343673900,396406472100,62798200,-1
779,1,STEP,396406521900,396469092300,62570400,-1
780,1,STEP,396469148700,396531879100,62730400,-1
781,1,STEP,396531932100,396594495100,62563000,-1
782,1,STEP,396594559300,396657264600,62705300,-1
783,1,STEP,396657328900,396719968200,62639300,-1
784,1,STEP,396720018900,396782569500,62550600,-1
785,1,STEP,396782618700,396845296800,62678100,-1
786,1,STEP,396845347500,396908298400,62950900,-1
787,1,STEP,396908353500,396971371200,63017700,-1
788,1,STEP,396971444400,397033750900,62306500,-1
789,1,STEP,397033815400,397096339400,62524000,-1
790,1,STEP,397096399100,397158913900,62514800,-1
791,1,STEP,397158972400,397221654800,62682400,-1
792,1,STEP,397221734200,397284079500,62345300,-1
793,1,STEP,397284139400,397346978200,62838800,-1
794,1,STEP,397347032400,397409782400,62750000,-1
795,1,STEP,397409833600,397472804400,62970800,-1
796,1,STEP,397472855800,397535751800,62896000,-1
797,1,STEP,397535803400,397598667600,62864200,-1
798,1,STEP,397598732400,397661611000,62878600,-1
799,1,STEP,397661674400,397724140100,62465700,-1
800,1,STEP,397724195900,397786726900,62531000,-1
801,1,STEP,397786776000,397849517200,62741200,-1
802,1,STEP,397849575600,397912160200,62584600,-1
803,1,STEP,397912220100,397974598900,62378800,-1
804,1,STEP,397974660700,398037419900,62759200,-1
805,1,STEP,398037475900,398100663400,63187500,-1
806,1,STEP,398100723500,398163069500,62346000,-1
807,1,STEP,398163137400,398225740200,62602800,-1
808,1,STEP,398225806600,398288288400,62481800,-1
809,1,STEP,398288343900,398350829300,62485400,-1
810,1,STEP,398350892100,398413346600,62454500,-1
811,1,STEP,398413416600,398475529100,62112500,-1
812,1,STEP,398475598800,398537996000,62397200,-1
813,1,STEP,398538054200,398600797200,62743000,-1
814,1,STEP,398600894300,398664210900,63316600,-1
815,1,STEP,398664283200,398726820500,62537300,-1
816,1,STEP,398726878300,398789717000,62838700,-1
817,1,STEP,398789787700,398851961500,62173800,-1
818,1,STEP,398852044800,398914194800,62150000,-1
819,1,STEP,398914272800,398977103000,62830200,-1
820,1,STEP,398977157100,399039989200,62832100,-1
821,1,STEP,399040052600,399102540800,62488200,-1
822,1,STEP,399102605400,399165651100,63045700,-1
823,1,STEP,399165710200,399228941600,63231400,-1
824,1,STEP,399229031400,399292009400,62978000,-1
825,1,STEP,399292132400,399354821100,62688700,-1
826,1,STEP,399354919000,399417635500,62716500,-1
827,1,STEP,399417701800,399479935600,62233800,-1
828,1,STEP,399480033600,399542842400,62808800,-1
829,1,STEP,399542913900,399605045200,62131300,-1
830,1,STEP,399605142400,399667568100,62425700,-1
831,1,STEP,399667635000,399730363000,62728000,-1
832,1,STEP,399730468800,399793714400,63245600,-1
833,1,STEP,399793801800,399856864200,63062400,-1
834,1,STEP,399856946400,399920627100,63680700,-1
835,1,STEP,399920744000,399982599500,61855500,-1
836,1,STEP,399982747500,400045928200,63180700,-1
837,1,STEP,400045985000,400108370100,62385100,-1
838,1,STEP,400108425600,400170689000,62263400,-1
839,1,STEP,400170751600,400233222000,62470400,-1
840,1,STEP,400233280200,400295956200,62676000,-1
841,1,STEP,400296028400,400358717000,62688600,-1
842,1,STEP,400358773600,400421367400,62593800,-1
843,1,STEP,400421433500,400484133600,62700100,-1
844,1,STEP,400484194400,400547046100,62851700,-1
845,1,STEP,400547220100,400609560100,62340000,-1
846,1,STEP,400609656100,400671986800,62330700,-1
847,1,STEP,400672050000,400734436900,62386900,-1
848,1,STEP,400734490600,400797056600,62566000,-1
849,1,STEP,400797113300,400860179800,63066500,-1
850,1,STEP,400860238600,400923293400,63054800,-1
851,1,STEP,400923352800,400986136700,62783900,-1
852,1,STEP,400986191800,401048617600,62425800,-1
853,1,STEP,401048680300,401122649000,73968700,-1
854,1,STEP,401122704400,401185207800,62503400,-1
855,1,STEP,401185267200,401247446300,62179100,-1
856,1,STEP,401247500100,401309840000,62339900,-1
857,1,STEP,401309894200,401371945200,62051000,-1
858,1,STEP,401372000800,401434356800,62356000,-1
859,1,STEP,401434418700,401496952200,62533500,-1
860,1,STEP,401497031400,401559773100,62741700,-1
861,1,STEP,401559833800,401624443000,64609200,-1
862,1,STEP,401624488600,401689463000,64974400,-1
863,1,STEP,401689519900,401754563200,65043300,-1
864,1,STEP,401754626400,401819233100,64606700,-1
865,1,STEP,401819292200,401883890500,64598300,-1
866,1,STEP,401883947800,401948846700,64898900,-1
867,1,STEP,401948917800,402014173900,65256100,-1
868,1,STEP,402014231100,402079222800,64991700,-1
869,1,STEP,402079278600,402144127600,64849000,-1
870,1,STEP,402144175100,402210708900,66533800,-1
871,1,STEP,402210776000,402278531900,67755900,-1
872,1,STEP,402278596500,402345019400,66422900,-1
873,1,STEP,402345075600,402409454400,64378800,-1
874,1,STEP,402409511400,402474061900,64550500,-1
875,1,STEP,402474118700,402539343400,65224700,-1
876,1,STEP,402539397400,402604283300,64885900,-1
877,1,STEP,402604338500,402668772000,64433500,-1
878,1,STEP,402668837400,402733631700,64794300,-1
879,1,STEP,402733687100,402798274300,64587200,-1
880,1,STEP,402798349100,402862749000,64399900,-1
881,1,STEP,402862819100,402927081700,64262600,-1
882,1,STEP,402927140200,402991337000,64196800,-1
883,1,STEP,402991391200,403054245200,62854000,-1
884,1,STEP,403054298900,403117554900,63256000,-1
885,1,STEP,403117613700,403180794800,63181100,-1
886,1,STEP,403180850300,403243994700,63144400,-1
887,1,STEP,403244050000,403307057500,63007500,-1
888,1,STEP,403307106200,403372717100,65610900,-1
889,1,STEP,403372784300,403437876400,65092100,-1
890,1,STEP,403437935200,403500108500,62173300,-1
891,1,STEP,403500164000,403562500400,62336400,-1
892,1,STEP,403562552800,403625447600,62894800,-1
893,1,STEP,403625500000,403688659300,63159300,-1
894,1,STEP,403688751100,403751551300,62800200,-1
895,1,STEP,403751611800,403814270500,62658700,-1
896,1,STEP,403814332600,403877235800,62903200,-1
897,1,STEP,403877286000,403940259300,62973300,-1
898,1,STEP,403940314100,404003188400,62874300,-1
899,1,STEP,404003241100,404066235800,62994700,-1
900,1,STEP,404066308800,404129200700,62891900,-1
901,1,STEP,404129264800,404192447400,63182600,-1
902,1,STEP,404192501000,404255572300,63071300,-1
903,1,STEP,404255628700,404318412900,62784200,-1
904,1,STEP,404318468700,404381226400,62757700,-1
905,1,STEP,404381301700,404443691600,62389900,-1
906,1,STEP,404443744000,404508463600,64719600,-1
907,1,STEP,404508545700,404592002700,83457000,-1
908,1,STEP,404593218100,404655139800,61921700,-1
909,1,STEP,404655201600,404717724600,62523000,-1
910,1,STEP,404717779000,404780380800,62601800,-1
911,1,STEP,404780441900,404843345000,62903100,-1
912,1,STEP,404843407000,404905877600,62470600,-1
913,1,STEP,404905935500,404968797500,62862000,-1
914,1,STEP,404968847600,405031785900,62938300,-1
915,1,STEP,405031839600,405096670400,64830800,-1
916,1,STEP,405096746200,405161953500,65207300,-1
917,1,STEP,405162023800,405227167200,65143400,-1
918,1,STEP,405227219800,405292016600,64796800,-1
919,1,STEP,405292108400,405357202000,65093600,-1
920,1,STEP,405357263600,405422593600,65330000,-1
921,1,STEP,405422665200,405488205500,65540300,-1
922,1,STEP,405488273000,405553311600,65038600,-1
923,1,STEP,405553414400,405626494700,73080300,-1
924,1,STEP,405626582300,405691685400,65103100,-1
925,1,STEP,405691755500,405758597600,66842100,-1
926,1,STEP,405758669300,405823574600,64905300,-1
927,1,STEP,405823637200,405888183300,64546100,-1
928,1,STEP,405888237700,405951611800,63374100,-1
929,1,STEP,405951679300,406014540100,62860800,-1
930,1,STEP,406014597700,406077771000,63173300,-1
931,1,STEP,406077822500,406140953300,63130800,-1
932,1,STEP,406141004200,406204237400,63233200,-1
933,1,STEP,406204296600,406267366400,63069800,-1
934,1,STEP,406267420500,406330762300,63341800,-1
935,1,STEP,406330815500,406394228600,63413100,-1
936,1,STEP,406394285300,406457491500,63206200,-1
937,1,STEP,406457554700,406520548300,62993600,-1
938,1,STEP,406520601600,406583917500,63315900,-1
939,1,STEP,406583990200,406647368200,63378000,-1
940,1,STEP,406647451800,406710926500,63474700,-1
941,1,STEP,406710988400,406774471200,63482800,-1
942,1,STEP,406774522700,406837641700,63119000,-1
943,1,STEP,406837714000,406902177800,64463800,-1
944,1,STEP,406902240900,406964707600,62466700,-1
945,1,STEP,406964766400,407027641100,62874700,-1
946,1,STEP,407027697400,407090656300,62958900,-1
947,1,STEP,407090721500,407153552600,62831100,-1
948,1,STEP,407153613700,407216323500,62709800,-1
949,1,STEP,407216375200,407279531800,63156600,-1
950,1,STEP,407279583500,407343062800,63479300,-1
951,1,STEP,407343118300,407406138300,63020000,-1
952,1,STEP,407406195000,407469256200,63061200,-1
953,1,STEP,407469307700,407532861500,63553800,-1
954,1,STEP,407532943400,407596031100,63087700,-1
955,1,STEP,407596107500,407659703300,63595800,-1
956,1,STEP,407659754800,407723047000,63292200,-1
957,1,STEP,407723100400,407786559400,63459000,-1
958,1,STEP,407786612700,407850018400,63405700,-1
959,1,STEP,407850081000,407913212200,63131200,-1
960,1,STEP,407913277200,407976449900,63172700,-1
961,1,STEP,407976511700,408040255100,63743400,-1
962,1,STEP,408040304300,408103071100,62766800,-1
963,1,STEP,408103126200,408166152300,63026100,-1
964,1,STEP,408166213500,408229110000,62896500,-1
965,1,STEP,408229168600,408291974900,62806300,-1
966,1,STEP,408292055200,408356953700,64898500,-1
967,1,STEP,408357025100,408422911100,65886000,-1
968,1,STEP,408422980200,408489052500,66072300,-1
969,1,STEP,408489103100,408554647700,65544600,-1
970,1,STEP,408554712700,408620185800,65473100,-1
971,1,STEP,408620254500,408685748900,65494400,-1
972,1,STEP,408685803100,408751618900,65815800,-1
973,1,STEP,408751683800,408817153400,65469600,-1
974,1,STEP,408817208000,408882938500,65730500,-1
975,1,STEP,408883016400,408948903500,65887100,-1
976,1,STEP,408948958900,409015090100,66131200,-1
977,1,STEP,409015148000,409080699200,65551200,-1
978,1,STEP,409080763500,409150181500,69418000,-1
979,1,STEP,409150250100,409212984500,62734400,-1
980,1,STEP,409213048100,409275907000,62858900,-1
981,1,STEP,409275969100,409338638500,62669400,-1
982,1,STEP,409338702200,409402227800,63525600,-1
983,1,STEP,409402302100,409465818000,63515900,-1
984,1,STEP,409465898400,409529003700,63105300,-1
985,1,STEP,409529073700,409592798600,63724900,-1
986,1,STEP,409592881100,409656516300,63635200,-1
987,1,STEP,409656667700,409720124100,63456400,-1
988,1,STEP,409720191000,409783276000,63085000,-1
989,1,STEP,409783335000,409846789700,63454700,-1
990,1,STEP,409846842300,409910164900,63322600,-1
991,1,STEP,409910240100,409973699200,63459100,-1
992,1,STEP,409979554000,410043130500,63576500,-1
993,1,STEP,410043184000,410106819100,63635100,-1
994,1,STEP,410106883600,410170203600,63320000,-1
995,1,STEP,410170257700,410233464900,63207200,-1
996,1,STEP,410233523400,410297048800,63525400,-1
997,1,STEP,410297125800,410360732000,63606200,-1
998,1,STEP,410360780900,410424611000,63830100,-1
999,1,STEP,410424676400,410488254100,63577700,-1
