Gen,Resource,Stamp,TimeStamp_Start,TimeStamp_End,Duration,Indiv_id
0,1,FirstEvaluation,433953851900,434668586600,714734700,-1
0,1,STEP,434668760700,434674557700,5797000,-1
1,1,STEP,434674649800,434679959200,5309400,-1
2,1,STEP,434680072100,434684812500,4740400,-1
3,1,STEP,434684911400,434689699500,4788100,-1
4,1,STEP,434689809900,434694507700,4697800,-1
5,1,STEP,434694610400,434699104200,4493800,-1
6,1,STEP,434699205000,434703859900,4654900,-1
7,1,STEP,434703964400,434708546800,4582400,-1
8,1,STEP,434708662100,434713503100,4841000,-1
9,1,STEP,434713611300,434717421800,3810500,-1
10,1,STEP,434717531600,434721801100,4269500,-1
11,1,STEP,434721899500,434727112300,5212800,-1
12,1,STEP,434727196000,434731192400,3996400,-1
13,1,STEP,434731274600,434734669200,3394600,-1
14,1,STEP,434734753600,434738947100,4193500,-1
15,1,STEP,434739039100,434742379900,3340800,-1
16,1,STEP,434742448000,434746399600,3951600,-1
17,1,STEP,434746477000,434749527500,3050500,-1
18,1,STEP,434749608300,434753425400,3817100,-1
19,1,STEP,434753510300,434757204200,3693900,-1
20,1,STEP,434757282500,434760591100,3308600,-1
21,1,STEP,434760671000,434764352900,3681900,-1
22,1,STEP,434764497200,434768584000,4086800,-1
23,1,STEP,434768669600,434772030700,3361100,-1
24,1,STEP,434772137900,434775415300,3277400,-1
25,1,STEP,434775532900,434779926300,4393400,-1
26,1,STEP,434780015900,434783787200,3771300,-1
27,1,STEP,434783870000,434787838700,3968700,-1
28,1,STEP,434787933700,434791139400,3205700,-1
29,1,STEP,434791236200,434794923100,3686900,-1
30,1,STEP,434795042900,434798859300,3816400,-1
31,1,STEP,434798945300,434802573000,3627700,-1
32,1,STEP,434802686500,434805472400,2785900,-1
33,1,STEP,434805568200,434809398900,3830700,-1
34,1,STEP,434809484600,434813160300,3675700,-1
35,1,STEP,434813250700,434817479000,4228300,-1
36,1,STEP,434817588600,434822042100,4453500,-1
37,1,STEP,434822141400,434825540300,3398900,-1
38,1,STEP,434825626800,434829154800,3528000,-1
39,1,STEP,434829255400,434833043300,3787900,-1
40,1,STEP,434833130700,434837542700,4412000,-1
41,1,STEP,434837640200,434841013000,3372800,-1
42,1,STEP,434841115500,434845234600,4119100,-1
43,1,STEP,434845337900,434848993600,3655700,-1
44,1,STEP,434849092500,434852988200,3895700,-1
45,1,STEP,434853091700,434857419100,4327400,-1
46,1,STEP,434857512400,434862399000,4886600,-1
47,1,STEP,434862508700,434866453800,3945100,-1
48,1,STEP,434866543200,434870812400,4269200,-1
49,1,STEP,434870922400,434874870500,3948100,-1
50,1,STEP,434874964800,434879085500,4120700,-1
51,1,STEP,434879187000,434884035200,4848200,-1
52,1,STEP,434884151100,434888400900,4249800,-1
53,1,STEP,434888501000,434893004700,4503700,-1
54,1,STEP,434893105000,434896753800,3648800,-1
55,1,STEP,434896861600,434901198900,4337300,-1
56,1,STEP,434901300600,434906075800,4775200,-1
57,1,STEP,434906171500,434909952800,3781300,-1
58,1,STEP,434910044600,434914384000,4339400,-1
59,1,STEP,434914488800,434918929700,4440900,-1
60,1,STEP,434919038300,434923080300,4042000,-1
61,1,STEP,434923241800,434926906600,3664800,-1
62,1,STEP,434927000100,434931040100,4040000,-1
63,1,STEP,434931199700,434934827700,3628000,-1
64,1,STEP,434934950100,434938979300,4029200,-1
65,1,STEP,434939075900,434942309700,3233800,-1
66,1,STEP,434942398800,434946131800,3733000,-1
67,1,STEP,434946229100,434949969200,3740100,-1
68,1,STEP,434950058600,434954028200,3969600,-1
69,1,STEP,434954129900,434958774500,4644600,-1
70,1,STEP,434958870900,434962356500,3485600,-1
71,1,STEP,434962446100,434966955700,4509600,-1
72,1,STEP,434967055100,434971028100,3973000,-1
73,1,STEP,434971114000,434974415500,3301500,-1
74,1,STEP,434974499400,434977266800,2767400,-1
75,1,STEP,434977348400,434981047100,3698700,-1
76,1,STEP,434981154500,434984718600,3564100,-1
77,1,STEP,434984809000,434988388500,3579500,-1
78,1,STEP,434988487500,434991797400,3309900,-1
79,1,STEP,434991885900,434995128700,3242800,-1
80,1,STEP,434995219700,434999152700,3933000,-1
81,1,STEP,434999244800,435003318900,4074100,-1
82,1,STEP,435003415100,435007353400,3938300,-1
83,1,STEP,435007446800,435011558900,4112100,-1
84,1,STEP,435011652200,435016376800,4724600,-1
85,1,STEP,435016496800,435020142200,3645400,-1
86,1,STEP,435020243300,435024588500,4345200,-1
87,1,STEP,435024715900,435029309900,4594000,-1
88,1,STEP,435029417300,435033255000,3837700,-1
89,1,STEP,435033347600,435037501700,4154100,-1
90,1,STEP,435037593800,435041296100,3702300,-1
91,1,STEP,435041387700,435045834100,4446400,-1
92,1,STEP,435045933500,435049627900,3694400,-1
93,1,STEP,435049726200,435053738700,4012500,-1
94,1,STEP,435053815900,435057628700,3812800,-1
95,1,STEP,435057728000,435061169000,3441000,-1
96,1,STEP,435061248700,435064077600,2828900,-1
97,1,STEP,435064160700,435067808100,3647400,-1
98,1,STEP,435067907000,435071237600,3330600,-1
99,1,STEP,435071320000,435074983700,3663700,-1
100,1,STEP,435075086800,435079151100,4064300,-1
101,1,STEP,435079248400,435082491800,3243400,-1
102,1,STEP,435082577400,435086548800,3971400,-1
103,1,STEP,435086639100,435090946500,4307400,-1
104,1,STEP,435091084100,435093893500,2809400,-1
105,1,STEP,435093971700,435096683500,2711800,-1
106,1,STEP,435096778500,435100454600,3676100,-1
107,1,STEP,435100544900,435104714300,4169400,-1
108,1,STEP,435104803000,435108528800,3725800,-1
109,1,STEP,435108609400,435111400500,2791100,-1
110,1,STEP,435111487400,435115384900,3897500,-1
111,1,STEP,435115493000,435118931900,3438900,-1
112,1,STEP,435119052300,435122957500,3905200,-1
113,1,STEP,435123052300,435126004700,2952400,-1
114,1,STEP,435126108500,435129942400,3833900,-1
115,1,STEP,435130038400,435133794900,3756500,-1
116,1,STEP,435133906700,435137446500,3539800,-1
117,1,STEP,435137532400,435141624800,4092400,-1
118,1,STEP,435141715100,435145666500,3951400,-1
119,1,STEP,435145759600,435149624600,3865000,-1
120,1,STEP,435149716100,435153238200,3522100,-1
121,1,STEP,435153316000,435156170000,2854000,-1
122,1,STEP,435156260000,435159403200,3143200,-1
123,1,STEP,435159482400,435162680600,3198200,-1
124,1,STEP,435162763900,435166472300,3708400,-1
125,1,STEP,435166556500,435169761600,3205100,-1
126,1,STEP,435169858600,435173062200,3203600,-1
127,1,STEP,435173224800,435177172200,3947400,-1
128,1,STEP,435177279500,435180283100,3003600,-1
129,1,STEP,435180372100,435184316200,3944100,-1
130,1,STEP,435184415500,435187811200,3395700,-1
131,1,STEP,435187896200,435191947200,4051000,-1
132,1,STEP,435192069200,435195316700,3247500,-1
133,1,STEP,435195409400,435199930200,4520800,-1
134,1,STEP,435200044500,435204371300,4326800,-1
135,1,STEP,435204606600,435208341300,3734700,-1
136,1,STEP,435208436600,435212654000,4217400,-1
137,1,STEP,435212760000,435217557900,4797900,-1
138,1,STEP,435217769000,435221893800,4124800,-1
139,1,STEP,435222000300,435225942300,3942000,-1
140,1,STEP,435226043700,435230942800,4899100,-1
141,1,STEP,435231062800,435234874000,3811200,-1
142,1,STEP,435234980400,435238070300,3089900,-1
143,1,STEP,435238225200,435241996100,3770900,-1
144,1,STEP,435242109900,435245897600,3787700,-1
145,1,STEP,435246082300,435251323300,5241000,-1
146,1,STEP,435251427800,435254979000,3551200,-1
147,1,STEP,435255086300,435259098400,4012100,-1
148,1,STEP,435259260600,435263337700,4077100,-1
149,1,STEP,435263454300,435267355200,3900900,-1
150,1,STEP,435267476300,435271217900,3741600,-1
151,1,STEP,435271354900,435275389800,4034900,-1
152,1,STEP,435275534400,435279282200,3747800,-1
153,1,STEP,435279394700,435283067500,3672800,-1
154,1,STEP,435283188500,435287265800,4077300,-1
155,1,STEP,435287407500,435290952800,3545300,-1
156,1,STEP,435291041700,435295620000,4578300,-1
157,1,STEP,435295759300,435300123000,4363700,-1
158,1,STEP,435300245200,435304350000,4104800,-1
159,1,STEP,435304481900,435309349300,4867400,-1
160,1,STEP,435309552700,435313511000,3958300,-1
161,1,STEP,435313679400,435317894400,4215000,-1
162,1,STEP,435318023600,435322136400,4112800,-1
163,1,STEP,435322383000,435326438700,4055700,-1
164,1,STEP,435326550300,435330435400,3885100,-1
165,1,STEP,435330573500,435334452100,3878600,-1
166,1,STEP,435334575900,435338867100,4291200,-1
167,1,STEP,435338984900,435343443700,4458800,-1
168,1,STEP,435343572900,435347451500,3878600,-1
169,1,STEP,435347579900,435351291800,3711900,-1
170,1,STEP,435351392100,435354940200,3548100,-1
171,1,STEP,435355089300,435359225600,4136300,-1
172,1,STEP,435359352600,435364172700,4820100,-1
173,1,STEP,435364286600,435367581500,3294900,-1
174,1,STEP,435367690400,435371572000,3881600,-1
175,1,STEP,435371821500,435376849000,5027500,-1
176,1,STEP,435377040700,435381181400,4140700,-1
177,1,STEP,435381300300,435385973400,4673100,-1
178,1,STEP,435386130400,435390248200,4117800,-1
179,1,STEP,435390403700,435394732300,4328600,-1
180,1,STEP,435394898900,435399290100,4391200,-1
181,1,STEP,435399409800,435403412300,4002500,-1
182,1,STEP,435403566800,435408371800,4805000,-1
183,1,STEP,435408502300,435412940600,4438300,-1
184,1,STEP,435413075100,435417990400,4915300,-1
185,1,STEP,435418164300,435423497900,5333600,-1
186,1,STEP,435423628200,435428579800,4951600,-1
187,1,STEP,435428729800,435433729200,4999400,-1
188,1,STEP,435433886200,435438076600,4190400,-1
189,1,STEP,435438274700,435442868400,4593700,-1
190,1,STEP,435443023600,435447717200,4693600,-1
191,1,STEP,435447853100,435452198200,4345100,-1
192,1,STEP,435452311000,435456245200,3934200,-1
193,1,STEP,435456364200,435460877200,4513000,-1
194,1,STEP,435461095700,435465023900,3928200,-1
195,1,STEP,435465129300,435469743000,4613700,-1
196,1,STEP,435469896500,435472564000,2667500,-1
197,1,STEP,435472647600,435476302100,3654500,-1
198,1,STEP,435476404100,435479445300,3041200,-1
199,1,STEP,435479539400,435483846900,4307500,-1
200,1,STEP,435483970000,435487689400,3719400,-1
201,1,STEP,435487856500,435492003900,4147400,-1
202,1,STEP,435492102400,435496538900,4436500,-1
203,1,STEP,435496659000,435500517600,3858600,-1
204,1,STEP,435500677200,435504754200,4077000,-1
205,1,STEP,435504886200,435508878100,3991900,-1
206,1,STEP,435509044500,435513576100,4531600,-1
207,1,STEP,435513706000,435518304900,4598900,-1
208,1,STEP,435518433100,435522369600,3936500,-1
209,1,STEP,435522500200,435527106200,4606000,-1
210,1,STEP,435527226300,435531488600,4262300,-1
211,1,STEP,435531591400,435536028500,4437100,-1
212,1,STEP,435536192700,435539810000,3617300,-1
213,1,STEP,435539944400,435543997600,4053200,-1
214,1,STEP,435544145700,435549698600,5552900,-1
215,1,STEP,435549912500,435554820400,4907900,-1
216,1,STEP,435554937900,435559225900,4288000,-1
217,1,STEP,435559347300,435563704900,4357600,-1
218,1,STEP,435563883800,435568292000,4408200,-1
219,1,STEP,435568422200,435573286800,4864600,-1
220,1,STEP,435573427900,435577289100,3861200,-1
221,1,STEP,435577463500,435580907300,3443800,-1
222,1,STEP,435581037500,435585279900,4242400,-1
223,1,STEP,435585482000,435589537600,4055600,-1
224,1,STEP,435589645300,435593892100,4246800,-1
225,1,STEP,435594022900,435598593400,4570500,-1
226,1,STEP,435598854600,435602725400,3870800,-1
227,1,STEP,435602829200,435606859200,4030000,-1
228,1,STEP,435607055600,435612437100,5381500,-1
229,1,STEP,435612654800,435618085800,5431000,-1
230,1,STEP,435618287800,435623139800,4852000,-1
231,1,STEP,435623250300,435626922900,3672600,-1
232,1,STEP,435627033000,435631215400,4182400,-1
233,1,STEP,435631317500,435635697600,4380100,-1
234,1,STEP,435635806400,435640004800,4198400,-1
235,1,STEP,435640210300,435644035400,3825100,-1
236,1,STEP,435644130900,435647799000,3668100,-1
237,1,STEP,435647907300,435651640300,3733000,-1
238,1,STEP,435651746000,435655848300,4102300,-1
239,1,STEP,435655954200,435659529800,3575600,-1
240,1,STEP,435659631000,435663717300,4086300,-1
241,1,STEP,435663817700,435668524200,4706500,-1
242,1,STEP,435668662200,435672407800,3745600,-1
243,1,STEP,435672522500,435677507400,4984900,-1
244,1,STEP,435677750800,435682535100,4784300,-1
245,1,STEP,435682672800,435687121600,4448800,-1
246,1,STEP,435687320300,435693068500,5748200,-1
247,1,STEP,435693271000,435699708000,6437000,-1
248,1,STEP,435699981000,435706986000,7005000,-1
249,1,STEP,435707177700,435712064200,4886500,-1
250,1,STEP,435712227300,435717224100,4996800,-1
251,1,STEP,435717376900,435722552400,5175500,-1
252,1,STEP,435722750800,435727345600,4594800,-1
253,1,STEP,435727483900,435732280300,4796400,-1
254,1,STEP,435732409900,435737881400,5471500,-1
255,1,STEP,435738014600,435742367700,4353100,-1
256,1,STEP,435742576600,435747291700,4715100,-1
257,1,STEP,435747455100,435752567500,5112400,-1
258,1,STEP,435752726600,435757436800,4710200,-1
259,1,STEP,435757680100,435762524900,4844800,-1
260,1,STEP,435762655500,435766955300,4299800,-1
261,1,STEP,435767066100,435771056300,3990200,-1
262,1,STEP,435771199400,435776079900,4880500,-1
263,1,STEP,435776202900,435780772400,4569500,-1
264,1,STEP,435781037400,435785844600,4807200,-1
265,1,STEP,435785978200,435790370500,4392300,-1
266,1,STEP,435790525100,435795478600,4953500,-1
267,1,STEP,435795609200,435800073700,4464500,-1
268,1,STEP,435800198900,435804343100,4144200,-1
269,1,STEP,435804450900,435807865600,3414700,-1
270,1,STEP,435807965100,435812380100,4415000,-1
271,1,STEP,435812508400,435816864700,4356300,-1
272,1,STEP,435816981800,435820473500,3491700,-1
273,1,STEP,435820652000,435824855200,4203200,-1
274,1,STEP,435824977800,435829205300,4227500,-1
275,1,STEP,435829325100,435832546700,3221600,-1
276,1,STEP,435832645500,435836274700,3629200,-1
277,1,STEP,435836415900,435839886800,3470900,-1
278,1,STEP,435839977800,435843800600,3822800,-1
279,1,STEP,435843950700,435847532400,3581700,-1
280,1,STEP,435847644500,435850779300,3134800,-1
281,1,STEP,435850891600,435854997600,4106000,-1
282,1,STEP,435855153300,435859498400,4345100,-1
283,1,STEP,435859595800,435863699000,4103200,-1
284,1,STEP,435863845300,435868012800,4167500,-1
285,1,STEP,435868112300,435872811000,4698700,-1
286,1,STEP,435872919100,435876346200,3427100,-1
287,1,STEP,435876462000,435879946500,3484500,-1
288,1,STEP,435880039200,435883858300,3819100,-1
289,1,STEP,435884008000,435887909100,3901100,-1
290,1,STEP,435888020800,435891542600,3521800,-1
291,1,STEP,435891682000,435895291900,3609900,-1
292,1,STEP,435895405600,435899327000,3921400,-1
293,1,STEP,435899434700,435903529600,4094900,-1
294,1,STEP,435903850100,435908254200,4404100,-1
295,1,STEP,435908376100,435912408500,4032400,-1
296,1,STEP,435912565100,435916334000,3768900,-1
297,1,STEP,435916440800,435920425000,3984200,-1
298,1,STEP,435920530300,435924496400,3966100,-1
299,1,STEP,435924711600,435928515700,3804100,-1
300,1,STEP,435928633100,435931959400,3326300,-1
301,1,STEP,435932069800,435936580900,4511100,-1
302,1,STEP,435936752700,435941066800,4314100,-1
303,1,STEP,435941174500,435945257100,4082600,-1
304,1,STEP,435945539000,435950475000,4936000,-1
305,1,STEP,435950580300,435954938900,4358600,-1
306,1,STEP,435955127400,435959261300,4133900,-1
307,1,STEP,435959392500,435964163100,4770600,-1
308,1,STEP,435964407900,435969067400,4659500,-1
309,1,STEP,435969187500,435973267800,4080300,-1
310,1,STEP,435973642000,435978409600,4767600,-1
311,1,STEP,435978716300,435983225800,4509500,-1
312,1,STEP,435983335500,435987980200,4644700,-1
313,1,STEP,435988105100,435992275400,4170300,-1
314,1,STEP,435992379600,435996788300,4408700,-1
315,1,STEP,435996921000,436001281100,4360100,-1
316,1,STEP,436001415500,436005468800,4053300,-1
317,1,STEP,436005593200,436009382900,3789700,-1
318,1,STEP,436009513600,436013398400,3884800,-1
319,1,STEP,436013541900,436017822100,4280200,-1
320,1,STEP,436018023200,436022176700,4153500,-1
321,1,STEP,436022339900,436027486600,5146700,-1
322,1,STEP,436027622000,436032324800,4702800,-1
323,1,STEP,436032478100,436037315600,4837500,-1
324,1,STEP,436037504200,436043216900,5712700,-1
325,1,STEP,436043378000,436048096000,4718000,-1
326,1,STEP,436048297000,436053335300,5038300,-1
327,1,STEP,436053514000,436059285200,5771200,-1
328,1,STEP,436059586400,436064281100,4694700,-1
329,1,STEP,436064407400,436068825000,4417600,-1
330,1,STEP,436068983800,436075838500,6854700,-1
331,1,STEP,436076003400,436081398100,5394700,-1
332,1,STEP,436081548600,436086417300,4868700,-1
333,1,STEP,436086550300,436090716600,4166300,-1
334,1,STEP,436090919000,436095225900,4306900,-1
335,1,STEP,436095350500,436100181100,4830600,-1
336,1,STEP,436100326900,436104582900,4256000,-1
337,1,STEP,436104707800,436111287000,6579200,-1
338,1,STEP,436111516000,436117754200,6238200,-1
339,1,STEP,436117890700,436122885900,4995200,-1
340,1,STEP,436123009800,436126910300,3900500,-1
341,1,STEP,436127062300,436131206800,4144500,-1
342,1,STEP,436131344100,436135596400,4252300,-1
343,1,STEP,436135736700,436140561200,4824500,-1
344,1,STEP,436140739500,436146067500,5328000,-1
345,1,STEP,436146212500,436151588100,5375600,-1
346,1,STEP,436151818500,436156196600,4378100,-1
347,1,STEP,436156324100,436161025500,4701400,-1
348,1,STEP,436161170800,436165965900,4795100,-1
349,1,STEP,436166106900,436171765200,5658300,-1
350,1,STEP,436171990900,436177037400,5046500,-1
351,1,STEP,436177180300,436182347400,5167100,-1
352,1,STEP,436182478400,436187322500,4844100,-1
353,1,STEP,436187443500,436192227400,4783900,-1
354,1,STEP,436192350900,436197598800,5247900,-1
355,1,STEP,436197833300,436202892100,5058800,-1
356,1,STEP,436203026300,436207468300,4442000,-1
357,1,STEP,436207595300,436212800700,5205400,-1
358,1,STEP,436212970400,436217442400,4472000,-1
359,1,STEP,436217610600,436222629000,5018400,-1
360,1,STEP,436222814400,436226650700,3836300,-1
361,1,STEP,436226771500,436232309400,5537900,-1
362,1,STEP,436232537900,436236589200,4051300,-1
363,1,STEP,436236793500,436241848500,5055000,-1
364,1,STEP,436241999600,436247095600,5096000,-1
365,1,STEP,436247275000,436251323100,4048100,-1
366,1,STEP,436251514000,436256559200,5045200,-1
367,1,STEP,436256699500,436261578900,4879400,-1
368,1,STEP,436261749600,436267661000,5911400,-1
369,1,STEP,436267856500,436273646500,5790000,-1
370,1,STEP,436273777400,436278990300,5212900,-1
371,1,STEP,436279242200,436283199600,3957400,-1
372,1,STEP,436283342200,436287984800,4642600,-1
373,1,STEP,436288109700,436293619000,5509300,-1
374,1,STEP,436293815000,436297478400,3663400,-1
375,1,STEP,436297612100,436303022000,5409900,-1
376,1,STEP,436303277700,436308844800,5567100,-1
377,1,STEP,436309275300,436314753900,5478600,-1
378,1,STEP,436314960500,436319287000,4326500,-1
379,1,STEP,436319397800,436324411900,5014100,-1
380,1,STEP,436324573100,436329043500,4470400,-1
381,1,STEP,436329208800,436333199400,3990600,-1
382,1,STEP,436333351700,436338481200,5129500,-1
383,1,STEP,436338613700,436342937000,4323300,-1
384,1,STEP,436343058200,436348012300,4954100,-1
385,1,STEP,436348230700,436352446700,4216000,-1
386,1,STEP,436352598300,436357540700,4942400,-1
387,1,STEP,436357662100,436361852900,4190800,-1
388,1,STEP,436362033900,436367425000,5391100,-1
389,1,STEP,436367591900,436371698200,4106300,-1
390,1,STEP,436371853900,436375970000,4116100,-1
391,1,STEP,436376159800,436380305400,4145600,-1
392,1,STEP,436380455600,436384512500,4056900,-1
393,1,STEP,436384666600,436388984900,4318300,-1
394,1,STEP,436389104900,436393671500,4566600,-1
395,1,STEP,436393817600,436398540000,4722400,-1
396,1,STEP,436398667900,436402868200,4200300,-1
397,1,STEP,436402997500,436408813000,5815500,-1
398,1,STEP,436408938300,436415433400,6495100,-1
399,1,STEP,436415871700,436421658100,5786400,-1
400,1,STEP,436421780800,436427255200,5474400,-1
401,1,STEP,436427433600,436431935500,4501900,-1
402,1,STEP,436432091500,436437362400,5270900,-1
403,1,STEP,436437495600,436442338700,4843100,-1
404,1,STEP,436442479200,436446810200,4331000,-1
405,1,STEP,436446955800,436451490200,4534400,-1
406,1,STEP,436451618000,436456058900,4440900,-1
407,1,STEP,436456192700,436460540100,4347400,-1
408,1,STEP,436460709600,436464867200,4157600,-1
409,1,STEP,436465000800,436469793100,4792300,-1
410,1,STEP,436470007400,436473861800,3854400,-1
411,1,STEP,436474053400,436478416900,4363500,-1
412,1,STEP,436478632500,436483322300,4689800,-1
413,1,STEP,436483443000,436487994900,4551900,-1
414,1,STEP,436488145300,436492411400,4266100,-1
415,1,STEP,436492539000,436497089500,4550500,-1
416,1,STEP,436497260500,436501658300,4397800,-1
417,1,STEP,436501808200,436506804800,4996600,-1
418,1,STEP,436507003700,436511511800,4508100,-1
419,1,STEP,436511642000,436516607800,4965800,-1
420,1,STEP,436516749400,436520246300,3496900,-1
421,1,STEP,436520380300,436525583300,5203000,-1
422,1,STEP,436525798300,436530422500,4624200,-1
423,1,STEP,436530619000,436534118200,3499200,-1
424,1,STEP,436534243200,436539264100,5020900,-1
425,1,STEP,436539407500,436544810500,5403000,-1
426,1,STEP,436544973300,436549447700,4474400,-1
427,1,STEP,436549590800,436554589100,4998300,-1
428,1,STEP,436554706200,436559072500,4366300,-1
429,1,STEP,436559244400,436564385900,5141500,-1
430,1,STEP,436564600300,436569956700,5356400,-1
431,1,STEP,436570240100,436574120300,3880200,-1
432,1,STEP,436574251000,436577897600,3646600,-1
433,1,STEP,436578127300,436582739000,4611700,-1
434,1,STEP,436582857000,436587031000,4174000,-1
435,1,STEP,436587135900,436592093000,4957100,-1
436,1,STEP,436592264000,436596456300,4192300,-1
437,1,STEP,436596571600,436601447600,4876000,-1
438,1,STEP,436601630500,436606636900,5006400,-1
439,1,STEP,436606792700,436610943600,4150900,-1
440,1,STEP,436611054600,436615434800,4380200,-1
441,1,STEP,436615598600,436619853800,4255200,-1
442,1,STEP,436619991000,436624165000,4174000,-1
443,1,STEP,436624372400,436629133100,4760700,-1
444,1,STEP,436629334900,436633527500,4192600,-1
445,1,STEP,436633811900,436639029300,5217400,-1
446,1,STEP,436639148000,436643124700,3976700,-1
447,1,STEP,436643375400,436649712100,6336700,-1
448,1,STEP,436649958200,436656161000,6202800,-1
449,1,STEP,436656329100,436661333000,5003900,-1
450,1,STEP,436661477800,436665913200,4435400,-1
451,1,STEP,436666050100,436671145200,5095100,-1
452,1,STEP,436671293300,436675409900,4116600,-1
453,1,STEP,436675566700,436680172800,4606100,-1
454,1,STEP,436680371600,436683880800,3509200,-1
455,1,STEP,436684031500,436687179300,3147800,-1
456,1,STEP,436687361700,436693701500,6339800,-1
457,1,STEP,436693812700,436699217000,5404300,-1
458,1,STEP,436699370900,436704275600,4904700,-1
459,1,STEP,436704566300,436708491500,3925200,-1
460,1,STEP,436708664800,436713402500,4737700,-1
461,1,STEP,436713548200,436717981000,4432800,-1
462,1,STEP,436718313700,436723866300,5552600,-1
463,1,STEP,436724065500,436728633600,4568100,-1
464,1,STEP,436728874700,436733200700,4326000,-1
465,1,STEP,436733388500,436738670500,5282000,-1
466,1,STEP,436738860200,436742934500,4074300,-1
467,1,STEP,436743068100,436747649000,4580900,-1
468,1,STEP,436747802700,436752235500,4432800,-1
469,1,STEP,436752402100,436756533100,4131000,-1
470,1,STEP,436756651100,436761450800,4799700,-1
471,1,STEP,436761968000,436770100600,8132600,-1
472,1,STEP,436770233600,436775396400,5162800,-1
473,1,STEP,436775581200,436780136700,4555500,-1
474,1,STEP,436780318700,436785583300,5264600,-1
475,1,STEP,436785822200,436791233400,5411200,-1
476,1,STEP,436791392500,436796098500,4706000,-1
477,1,STEP,436796374000,436803354400,6980400,-1
478,1,STEP,436803571000,436810114400,6543400,-1
479,1,STEP,436810366500,436816268300,5901800,-1
480,1,STEP,436816440200,436820879600,4439400,-1
481,1,STEP,436821083500,436826390600,5307100,-1
482,1,STEP,436826552200,436832308500,5756300,-1
483,1,STEP,436832534000,436838717700,6183700,-1
484,1,STEP,436839065000,436844184000,5119000,-1
485,1,STEP,436844322600,436849195600,4873000,-1
486,1,STEP,436849416200,436856210000,6793800,-1
487,1,STEP,436856510500,436863588000,7077500,-1
488,1,STEP,436863783800,436868509000,4725200,-1
489,1,STEP,436868681400,436873948900,5267500,-1
490,1,STEP,436874100100,436880010300,5910200,-1
491,1,STEP,436880442400,436885258300,4815900,-1
492,1,STEP,436885452400,436890682300,5229900,-1
493,1,STEP,436890862400,436896781700,5919300,-1
494,1,STEP,436897000600,436901767800,4767200,-1
495,1,STEP,436901917900,436906746000,4828100,-1
496,1,STEP,436906896700,436911407100,4510400,-1
497,1,STEP,436911556100,436915448200,3892100,-1
498,1,STEP,436915607300,436920378500,4771200,-1
499,1,STEP,436920523300,436924545100,4021800,-1
500,1,STEP,436924796500,436929483900,4687400,-1
501,1,STEP,436929656100,436934516500,4860400,-1
502,1,STEP,436934654500,436939936400,5281900,-1
503,1,STEP,436940100500,436946570900,6470400,-1
504,1,STEP,436946707600,436950456500,3748900,-1
505,1,STEP,436950572200,436954801900,4229700,-1
506,1,STEP,436954923300,436959655100,4731800,-1
507,1,STEP,436959849400,436965034900,5185500,-1
508,1,STEP,436965188000,436969521100,4333100,-1
509,1,STEP,436969705200,436974471600,4766400,-1
510,1,STEP,436974618100,436980004900,5386800,-1
511,1,STEP,436980236600,436984717300,4480700,-1
512,1,STEP,436984905800,436990364300,5458500,-1
513,1,STEP,436990534100,436996223400,5689300,-1
514,1,STEP,436996360400,437001051400,4691000,-1
515,1,STEP,437001292200,437007688400,6396200,-1
516,1,STEP,437007869200,437012344700,4475500,-1
517,1,STEP,437012472200,437017023800,4551600,-1
518,1,STEP,437017249700,437022248300,4998600,-1
519,1,STEP,437022485800,437027847100,5361300,-1
520,1,STEP,437028143100,437033496500,5353400,-1
521,1,STEP,437033657600,437038546100,4888500,-1
522,1,STEP,437038658700,437043249600,4590900,-1
523,1,STEP,437043389800,437047623500,4233700,-1
524,1,STEP,437047744600,437053501300,5756700,-1
525,1,STEP,437053711600,437059900200,6188600,-1
526,1,STEP,437060122200,437066600000,6477800,-1
527,1,STEP,437066747800,437071404400,4656600,-1
528,1,STEP,437071523700,437075695600,4171900,-1
529,1,STEP,437075820700,437080113700,4293000,-1
530,1,STEP,437080237700,437085341100,5103400,-1
531,1,STEP,437085522300,437089677200,4154900,-1
532,1,STEP,437089790000,437094995200,5205200,-1
533,1,STEP,437095235100,437101370400,6135300,-1
534,1,STEP,437101585900,437108437400,6851500,-1
535,1,STEP,437108585900,437113335600,4749700,-1
536,1,STEP,437113505300,437118540500,5035200,-1
537,1,STEP,437118761400,437124227500,5466100,-1
538,1,STEP,437124446300,437130002400,5556100,-1
539,1,STEP,437130209100,437135808000,5598900,-1
540,1,STEP,437136008600,437144111200,8102600,-1
541,1,STEP,437144266000,437149129300,4863300,-1
542,1,STEP,437149261900,437153812800,4550900,-1
543,1,STEP,437153979200,437157836900,3857700,-1
544,1,STEP,437158017600,437162709100,4691500,-1
545,1,STEP,437162862400,437167654000,4791600,-1
546,1,STEP,437167814500,437172337300,4522800,-1
547,1,STEP,437172518900,437179172200,6653300,-1
548,1,STEP,437179363200,437186049400,6686200,-1
549,1,STEP,437186333500,437192698500,6365000,-1
550,1,STEP,437192935000,437199328600,6393600,-1
551,1,STEP,437199533600,437204462700,4929100,-1
552,1,STEP,437204678900,437209408400,4729500,-1
553,1,STEP,437209537200,437213710800,4173600,-1
554,1,STEP,437213829200,437218825000,4995800,-1
555,1,STEP,437219027200,437223405100,4377900,-1
556,1,STEP,437223575200,437227779000,4203800,-1
557,1,STEP,437228044000,437233165300,5121300,-1
558,1,STEP,437233322400,437238438800,5116400,-1
559,1,STEP,437238583200,437242893400,4310200,-1
560,1,STEP,437243122700,437247424400,4301700,-1
561,1,STEP,437247557300,437252398300,4841000,-1
562,1,STEP,437252585200,437256547600,3962400,-1
563,1,STEP,437256690800,437260494100,3803300,-1
564,1,STEP,437260621700,437265453700,4832000,-1
565,1,STEP,437265680500,437270719500,5039000,-1
566,1,STEP,437270846200,437276290300,5444100,-1
567,1,STEP,437276434600,437281563900,5129300,-1
568,1,STEP,437281694200,437285885200,4191000,-1
569,1,STEP,437286041200,437290399300,4358100,-1
570,1,STEP,437290550700,437295059100,4508400,-1
571,1,STEP,437295211100,437299838400,4627300,-1
572,1,STEP,437299995700,437304393000,4397300,-1
573,1,STEP,437304524800,437308926100,4401300,-1
574,1,STEP,437309047200,437313055600,4008400,-1
575,1,STEP,437313266700,437318823900,5557200,-1
576,1,STEP,437318961000,437324192100,5231100,-1
577,1,STEP,437324332600,437328524500,4191900,-1
578,1,STEP,437328672100,437334607700,5935600,-1
579,1,STEP,437334792200,437340540000,5747800,-1
580,1,STEP,437340835600,437347934800,7099200,-1
581,1,STEP,437348125300,437354011300,5886000,-1
582,1,STEP,437354185900,437359078300,4892400,-1
583,1,STEP,437359196800,437363473000,4276200,-1
584,1,STEP,437363588100,437366722700,3134600,-1
585,1,STEP,437366844100,437371768600,4924500,-1
586,1,STEP,437371887900,437376020100,4132200,-1
587,1,STEP,437376134600,437379274100,3139500,-1
588,1,STEP,437379373400,437383720200,4346800,-1
589,1,STEP,437383828900,437387643000,3814100,-1
590,1,STEP,437387762500,437392007500,4245000,-1
591,1,STEP,437392181500,437395308900,3127400,-1
592,1,STEP,437395401500,437399257800,3856300,-1
593,1,STEP,437399379200,437403130200,3751000,-1
594,1,STEP,437403242100,437407931100,4689000,-1
595,1,STEP,437408050500,437412086600,4036100,-1
596,1,STEP,437412216600,437416750600,4534000,-1
597,1,STEP,437416852600,437420961900,4109300,-1
598,1,STEP,437421115200,437425241600,4126400,-1
599,1,STEP,437425418100,437430115100,4697000,-1
600,1,STEP,437430266100,437434301500,4035400,-1
601,1,STEP,437434414200,437439292900,4878700,-1
602,1,STEP,437439433000,437443061900,3628900,-1
603,1,STEP,437443163200,437448499400,5336200,-1
604,1,STEP,437448610500,437452454200,3843700,-1
605,1,STEP,437452549800,437456445700,3895900,-1
606,1,STEP,437456541900,437460991300,4449400,-1
607,1,STEP,437461111200,437464935400,3824200,-1
608,1,STEP,437465018800,437469196100,4177300,-1
609,1,STEP,437469293000,437473158600,3865600,-1
610,1,STEP,437473245500,437478435000,5189500,-1
611,1,STEP,437478548700,437482633100,4084400,-1
612,1,STEP,437482743600,437486215000,3471400,-1
613,1,STEP,437486301000,437490244000,3943000,-1
614,1,STEP,437490349800,437494316700,3966900,-1
615,1,STEP,437494430700,437498464900,4034200,-1
616,1,STEP,437498566900,437503320500,4753600,-1
617,1,STEP,437503435400,437506900300,3464900,-1
618,1,STEP,437506992200,437510307300,3315100,-1
619,1,STEP,437510396300,437513684700,3288400,-1
620,1,STEP,437513767000,437516681400,2914400,-1
621,1,STEP,437516776500,437520426800,3650300,-1
622,1,STEP,437520528100,437524921100,4393000,-1
623,1,STEP,437525032400,437528371200,3338800,-1
624,1,STEP,437528477500,437532247300,3769800,-1
625,1,STEP,437532355500,437536050100,3694600,-1
626,1,STEP,437536199900,437540327000,4127100,-1
627,1,STEP,437540434700,437544085400,3650700,-1
628,1,STEP,437544187800,437548450200,4262400,-1
629,1,STEP,437548555700,437552750300,4194600,-1
630,1,STEP,437552861000,437556025600,3164600,-1
631,1,STEP,437556172400,437559732200,3559800,-1
632,1,STEP,437559827700,437563546400,3718700,-1
633,1,STEP,437563633000,437567356600,3723600,-1
634,1,STEP,437567432200,437570468600,3036400,-1
635,1,STEP,437570548400,437573791200,3242800,-1
636,1,STEP,437573872700,437577015500,3142800,-1
637,1,STEP,437577110400,437580375500,3265100,-1
638,1,STEP,437580462600,437584536800,4074200,-1
639,1,STEP,437584638800,437588214600,3575800,-1
640,1,STEP,437588299100,437591881200,3582100,-1
641,1,STEP,437592010500,437596006900,3996400,-1
642,1,STEP,437596096100,437599728900,3632800,-1
643,1,STEP,437599822300,437603278200,3455900,-1
644,1,STEP,437603363800,437607483000,4119200,-1
645,1,STEP,437607576100,437611486700,3910600,-1
646,1,STEP,437611599700,437614861400,3261700,-1
647,1,STEP,437614950300,437618561000,3610700,-1
648,1,STEP,437618654100,437622302700,3648600,-1
649,1,STEP,437622413100,437626744500,4331400,-1
650,1,STEP,437626852500,437631168100,4315600,-1
651,1,STEP,437631270900,437636011800,4740900,-1
652,1,STEP,437636129100,437640692000,4562900,-1
653,1,STEP,437640821700,437644430100,3608400,-1
654,1,STEP,437644537200,437648008200,3471000,-1
655,1,STEP,437648125100,437651947500,3822400,-1
656,1,STEP,437652031400,437655328400,3297000,-1
657,1,STEP,437655423400,437659566700,4143300,-1
658,1,STEP,437659659400,437663142100,3482700,-1
659,1,STEP,437663231500,437666464300,3232800,-1
660,1,STEP,437666574800,437670058000,3483200,-1
661,1,STEP,437670150100,437674835700,4685600,-1
662,1,STEP,437674941900,437678963600,4021700,-1
663,1,STEP,437679057600,437682816300,3758700,-1
664,1,STEP,437682920100,437685916600,2996500,-1
665,1,STEP,437686008400,437690302200,4293800,-1
666,1,STEP,437690403200,437694687300,4284100,-1
667,1,STEP,437694784100,437699462400,4678300,-1
668,1,STEP,437699566800,437704499000,4932200,-1
669,1,STEP,437704599100,437708765000,4165900,-1
670,1,STEP,437708857000,437712631600,3774600,-1
671,1,STEP,437712724500,437716565200,3840700,-1
672,1,STEP,437716670200,437720744200,4074000,-1
673,1,STEP,437720861500,437724409500,3548000,-1
674,1,STEP,437724506800,437728251800,3745000,-1
675,1,STEP,437728330700,437731664900,3334200,-1
676,1,STEP,437731752900,437734884000,3131100,-1
677,1,STEP,437734965400,437738491900,3526500,-1
678,1,STEP,437738594300,437741555200,2960900,-1
679,1,STEP,437741648700,437744682900,3034200,-1
680,1,STEP,437744783400,437747980600,3197200,-1
681,1,STEP,437748066100,437751800500,3734400,-1
682,1,STEP,437751891000,437755588600,3697600,-1
683,1,STEP,437755720400,437759017400,3297000,-1
684,1,STEP,437759103800,437762455500,3351700,-1
685,1,STEP,437762538600,437765903900,3365300,-1
686,1,STEP,437766000200,437769877600,3877400,-1
687,1,STEP,437769965400,437773664300,3698900,-1
688,1,STEP,437773754600,437777267500,3512900,-1
689,1,STEP,437777362300,437780679800,3317500,-1
690,1,STEP,437780771600,437784091700,3320100,-1
691,1,STEP,437784178400,437787743600,3565200,-1
692,1,STEP,437787831800,437791308000,3476200,-1
693,1,STEP,437791404000,437795674600,4270600,-1
694,1,STEP,437795828800,437800547300,4718500,-1
695,1,STEP,437800663600,437804752100,4088500,-1
696,1,STEP,437804853600,437808862400,4008800,-1
697,1,STEP,437808966900,437812557700,3590800,-1
698,1,STEP,437812651400,437816195700,3544300,-1
699,1,STEP,437816298700,437820482900,4184200,-1
700,1,STEP,437820595200,437824430500,3835300,-1
701,1,STEP,437824529200,437829263000,4733800,-1
702,1,STEP,437829462000,437834700600,5238600,-1
703,1,STEP,437834879600,437839165800,4286200,-1
704,1,STEP,437839272100,437845818300,6546200,-1
705,1,STEP,437846064800,437850267300,4202500,-1
706,1,STEP,437850383600,437854367000,3983400,-1
707,1,STEP,437854465300,437858888500,4423200,-1
708,1,STEP,437859118700,437864613300,5494600,-1
709,1,STEP,437864842700,437870030900,5188200,-1
710,1,STEP,437870239500,437875300000,5060500,-1
711,1,STEP,437875417600,437879551900,4134300,-1
712,1,STEP,437879671700,437883298200,3626500,-1
713,1,STEP,437883452400,437888196100,4743700,-1
714,1,STEP,437888325500,437892773300,4447800,-1
715,1,STEP,437892894500,437897010500,4116000,-1
716,1,STEP,437897152800,437903043300,5890500,-1
717,1,STEP,437903288700,437910024400,6735700,-1
718,1,STEP,437910137800,437915074900,4937100,-1
719,1,STEP,437915196600,437919370600,4174000,-1
720,1,STEP,437919569500,437923778900,4209400,-1
721,1,STEP,437923877100,437927498400,3621300,-1
722,1,STEP,437927597200,437931471300,3874100,-1
723,1,STEP,437931588200,437934752300,3164100,-1
724,1,STEP,437934848300,437938057700,3209400,-1
725,1,STEP,437938188600,437942191700,4003100,-1
726,1,STEP,437942287400,437945574600,3287200,-1
727,1,STEP,437945701600,437949622500,3920900,-1
728,1,STEP,437949715700,437953587600,3871900,-1
729,1,STEP,437953689500,437957636900,3947400,-1
730,1,STEP,437957734200,437961031600,3297400,-1
731,1,STEP,437961183400,437964862500,3679100,-1
732,1,STEP,437964956500,437968720800,3764300,-1
733,1,STEP,437968824900,437972465700,3640800,-1
734,1,STEP,437972566900,437976276200,3709300,-1
735,1,STEP,437976377100,437982064100,5687000,-1
736,1,STEP,437982204200,437985949100,3744900,-1
737,1,STEP,437986030700,437989858100,3827400,-1
738,1,STEP,437989943400,437993536300,3592900,-1
739,1,STEP,437993693400,437997773300,4079900,-1
740,1,STEP,437997857100,438001565200,3708100,-1
741,1,STEP,438001656200,438005190600,3534400,-1
742,1,STEP,438005269600,438009101400,3831800,-1
743,1,STEP,438009207100,438012267200,3060100,-1
744,1,STEP,438012340700,438016120200,3779500,-1
745,1,STEP,438016265100,438019872400,3607300,-1
746,1,STEP,438019987500,438023715300,3727800,-1
747,1,STEP,438023808800,438027106100,3297300,-1
748,1,STEP,438027186700,438030701000,3514300,-1
749,1,STEP,438030799500,438034620900,3821400,-1
750,1,STEP,438034707900,438037644200,2936300,-1
751,1,STEP,438037727700,438040895800,3168100,-1
752,1,STEP,438040982200,438044817400,3835200,-1
753,1,STEP,438044926000,438048323600,3397600,-1
754,1,STEP,438048411800,438051714300,3302500,-1
755,1,STEP,438051802000,438055914300,4112300,-1
756,1,STEP,438056017100,438059005200,2988100,-1
757,1,STEP,438059080900,438062504600,3423700,-1
758,1,STEP,438062582100,438065812200,3230100,-1
759,1,STEP,438065915000,438070482900,4567900,-1
760,1,STEP,438070589100,438074193400,3604300,-1
761,1,STEP,438074270700,438077760600,3489900,-1
762,1,STEP,438077866600,438081714600,3848000,-1
763,1,STEP,438081803500,438085340700,3537200,-1
764,1,STEP,438085438600,438088916800,3478200,-1
765,1,STEP,438089007100,438092607400,3600300,-1
766,1,STEP,438092700600,438096142000,3441400,-1
767,1,STEP,438096233500,438100358700,4125200,-1
768,1,STEP,438100465300,438104342900,3877600,-1
769,1,STEP,438104434600,438108442000,4007400,-1
770,1,STEP,438108538000,438112561000,4023000,-1
771,1,STEP,438112672700,438115895800,3223100,-1
772,1,STEP,438116009700,438120421400,4411700,-1
773,1,STEP,438120525300,438124502800,3977500,-1
774,1,STEP,438124600900,438127829400,3228500,-1
775,1,STEP,438127927200,438131282000,3354800,-1
776,1,STEP,438131375100,438135222600,3847500,-1
777,1,STEP,438135315400,438138824300,3508900,-1
778,1,STEP,438138920500,438141992100,3071600,-1
779,1,STEP,438142080000,438145589700,3509700,-1
780,1,STEP,438145691100,438150084400,4393300,-1
781,1,STEP,438150178800,438153678200,3499400,-1
782,1,STEP,438153757900,438156887000,3129100,-1
783,1,STEP,438156969800,438160749800,3780000,-1
784,1,STEP,438160849900,438164565200,3715300,-1
785,1,STEP,438164653100,438168152100,3499000,-1
786,1,STEP,438168249600,438171957000,3707400,-1
787,1,STEP,438172047600,438177030200,4982600,-1
788,1,STEP,438177127800,438180632600,3504800,-1
789,1,STEP,438180727600,438184425700,3698100,-1
790,1,STEP,438184521300,438188471000,3949700,-1
791,1,STEP,438188615100,438192656000,4040900,-1
792,1,STEP,438192755300,438197036200,4280900,-1
793,1,STEP,438197152200,438200667900,3515700,-1
794,1,STEP,438200742700,438204316800,3574100,-1
795,1,STEP,438204396200,438207514300,3118100,-1
796,1,STEP,438207596500,438211218500,3622000,-1
797,1,STEP,438211312500,438214897800,3585300,-1
798,1,STEP,438215010300,438218466900,3456600,-1
799,1,STEP,438218555800,438221936100,3380300,-1
800,1,STEP,438222033500,438225088700,3055200,-1
801,1,STEP,438225171000,438228900300,3729300,-1
802,1,STEP,438229007000,438232223400,3216400,-1
803,1,STEP,438232306000,438235453000,3147000,-1
804,1,STEP,438235529200,438238858200,3329000,-1
805,1,STEP,438238961300,438242657200,3695900,-1
806,1,STEP,438242739300,438246047100,3307800,-1
807,1,STEP,438246132800,438249170200,3037400,-1
808,1,STEP,438249248900,438252924700,3675800,-1
809,1,STEP,438253012800,438257182900,4170100,-1
810,1,STEP,438257271600,438260750900,3479300,-1
811,1,STEP,438260835300,438264334700,3499400,-1
812,1,STEP,438264421800,438268248700,3826900,-1
813,1,STEP,438268333300,438271487600,3154300,-1
814,1,STEP,438271576900,438275744500,4167600,-1
815,1,STEP,438275822600,438278553500,2730900,-1
816,1,STEP,438278630200,438282620100,3989900,-1
817,1,STEP,438282703000,438286428900,3725900,-1
818,1,STEP,438286520400,438290542600,4022200,-1
819,1,STEP,438290629000,438294532600,3903600,-1
820,1,STEP,438294624900,438298284400,3659500,-1
821,1,STEP,438298376300,438302043700,3667400,-1
822,1,STEP,438302151900,438306456900,4305000,-1
823,1,STEP,438306554900,438309453600,2898700,-1
824,1,STEP,438309526100,438312729600,3203500,-1
825,1,STEP,438312805300,438316182800,3377500,-1
826,1,STEP,438316261100,438319213800,2952700,-1
827,1,STEP,438319290600,438323749700,4459100,-1
828,1,STEP,438323846700,438327023700,3177000,-1
829,1,STEP,438327180000,438330537500,3357500,-1
830,1,STEP,438330620100,438334521300,3901200,-1
831,1,STEP,438334683700,438338725800,4042100,-1
832,1,STEP,438338820900,438342979900,4159000,-1
833,1,STEP,438343089800,438346362200,3272400,-1
834,1,STEP,438346452200,438350138100,3685900,-1
835,1,STEP,438350243200,438353850900,3607700,-1
836,1,STEP,438353952500,438357403500,3451000,-1
837,1,STEP,438357502900,438361233400,3730500,-1
838,1,STEP,438361326800,438364808300,3481500,-1
839,1,STEP,438364909100,438368874500,3965400,-1
840,1,STEP,438369006100,438371981200,2975100,-1
841,1,STEP,438372089000,438375473700,3384700,-1
842,1,STEP,438375576400,438379925700,4349300,-1
843,1,STEP,438380049200,438383549300,3500100,-1
844,1,STEP,438383644900,438387124500,3479600,-1
845,1,STEP,438387205900,438390210000,3004100,-1
846,1,STEP,438390318200,438393574100,3255900,-1
847,1,STEP,438393655000,438398006200,4351200,-1
848,1,STEP,438398118500,438401333700,3215200,-1
849,1,STEP,438401425500,438404970300,3544800,-1
850,1,STEP,438405075300,438408790100,3714800,-1
851,1,STEP,438408881500,438412000400,3118900,-1
852,1,STEP,438412103100,438416093300,3990200,-1
853,1,STEP,438416188400,438420807100,4618700,-1
854,1,STEP,438421008000,438425101300,4093300,-1
855,1,STEP,438425206000,438429359800,4153800,-1
856,1,STEP,438429492700,438433720400,4227700,-1
857,1,STEP,438433815300,438437662800,3847500,-1
858,1,STEP,438437753500,438441016500,3263000,-1
859,1,STEP,438441111300,438444815700,3704400,-1
860,1,STEP,438445005900,438449161800,4155900,-1
861,1,STEP,438449262800,438452719000,3456200,-1
862,1,STEP,438452845700,438456158900,3313200,-1
863,1,STEP,438456257300,438459694000,3436700,-1
864,1,STEP,438459857600,438464228500,4370900,-1
865,1,STEP,438464321200,438468160100,3838900,-1
866,1,STEP,438468251200,438471603800,3352600,-1
867,1,STEP,438471684100,438474932500,3248400,-1
868,1,STEP,438475057300,438478733200,3675900,-1
869,1,STEP,438478839700,438482340500,3500800,-1
870,1,STEP,438482442500,438485617800,3175300,-1
871,1,STEP,438485716900,438489292000,3575100,-1
872,1,STEP,438489387700,438493107800,3720100,-1
873,1,STEP,438493196700,438496710700,3514000,-1
874,1,STEP,438496805300,438500641600,3836300,-1
875,1,STEP,438500812100,438505124400,4312300,-1
876,1,STEP,438505213600,438509849800,4636200,-1
877,1,STEP,438509951000,438513405000,3454000,-1
878,1,STEP,438513520200,438517302000,3781800,-1
879,1,STEP,438517400900,438521062300,3661400,-1
880,1,STEP,438521155000,438525179000,4024000,-1
881,1,STEP,438525271100,438529770800,4499700,-1
882,1,STEP,438529872800,438533451200,3578400,-1
883,1,STEP,438533543900,438537668300,4124400,-1
884,1,STEP,438537775000,438541965500,4190500,-1
885,1,STEP,438542063800,438545907200,3843400,-1
886,1,STEP,438546007400,438549453000,3445600,-1
887,1,STEP,438549567200,438553232300,3665100,-1
888,1,STEP,438553439600,438556878100,3438500,-1
889,1,STEP,438556976800,438560220000,3243200,-1
890,1,STEP,438560299200,438563489600,3190400,-1
891,1,STEP,438563619400,438566843400,3224000,-1
892,1,STEP,438566969300,438570333800,3364500,-1
893,1,STEP,438570427000,438574110200,3683200,-1
894,1,STEP,438574205400,438577681700,3476300,-1
895,1,STEP,438577784800,438580791900,3007100,-1
896,1,STEP,438580876200,438583827000,2950800,-1
897,1,STEP,438583906800,438587203300,3296500,-1
898,1,STEP,438587289800,438590292900,3003100,-1
899,1,STEP,438590372900,438593853600,3480700,-1
900,1,STEP,438593939300,438597606400,3667100,-1
901,1,STEP,438597696300,438601912700,4216400,-1
902,1,STEP,438602018400,438605595400,3577000,-1
903,1,STEP,438605694900,438608909900,3215000,-1
904,1,STEP,438608996400,438612259100,3262700,-1
905,1,STEP,438612356800,438616340400,3983600,-1
906,1,STEP,438616432600,438619583400,3150800,-1
907,1,STEP,438619672900,438623310800,3637900,-1
908,1,STEP,438623399200,438626899600,3500400,-1
909,1,STEP,438627004500,438630951600,3947100,-1
910,1,STEP,438631039900,438635504300,4464400,-1
911,1,STEP,438635602800,438639567700,3964900,-1
912,1,STEP,438639662900,438643214300,3551400,-1
913,1,STEP,438643308500,438646927500,3619000,-1
914,1,STEP,438647055400,438650842000,3786600,-1
915,1,STEP,438650961300,438654453400,3492100,-1
916,1,STEP,438654547100,438658483400,3936300,-1
917,1,STEP,438658581500,438663560200,4978700,-1
918,1,STEP,438663674900,438667316600,3641700,-1
919,1,STEP,438667421300,438671749400,4328100,-1
920,1,STEP,438671847500,438675655500,3808000,-1
921,1,STEP,438675757700,438680288100,4530400,-1
922,1,STEP,438680387800,438684277500,3889700,-1
923,1,STEP,438684378800,438688248100,3869300,-1
924,1,STEP,438688346600,438691925200,3578600,-1
925,1,STEP,438692023500,438696053000,4029500,-1
926,1,STEP,438696182300,438701288600,5106300,-1
927,1,STEP,438701388000,438704988100,3600100,-1
928,1,STEP,438705086700,438708830400,3743700,-1
929,1,STEP,438708988300,438713042000,4053700,-1
930,1,STEP,438713154200,438717622900,4468700,-1
931,1,STEP,438717731700,438721853700,4122000,-1
932,1,STEP,438721952200,438725658800,3706600,-1
933,1,STEP,438725764000,438730050800,4286800,-1
934,1,STEP,438730154800,438733967600,3812800,-1
935,1,STEP,438734067600,438737740500,3672900,-1
936,1,STEP,438737846300,438742030400,4184100,-1
937,1,STEP,438742132100,438746059000,3926900,-1
938,1,STEP,438746179300,438749973000,3793700,-1
939,1,STEP,438750081500,438753431400,3349900,-1
940,1,STEP,438753526300,438757264300,3738000,-1
941,1,STEP,438757358000,438761190100,3832100,-1
942,1,STEP,438761293300,438765334600,4041300,-1
943,1,STEP,438765438300,438769306400,3868100,-1
944,1,STEP,438769407200,438773573400,4166200,-1
945,1,STEP,438773699600,438777582000,3882400,-1
946,1,STEP,438777699900,438781846500,4146600,-1
947,1,STEP,438781950400,438786186400,4236000,-1
948,1,STEP,438786291100,438790290200,3999100,-1
949,1,STEP,438790385200,438794783600,4398400,-1
950,1,STEP,438794884700,438798759000,3874300,-1
951,1,STEP,438798858100,438802351300,3493200,-1
952,1,STEP,438802458000,438806742500,4284500,-1
953,1,STEP,438806857800,438811148400,4290600,-1
954,1,STEP,438811266100,438815074700,3808600,-1
955,1,STEP,438815193000,438819431000,4238000,-1
956,1,STEP,438819532300,438824282500,4750200,-1
957,1,STEP,438824394200,438827987300,3593100,-1
958,1,STEP,438828093800,438832433800,4340000,-1
959,1,STEP,438832537900,438836817300,4279400,-1
960,1,STEP,438836923900,438840608100,3684200,-1
961,1,STEP,438840704400,438846181800,5477400,-1
962,1,STEP,438846286000,438849847400,3561400,-1
963,1,STEP,438849950000,438853717600,3767600,-1
964,1,STEP,438853830200,438859497900,5667700,-1
965,1,STEP,438859613300,438863528200,3914900,-1
966,1,STEP,438863628300,438867212700,3584400,-1
967,1,STEP,438867379300,438872175800,4796500,-1
968,1,STEP,438872282900,438875929700,3646800,-1
969,1,STEP,438876065900,438880052500,3986600,-1
970,1,STEP,438880150100,438884166300,4016200,-1
971,1,STEP,438884284200,438888693900,4409700,-1
972,1,STEP,438888799300,438892186600,3387300,-1
973,1,STEP,438892291400,438896502800,4211400,-1
974,1,STEP,438896614700,438900560000,3945300,-1
975,1,STEP,438900674700,438904922200,4247500,-1
976,1,STEP,438905033100,438909246400,4213300,-1
977,1,STEP,438909351000,438913497500,4146500,-1
978,1,STEP,438913598100,438917918900,4320800,-1
979,1,STEP,438918150900,438922633800,4482900,-1
980,1,STEP,438922768000,438928013500,5245500,-1
981,1,STEP,438928118100,438932199800,4081700,-1
982,1,STEP,438932297900,438936272200,3974300,-1
983,1,STEP,438936372000,438941114300,4742300,-1
984,1,STEP,438941214200,438945498600,4284400,-1
985,1,STEP,438945598300,438949368600,3770300,-1
986,1,STEP,438949472400,438953369900,3897500,-1
987,1,STEP,438953464500,438957135700,3671200,-1
988,1,STEP,438957235900,438962068800,4832900,-1
989,1,STEP,438962174700,438967655500,5480800,-1
990,1,STEP,438967757200,438971868900,4111700,-1
991,1,STEP,438971967400,438976169200,4201800,-1
992,1,STEP,438976268800,438981004100,4735300,-1
993,1,STEP,438981180800,438985274900,4094100,-1
994,1,STEP,438985372300,438989624900,4252600,-1
995,1,STEP,438989725100,438993142000,3416900,-1
996,1,STEP,438993225400,438997366800,4141400,-1
997,1,STEP,438997454600,439000505000,3050400,-1
998,1,STEP,439000585500,439004193600,3608100,-1
999,1,STEP,439004273700,439008306500,4032800,-1
