Gen,Resource,Stamp,TimeStamp_Start,TimeStamp_End,Duration,Indiv_id
0,1,TransfertToDevice,754554460700,754906587000,352126300,-1
0,1,STEP,755023511900,755026842500,3330600,-1
1,1,STEP,755026892200,755029541700,2649500,-1
2,1,STEP,755029576800,755032161000,2584200,-1
3,1,STEP,755032185000,755034875500,2690500,-1
4,1,STEP,755034921400,755037388300,2466900,-1
5,1,STEP,755037416900,755039681700,2264800,-1
6,1,STEP,755039706200,755042033900,2327700,-1
7,1,STEP,755042066000,755044476600,2410600,-1
8,1,STEP,755044505400,755046788300,2282900,-1
9,1,STEP,755046811700,755049198100,2386400,-1
10,1,STEP,755049223600,755051621800,2398200,-1
11,1,STEP,755051652700,755053916600,2263900,-1
12,1,STEP,755053941400,755056347000,2405600,-1
13,1,STEP,755056408400,755059146200,2737800,-1
14,1,STEP,755059178400,755061926500,2748100,-1
15,1,STEP,755061951600,755064813400,2861800,-1
16,1,STEP,755064851400,755067195700,2344300,-1
17,1,STEP,755067219700,755069518000,2298300,-1
18,1,STEP,755069544000,755072037200,2493200,-1
19,1,STEP,755072090200,755074485900,2395700,-1
20,1,STEP,755074518800,755077019800,2501000,-1
21,1,STEP,755077072800,755079417500,2344700,-1
22,1,STEP,755079449400,755081749700,2300300,-1
23,1,STEP,755081773700,755084179900,2406200,-1
24,1,STEP,755084207100,755086708800,2501700,-1
25,1,STEP,755086733800,755089041200,2307400,-1
26,1,STEP,755089064600,755091457900,2393300,-1
27,1,STEP,755091498900,755093802000,2303100,-1
28,1,STEP,755093826200,755096157400,2331200,-1
29,1,STEP,755096181100,755098640700,2459600,-1
30,1,STEP,755098670300,755101031200,2360900,-1
31,1,STEP,755101058800,755103490100,2431300,-1
32,1,STEP,755103519200,755106119400,2600200,-1
33,1,STEP,755106251100,755108908800,2657700,-1
34,1,STEP,755108939300,755111881300,2942000,-1
35,1,STEP,755111946800,755114853400,2906600,-1
36,1,STEP,755114882000,755117619100,2737100,-1
37,1,STEP,755117651900,755120344000,2692100,-1
38,1,STEP,755120390500,755122794400,2403900,-1
39,1,STEP,755122821900,755125191800,2369900,-1
40,1,STEP,755125229800,755127677700,2447900,-1
41,1,STEP,755127703200,755130016900,2313700,-1
42,1,STEP,755130043200,755132621000,2577800,-1
43,1,STEP,755132646900,755134981600,2334700,-1
44,1,STEP,755135006300,755137310500,2304200,-1
45,1,STEP,755137334400,755139775600,2441200,-1
46,1,STEP,755139807100,755142187200,2380100,-1
47,1,STEP,755142212300,755145136100,2923800,-1
48,1,STEP,755145161100,755147990800,2829700,-1
49,1,STEP,755148028400,755150819300,2790900,-1
50,1,STEP,755150845100,755153407600,2562500,-1
51,1,STEP,755153433000,755155986300,2553300,-1
52,1,STEP,755156022300,755158500700,2478400,-1
53,1,STEP,755158524900,755161053800,2528900,-1
54,1,STEP,755161084400,755163555000,2470600,-1
55,1,STEP,755163578800,755166058700,2479900,-1
56,1,STEP,755166082300,755168635900,2553600,-1
57,1,STEP,755168666500,755171232400,2565900,-1
58,1,STEP,755171259900,755173774400,2514500,-1
59,1,STEP,755173807800,755176379100,2571300,-1
60,1,STEP,755176411000,755179020300,2609300,-1
61,1,STEP,755179051700,755181702800,2651100,-1
62,1,STEP,755181748300,755184279300,2531000,-1
63,1,STEP,755184305600,755186818200,2512600,-1
64,1,STEP,755186848100,755189428400,2580300,-1
65,1,STEP,755189457400,755191763200,2305800,-1
66,1,STEP,755191787600,755194095800,2308200,-1
67,1,STEP,755194119800,755196525900,2406100,-1
68,1,STEP,755196554600,755198886300,2331700,-1
69,1,STEP,755198910400,755201207200,2296800,-1
70,1,STEP,755201232100,755203630700,2398600,-1
71,1,STEP,755203667300,755206020600,2353300,-1
72,1,STEP,755206045400,755208389400,2344000,-1
73,1,STEP,755208415000,755210858200,2443200,-1
74,1,STEP,755210892800,755213234200,2341400,-1
75,1,STEP,755213259100,755215744000,2484900,-1
76,1,STEP,755215774500,755218196000,2421500,-1
77,1,STEP,755218230100,755220560000,2329900,-1
78,1,STEP,755220586000,755222967700,2381700,-1
79,1,STEP,755223000600,755225396700,2396100,-1
80,1,STEP,755225423300,755227792500,2369200,-1
81,1,STEP,755227816600,755230214900,2398300,-1
82,1,STEP,755230243900,755232621800,2377900,-1
83,1,STEP,755232647400,755235004900,2357500,-1
84,1,STEP,755235030700,755237484200,2453500,-1
85,1,STEP,755237521100,755239863700,2342600,-1
86,1,STEP,755239889700,755242255200,2365500,-1
87,1,STEP,755242279900,755244633300,2353400,-1
88,1,STEP,755244660300,755246992500,2332200,-1
89,1,STEP,755247017100,755249351000,2333900,-1
90,1,STEP,755249381500,755251824600,2443100,-1
91,1,STEP,755251869600,755254246000,2376400,-1
92,1,STEP,755254273900,755256643200,2369300,-1
93,1,STEP,755256667800,755259153100,2485300,-1
94,1,STEP,755259186300,755261515900,2329600,-1
95,1,STEP,755261542200,755263950400,2408200,-1
96,1,STEP,755263979300,755266401300,2422000,-1
97,1,STEP,755266434400,755268748900,2314500,-1
98,1,STEP,755268772800,755271243600,2470800,-1
99,1,STEP,755271272200,755273660200,2388000,-1
100,1,STEP,755273688400,755276071500,2383100,-1
101,1,STEP,755276096200,755278749700,2653500,-1
102,1,STEP,755278777700,755281550600,2772900,-1
103,1,STEP,755281642400,755284205500,2563100,-1
104,1,STEP,755284249800,755286761500,2511700,-1
105,1,STEP,755286804400,755289132300,2327900,-1
106,1,STEP,755289157200,755291502700,2345500,-1
107,1,STEP,755291528400,755294012200,2483800,-1
108,1,STEP,755294040500,755296423400,2382900,-1
109,1,STEP,755296447200,755298938700,2491500,-1
110,1,STEP,755298965800,755301365100,2399300,-1
111,1,STEP,755301398200,755303757900,2359700,-1
112,1,STEP,755303782300,755306170500,2388200,-1
113,1,STEP,755306200500,755308601900,2401400,-1
114,1,STEP,755308631600,755310930800,2299200,-1
115,1,STEP,755310955700,755313578000,2622300,-1
116,1,STEP,755313611800,755316015300,2403500,-1
117,1,STEP,755316039800,755318390000,2350200,-1
118,1,STEP,755318414200,755320759000,2344800,-1
119,1,STEP,755320786300,755323118700,2332400,-1
120,1,STEP,755323143200,755325460300,2317100,-1
121,1,STEP,755325484400,755328052500,2568100,-1
122,1,STEP,755328083100,755330409900,2326800,-1
123,1,STEP,755330435300,755332754900,2319600,-1
124,1,STEP,755332779100,755335174600,2395500,-1
125,1,STEP,755335202200,755337568300,2366100,-1
126,1,STEP,755337592600,755339907200,2314600,-1
127,1,STEP,755339932300,755342317400,2385100,-1
128,1,STEP,755342346600,755344663400,2316800,-1
129,1,STEP,755344691700,755347058200,2366500,-1
130,1,STEP,755347082300,755349510200,2427900,-1
131,1,STEP,755349544300,755351883700,2339400,-1
132,1,STEP,755351907900,755354226200,2318300,-1
133,1,STEP,755354252100,755356794000,2541900,-1
134,1,STEP,755356829700,755359203000,2373300,-1
135,1,STEP,755359227400,755361685000,2457600,-1
136,1,STEP,755361713100,755364072800,2359700,-1
137,1,STEP,755364098200,755366441900,2343700,-1
138,1,STEP,755366465700,755368888600,2422900,-1
139,1,STEP,755368914100,755371279500,2365400,-1
140,1,STEP,755371304900,755373656500,2351600,-1
141,1,STEP,755373681200,755376331100,2649900,-1
142,1,STEP,755376387200,755379181100,2793900,-1
143,1,STEP,755379209100,755381586000,2376900,-1
144,1,STEP,755381611600,755384438900,2827300,-1
145,1,STEP,755384472100,755387101300,2629200,-1
146,1,STEP,755387132300,755389535300,2403000,-1
147,1,STEP,755389574700,755392026700,2452000,-1
148,1,STEP,755392063700,755394357400,2293700,-1
149,1,STEP,755394383700,755396916600,2532900,-1
150,1,STEP,755396949500,755399367200,2417700,-1
151,1,STEP,755399398300,755401760600,2362300,-1
152,1,STEP,755401787000,755404200000,2413000,-1
153,1,STEP,755404245200,755406614300,2369100,-1
154,1,STEP,755406640200,755409041500,2401300,-1
155,1,STEP,755409068600,755411678800,2610200,-1
156,1,STEP,755411709200,755414010200,2301000,-1
157,1,STEP,755414035100,755416360400,2325300,-1
158,1,STEP,755416385100,755418779400,2394300,-1
159,1,STEP,755418805700,755421174900,2369200,-1
160,1,STEP,755421200200,755423539900,2339700,-1
161,1,STEP,755423566400,755426366200,2799800,-1
162,1,STEP,755426414500,755428746000,2331500,-1
163,1,STEP,755428771900,755431193000,2421100,-1
164,1,STEP,755431222000,755433552900,2330900,-1
165,1,STEP,755433589600,755435914700,2325100,-1
166,1,STEP,755435939400,755438451400,2512000,-1
167,1,STEP,755438480400,755440865000,2384600,-1
168,1,STEP,755440892900,755443190500,2297600,-1
169,1,STEP,755443216800,755445604700,2387900,-1
170,1,STEP,755445633500,755447979800,2346300,-1
171,1,STEP,755448012000,755450331100,2319100,-1
172,1,STEP,755450357300,755452742000,2384700,-1
173,1,STEP,755452771000,755455030500,2259500,-1
174,1,STEP,755455055600,755457727700,2672100,-1
175,1,STEP,755457760200,755460174300,2414100,-1
176,1,STEP,755460205900,755462544600,2338700,-1
177,1,STEP,755462582000,755464926100,2344100,-1
178,1,STEP,755464950100,755467331400,2381300,-1
179,1,STEP,755467360400,755469685900,2325500,-1
180,1,STEP,755469711700,755472074800,2363100,-1
181,1,STEP,755472104900,755474803000,2698100,-1
182,1,STEP,755474844200,755477415100,2570900,-1
183,1,STEP,755477443400,755479896000,2452600,-1
184,1,STEP,755479923700,755482333500,2409800,-1
185,1,STEP,755482358600,755484688900,2330300,-1
186,1,STEP,755484713200,755487312300,2599100,-1
187,1,STEP,755487353600,755489952400,2598800,-1
188,1,STEP,755489981000,755492483100,2502100,-1
189,1,STEP,755492514900,755494908400,2393500,-1
190,1,STEP,755494940300,755497287400,2347100,-1
191,1,STEP,755497312800,755499632600,2319800,-1
192,1,STEP,755499657600,755502153300,2495700,-1
193,1,STEP,755502181600,755504547000,2365400,-1
194,1,STEP,755504572800,755506932200,2359400,-1
195,1,STEP,755506956200,755509386300,2430100,-1
196,1,STEP,755509414600,755511715100,2300500,-1
197,1,STEP,755511739300,755514060000,2320700,-1
198,1,STEP,755514084200,755516552000,2467800,-1
199,1,STEP,755516579200,755518891300,2312100,-1
200,1,STEP,755518915000,755521478000,2563000,-1
201,1,STEP,755521526700,755524368700,2842000,-1
202,1,STEP,755524409200,755527008600,2599400,-1
203,1,STEP,755527034900,755529645500,2610600,-1
204,1,STEP,755529689800,755532510800,2821000,-1
205,1,STEP,755532536800,755535169300,2632500,-1
206,1,STEP,755535210300,755537852200,2641900,-1
207,1,STEP,755537886200,755540518900,2632700,-1
208,1,STEP,755540546200,755543233000,2686800,-1
209,1,STEP,755543262600,755545849700,2587100,-1
210,1,STEP,755545876700,755548535100,2658400,-1
211,1,STEP,755548564600,755551431800,2867200,-1
212,1,STEP,755551479200,755553841700,2362500,-1
213,1,STEP,755553867400,755556284600,2417200,-1
214,1,STEP,755556312600,755558704500,2391900,-1
215,1,STEP,755558730100,755561073400,2343300,-1
216,1,STEP,755561098600,755563671900,2573300,-1
217,1,STEP,755563705500,755566061700,2356200,-1
218,1,STEP,755566086200,755568733400,2647200,-1
219,1,STEP,755568767200,755571634200,2867000,-1
220,1,STEP,755571668100,755574242500,2574400,-1
221,1,STEP,755574267600,755576675400,2407800,-1
222,1,STEP,755576700400,755579103900,2403500,-1
223,1,STEP,755579130200,755581501500,2371300,-1
224,1,STEP,755581527000,755584077800,2550800,-1
225,1,STEP,755584114000,755586862700,2748700,-1
226,1,STEP,755586891400,755589490200,2598800,-1
227,1,STEP,755589522900,755592070200,2547300,-1
228,1,STEP,755592110400,755594468400,2358000,-1
229,1,STEP,755594492800,755596811700,2318900,-1
230,1,STEP,755596835300,755599192700,2357400,-1
231,1,STEP,755599220100,755601705600,2485500,-1
232,1,STEP,755601732800,755604104000,2371200,-1
233,1,STEP,755604127500,755606505300,2377800,-1
234,1,STEP,755606534100,755608858500,2324400,-1
235,1,STEP,755608882000,755611258600,2376600,-1
236,1,STEP,755611283600,755613804600,2521000,-1
237,1,STEP,755613836800,755616216100,2379300,-1
238,1,STEP,755616248800,755618695200,2446400,-1
239,1,STEP,755618722000,755621094000,2372000,-1
240,1,STEP,755621121900,755623479200,2357300,-1
241,1,STEP,755623503800,755626150100,2646300,-1
242,1,STEP,755626177700,755628518500,2340800,-1
243,1,STEP,755628543000,755631007000,2464000,-1
244,1,STEP,755631034600,755633436900,2402300,-1
245,1,STEP,755633464100,755635787700,2323600,-1
246,1,STEP,755635811800,755638156400,2344600,-1
247,1,STEP,755638180200,755640676700,2496500,-1
248,1,STEP,755640704100,755643049300,2345200,-1
249,1,STEP,755643073500,755645400700,2327200,-1
250,1,STEP,755645424600,755647828200,2403600,-1
251,1,STEP,755647856500,755650208300,2351800,-1
252,1,STEP,755650233200,755652531300,2298100,-1
253,1,STEP,755652555300,755654988400,2433100,-1
254,1,STEP,755655015500,755657270600,2255100,-1
255,1,STEP,755657295000,755659525400,2230400,-1
256,1,STEP,755659560200,755661907800,2347600,-1
257,1,STEP,755661939500,755664278100,2338600,-1
258,1,STEP,755664305300,755666576900,2271600,-1
259,1,STEP,755666601000,755669043700,2442700,-1
260,1,STEP,755669072000,755671517100,2445100,-1
261,1,STEP,755671542900,755674061900,2519000,-1
262,1,STEP,755674086900,755676549200,2462300,-1
263,1,STEP,755676574800,755679006200,2431400,-1
264,1,STEP,755679036200,755681485300,2449100,-1
265,1,STEP,755681514600,755683867800,2353200,-1
266,1,STEP,755683892200,755686212300,2320100,-1
267,1,STEP,755686236200,755688669700,2433500,-1
268,1,STEP,755688706800,755691069100,2362300,-1
269,1,STEP,755691094300,755693622200,2527900,-1
270,1,STEP,755693647600,755696289900,2642300,-1
271,1,STEP,755696328000,755699131600,2803600,-1
272,1,STEP,755699164300,755701951100,2786800,-1
273,1,STEP,755701984400,755704707600,2723200,-1
274,1,STEP,755704734300,755707433500,2699200,-1
275,1,STEP,755707457300,755709972400,2515100,-1
276,1,STEP,755710001000,755712442200,2441200,-1
277,1,STEP,755712469200,755714816300,2347100,-1
278,1,STEP,755714841200,755717288500,2447300,-1
279,1,STEP,755717314100,755719701800,2387700,-1
280,1,STEP,755719726600,755722052500,2325900,-1
281,1,STEP,755722076200,755724453500,2377300,-1
282,1,STEP,755724479700,755726956300,2476600,-1
283,1,STEP,755726984200,755729435500,2451300,-1
284,1,STEP,755729460200,755731856800,2396600,-1
285,1,STEP,755731884800,755734235900,2351100,-1
286,1,STEP,755734259900,755736619900,2360000,-1
287,1,STEP,755736644600,755739110900,2466300,-1
288,1,STEP,755739135400,755741483200,2347800,-1
289,1,STEP,755741508400,755744148800,2640400,-1
290,1,STEP,755744197300,755747018900,2821600,-1
291,1,STEP,755747042900,755749913700,2870800,-1
292,1,STEP,755749939100,755752481300,2542200,-1
293,1,STEP,755752510700,755755220300,2709600,-1
294,1,STEP,755755244800,755757876400,2631600,-1
295,1,STEP,755757912200,755760502400,2590200,-1
296,1,STEP,755760544800,755763035200,2490400,-1
297,1,STEP,755763068700,755765647100,2578400,-1
298,1,STEP,755765704300,755768198000,2493700,-1
299,1,STEP,755768247200,755770698700,2451500,-1
300,1,STEP,755770742700,755773312300,2569600,-1
301,1,STEP,755773363500,755776240400,2876900,-1
302,1,STEP,755776297000,755779166700,2869700,-1
303,1,STEP,755779226800,755782270100,3043300,-1
304,1,STEP,755782308900,755785185900,2877000,-1
305,1,STEP,755785216700,755788019300,2802600,-1
306,1,STEP,755788059400,755790739800,2680400,-1
307,1,STEP,755790775900,755793435100,2659200,-1
308,1,STEP,755793479300,755796073000,2593700,-1
309,1,STEP,755796110500,755798583600,2473100,-1
310,1,STEP,755798622200,755801128300,2506100,-1
311,1,STEP,755801161800,755803480900,2319100,-1
312,1,STEP,755803506400,755806087100,2580700,-1
313,1,STEP,755806116500,755808485600,2369100,-1
314,1,STEP,755808512400,755810867700,2355300,-1
315,1,STEP,755810893800,755813322900,2429100,-1
316,1,STEP,755813351300,755815726500,2375200,-1
317,1,STEP,755815751400,755818072800,2321400,-1
318,1,STEP,755818097400,755820670500,2573100,-1
319,1,STEP,755820702000,755823082800,2380800,-1
320,1,STEP,755823107900,755825461300,2353400,-1
321,1,STEP,755825486000,755827987800,2501800,-1
322,1,STEP,755828015000,755830403400,2388400,-1
323,1,STEP,755830429000,755832777400,2348400,-1
324,1,STEP,755832802600,755835206400,2403800,-1
325,1,STEP,755835233200,755837671000,2437800,-1
326,1,STEP,755837696900,755840021700,2324800,-1
327,1,STEP,755840062400,755842478000,2415600,-1
328,1,STEP,755842505600,755844866500,2360900,-1
329,1,STEP,755844891200,755847293000,2401800,-1
330,1,STEP,755847317700,755849735900,2418200,-1
331,1,STEP,755849765200,755852102300,2337100,-1
332,1,STEP,755852127000,755854696700,2569700,-1
333,1,STEP,755854726100,755857104600,2378500,-1
334,1,STEP,755857130800,755859475500,2344700,-1
335,1,STEP,755859501200,755861896100,2394900,-1
336,1,STEP,755861922000,755864265000,2343000,-1
337,1,STEP,755864290500,755866680800,2390300,-1
338,1,STEP,755866707200,755869414900,2707700,-1
339,1,STEP,755869455900,755872143000,2687100,-1
340,1,STEP,755872168900,755874852300,2683400,-1
341,1,STEP,755874884800,755877640700,2755900,-1
342,1,STEP,755877671000,755880395500,2724500,-1
343,1,STEP,755880422200,755883214700,2792500,-1
344,1,STEP,755883278200,755886001200,2723000,-1
345,1,STEP,755886030000,755888750300,2720300,-1
346,1,STEP,755888775600,755891643600,2868000,-1
347,1,STEP,755891688500,755894414700,2726200,-1
348,1,STEP,755894440800,755897244300,2803500,-1
349,1,STEP,755897275100,755900069300,2794200,-1
350,1,STEP,755900112700,755902835200,2722500,-1
351,1,STEP,755902954900,755905736100,2781200,-1
352,1,STEP,755905772700,755908494700,2722000,-1
353,1,STEP,755908520400,755911346500,2826100,-1
354,1,STEP,755911378600,755914241300,2862700,-1
355,1,STEP,755914272500,755917107600,2835100,-1
356,1,STEP,755917136200,755919953500,2817300,-1
357,1,STEP,755919984900,755922771100,2786200,-1
358,1,STEP,755922800200,755925692900,2892700,-1
359,1,STEP,755925724300,755928482700,2758400,-1
360,1,STEP,755928508100,755931407700,2899600,-1
361,1,STEP,755931443900,755934190500,2746600,-1
362,1,STEP,755934216800,755936935600,2718800,-1
363,1,STEP,755936960600,755939780100,2819500,-1
364,1,STEP,755939811700,755942532600,2720900,-1
365,1,STEP,755942558400,755945396900,2838500,-1
366,1,STEP,755945426900,755948502600,3075700,-1
367,1,STEP,755948530800,755951598500,3067700,-1
368,1,STEP,755951630100,755954467400,2837300,-1
369,1,STEP,755954497000,755957170700,2673700,-1
370,1,STEP,755957195600,755959975800,2780200,-1
371,1,STEP,755960005900,755962710000,2704100,-1
372,1,STEP,755962741500,755965540800,2799300,-1
373,1,STEP,755965578900,755968316700,2737800,-1
374,1,STEP,755968351200,755971050500,2699300,-1
375,1,STEP,755971079800,755973891300,2811500,-1
376,1,STEP,755973923600,755976627900,2704300,-1
377,1,STEP,755976653400,755979415200,2761800,-1
378,1,STEP,755979445600,755982249400,2803800,-1
379,1,STEP,755982283300,755984986900,2703600,-1
380,1,STEP,755985013100,755987801900,2788800,-1
381,1,STEP,755987832400,755990522500,2690100,-1
382,1,STEP,755990549100,755993293700,2744600,-1
383,1,STEP,755993320200,755996158300,2838100,-1
384,1,STEP,755996192900,755998867600,2674700,-1
385,1,STEP,755998893300,756001917300,3024000,-1
386,1,STEP,756001951100,756005166200,3215100,-1
387,1,STEP,756005208100,756008395700,3187600,-1
388,1,STEP,756008433900,756011181700,2747800,-1
389,1,STEP,756011211600,756013920600,2709000,-1
390,1,STEP,756013945900,756016854300,2908400,-1
391,1,STEP,756016884000,756019601500,2717500,-1
392,1,STEP,756019628700,756022358500,2729800,-1
393,1,STEP,756022388200,756025124900,2736700,-1
394,1,STEP,756025151700,756027917300,2765600,-1
395,1,STEP,756027943200,756030686400,2743200,-1
396,1,STEP,756030717200,756033384400,2667200,-1
397,1,STEP,756033409600,756036299500,2889900,-1
398,1,STEP,756036329800,756039031200,2701400,-1
399,1,STEP,756039056600,756041806600,2750000,-1
400,1,STEP,756041833900,756044576100,2742200,-1
401,1,STEP,756044605400,756047306700,2701300,-1
402,1,STEP,756047331500,756050132800,2801300,-1
403,1,STEP,756050172700,756052887700,2715000,-1
404,1,STEP,756052915700,756055609700,2694000,-1
405,1,STEP,756055713300,756059043500,3330200,-1
406,1,STEP,756059081500,756062194200,3112700,-1
407,1,STEP,756062220900,756064989900,2769000,-1
408,1,STEP,756065020100,756067657700,2637600,-1
409,1,STEP,756067681900,756070141500,2459600,-1
410,1,STEP,756070174100,756072970800,2796700,-1
411,1,STEP,756073006400,756075741300,2734900,-1
412,1,STEP,756075765900,756078380600,2614700,-1
413,1,STEP,756078407700,756080958400,2550700,-1
414,1,STEP,756080984000,756083339200,2355200,-1
415,1,STEP,756083362500,756085850000,2487500,-1
416,1,STEP,756085876100,756088239000,2362900,-1
417,1,STEP,756088265800,756090732500,2466700,-1
418,1,STEP,756090759000,756093161800,2402800,-1
419,1,STEP,756093188800,756095519800,2331000,-1
420,1,STEP,756095543700,756097979100,2435400,-1
421,1,STEP,756098007300,756100361900,2354600,-1
422,1,STEP,756100387700,756102730700,2343000,-1
423,1,STEP,756102756000,756105146000,2390000,-1
424,1,STEP,756105174800,756107480000,2305200,-1
425,1,STEP,756107505500,756109963100,2457600,-1
426,1,STEP,756109993600,756112343100,2349500,-1
427,1,STEP,756112393000,756114764900,2371900,-1
428,1,STEP,756114789700,756117097900,2308200,-1
429,1,STEP,756117121400,756119496700,2375300,-1
430,1,STEP,756119524400,756121877900,2353500,-1
431,1,STEP,756121903200,756124219000,2315800,-1
432,1,STEP,756124242600,756126623900,2381300,-1
433,1,STEP,756126650100,756128994800,2344700,-1
434,1,STEP,756129018500,756131348400,2329900,-1
435,1,STEP,756131373200,756133786500,2413300,-1
436,1,STEP,756133814300,756136152200,2337900,-1
437,1,STEP,756136178400,756138544100,2365700,-1
438,1,STEP,756138567800,756140985100,2417300,-1
439,1,STEP,756141015200,756143358000,2342800,-1
440,1,STEP,756143381700,756145746700,2365000,-1
441,1,STEP,756145770800,756148181200,2410400,-1
442,1,STEP,756148208100,756150524000,2315900,-1
443,1,STEP,756150549200,756153200900,2651700,-1
444,1,STEP,756153236800,756155628400,2391600,-1
445,1,STEP,756155655200,756157990000,2334800,-1
446,1,STEP,756158014600,756160468000,2453400,-1
447,1,STEP,756160496600,756162859000,2362400,-1
448,1,STEP,756162885100,756165213900,2328800,-1
449,1,STEP,756165238400,756167693900,2455500,-1
450,1,STEP,756167722800,756170073700,2350900,-1
451,1,STEP,756170099700,756172453700,2354000,-1
452,1,STEP,756172478700,756174891200,2412500,-1
453,1,STEP,756174919100,756177258100,2339000,-1
454,1,STEP,756177285200,756179628300,2343100,-1
455,1,STEP,756179653900,756182421000,2767100,-1
456,1,STEP,756182461700,756185153000,2691300,-1
457,1,STEP,756185181100,756187942900,2761800,-1
458,1,STEP,756187970600,756190812900,2842300,-1
459,1,STEP,756190843900,756193519900,2676000,-1
460,1,STEP,756193545900,756196289800,2743900,-1
461,1,STEP,756196323900,756199040400,2716500,-1
462,1,STEP,756199068300,756201849900,2781600,-1
463,1,STEP,756201879100,756204593800,2714700,-1
464,1,STEP,756204625400,756207343300,2717900,-1
465,1,STEP,756207368700,756210424100,3055400,-1
466,1,STEP,756210459100,756213582600,3123500,-1
467,1,STEP,756213632200,756216738300,3106100,-1
468,1,STEP,756216779800,756219837800,3058000,-1
469,1,STEP,756219884200,756222870700,2986500,-1
470,1,STEP,756223118000,756226337200,3219200,-1
471,1,STEP,756226366100,756229532400,3166300,-1
472,1,STEP,756229566800,756232444900,2878100,-1
473,1,STEP,756232474900,756235327600,2852700,-1
474,1,STEP,756235354200,756238162600,2808400,-1
475,1,STEP,756238192300,756240713800,2521500,-1
476,1,STEP,756240743400,756243391400,2648000,-1
477,1,STEP,756243424700,756245780500,2355800,-1
478,1,STEP,756245816700,756248126800,2310100,-1
479,1,STEP,756248151000,756250616600,2465600,-1
480,1,STEP,756250643600,756253052200,2408600,-1
481,1,STEP,756253078400,756255395900,2317500,-1
482,1,STEP,756255420100,756257820200,2400100,-1
483,1,STEP,756257847200,756260342900,2495700,-1
484,1,STEP,756260378400,756262835100,2456700,-1
485,1,STEP,756262861000,756265279600,2418600,-1
486,1,STEP,756265313100,756267636800,2323700,-1
487,1,STEP,756267662800,756270005300,2342500,-1
488,1,STEP,756270032400,756272424600,2392200,-1
489,1,STEP,756272452700,756274764300,2311600,-1
490,1,STEP,756274789200,756277220400,2431200,-1
491,1,STEP,756277247100,756279622100,2375000,-1
492,1,STEP,756279652700,756281968600,2315900,-1
493,1,STEP,756281993000,756284341700,2348700,-1
494,1,STEP,756284367000,756286743800,2376800,-1
495,1,STEP,756286771300,756289068100,2296800,-1
496,1,STEP,756289092800,756291440600,2347800,-1
497,1,STEP,756291466800,756293991600,2524800,-1
498,1,STEP,756294158500,756296528900,2370400,-1
499,1,STEP,756296557100,756298955300,2398200,-1
500,1,STEP,756298982500,756301345300,2362800,-1
501,1,STEP,756301380300,756303688000,2307700,-1
502,1,STEP,756303713000,756306133000,2420000,-1
503,1,STEP,756306159400,756308605200,2445800,-1
504,1,STEP,756308634900,756310955000,2320100,-1
505,1,STEP,756310981100,756313295400,2314300,-1
506,1,STEP,756313323500,756316095500,2772000,-1
507,1,STEP,756316124600,756318958700,2834100,-1
508,1,STEP,756318989500,756321671000,2681500,-1
509,1,STEP,756321704400,756324369800,2665400,-1
510,1,STEP,756324398400,756327036100,2637700,-1
511,1,STEP,756327062800,756329723200,2660400,-1
512,1,STEP,756329760400,756332393000,2632600,-1
513,1,STEP,756332417900,756334803600,2385700,-1
514,1,STEP,756334833200,756337162900,2329700,-1
515,1,STEP,756337187800,756339563600,2375800,-1
516,1,STEP,756339590800,756342044800,2454000,-1
517,1,STEP,756342082500,756344511200,2428700,-1
518,1,STEP,756344538100,756346931100,2393000,-1
519,1,STEP,756346955400,756349498700,2543300,-1
520,1,STEP,756349542300,756351911000,2368700,-1
521,1,STEP,756351936900,756354514800,2577900,-1
522,1,STEP,756354542900,756357049600,2506700,-1
523,1,STEP,756357088000,756359533900,2445900,-1
524,1,STEP,756359560800,756362368700,2807900,-1
525,1,STEP,756362401700,756365199700,2798000,-1
526,1,STEP,756365224800,756367562500,2337700,-1
527,1,STEP,756367586800,756370044500,2457700,-1
528,1,STEP,756370072800,756372433200,2360400,-1
529,1,STEP,756372460600,756374782700,2322100,-1
530,1,STEP,756374807100,756377251800,2444700,-1
531,1,STEP,756377282500,756379649400,2366900,-1
532,1,STEP,756379675600,756382022600,2347000,-1
533,1,STEP,756382048200,756384432400,2384200,-1
534,1,STEP,756384460800,756386775500,2314700,-1
535,1,STEP,756386799800,756389340200,2540400,-1
536,1,STEP,756389367200,756391809700,2442500,-1
537,1,STEP,756391837000,756394168200,2331200,-1
538,1,STEP,756394192300,756396634600,2442300,-1
539,1,STEP,756396663300,756399015800,2352500,-1
540,1,STEP,756399040000,756401358400,2318400,-1
541,1,STEP,756401384000,756403821100,2437100,-1
542,1,STEP,756403856200,756406237400,2381200,-1
543,1,STEP,756406263900,756408614300,2350400,-1
544,1,STEP,756408638600,756411084100,2445500,-1
545,1,STEP,756411116100,756413517900,2401800,-1
546,1,STEP,756413543000,756415855800,2312800,-1
547,1,STEP,756415879900,756418509600,2629700,-1
548,1,STEP,756418548200,756421258300,2710100,-1
549,1,STEP,756421292500,756423777800,2485300,-1
550,1,STEP,756423806200,756426210300,2404100,-1
551,1,STEP,756426242600,756428627200,2384600,-1
552,1,STEP,756428652100,756431064500,2412400,-1
553,1,STEP,756431094400,756433546700,2452300,-1
554,1,STEP,756433575400,756435905000,2329600,-1
555,1,STEP,756435929600,756438375400,2445800,-1
556,1,STEP,756438404200,756440823800,2419600,-1
557,1,STEP,756440849900,756443163800,2313900,-1
558,1,STEP,756443188200,756445751800,2563600,-1
559,1,STEP,756445780300,756448115200,2334900,-1
560,1,STEP,756448143800,756450513600,2369800,-1
561,1,STEP,756450539400,756452927100,2387700,-1
562,1,STEP,756452957100,756455273300,2316200,-1
563,1,STEP,756455298600,756457642000,2343400,-1
564,1,STEP,756457665800,756460174100,2508300,-1
565,1,STEP,756460205400,756462547400,2342000,-1
566,1,STEP,756462572800,756464944500,2371700,-1
567,1,STEP,756464968900,756467403900,2435000,-1
568,1,STEP,756467441900,756469827500,2385600,-1
569,1,STEP,756469854200,756472190100,2335900,-1
570,1,STEP,756472214400,756475024600,2810200,-1
571,1,STEP,756475071500,756477843300,2771800,-1
572,1,STEP,756477871700,756480627800,2756100,-1
573,1,STEP,756480656000,756483032200,2376200,-1
574,1,STEP,756483066700,756485406200,2339500,-1
575,1,STEP,756485430500,756487813300,2382800,-1
576,1,STEP,756487840000,756490203700,2363700,-1
577,1,STEP,756490228600,756492554500,2325900,-1
578,1,STEP,756492584300,756495043000,2458700,-1
579,1,STEP,756495069300,756497428000,2358700,-1
580,1,STEP,756497454800,756499804300,2349500,-1
581,1,STEP,756499829300,756502299500,2470200,-1
582,1,STEP,756502328600,756504653000,2324400,-1
583,1,STEP,756504677600,756506967100,2289500,-1
584,1,STEP,756506990900,756509484500,2493600,-1
585,1,STEP,756509513100,756511847500,2334400,-1
586,1,STEP,756511872500,756514498800,2626300,-1
587,1,STEP,756514540000,756517422600,2882600,-1
588,1,STEP,756517452200,756520324600,2872400,-1
589,1,STEP,756520357200,756523164800,2807600,-1
590,1,STEP,756523196800,756525867900,2671100,-1
591,1,STEP,756525893000,756528668300,2775300,-1
592,1,STEP,756528711300,756531382100,2670800,-1
593,1,STEP,756531408900,756534106400,2697500,-1
594,1,STEP,756534131100,756536866500,2735400,-1
595,1,STEP,756536894500,756539305700,2411200,-1
596,1,STEP,756539330000,756541963000,2633000,-1
597,1,STEP,756541998100,756544737300,2739200,-1
598,1,STEP,756544772400,756547211300,2438900,-1
599,1,STEP,756547242000,756549883700,2641700,-1
600,1,STEP,756549916000,756552285200,2369200,-1
601,1,STEP,756552311100,756554641200,2330100,-1
602,1,STEP,756554666300,756557138400,2472100,-1
603,1,STEP,756557167300,756559535700,2368400,-1
604,1,STEP,756559561900,756561926200,2364300,-1
605,1,STEP,756561953600,756564485700,2532100,-1
606,1,STEP,756564514300,756566863800,2349500,-1
607,1,STEP,756566888400,756569182000,2293600,-1
608,1,STEP,756569206500,756571705600,2499100,-1
609,1,STEP,756571733800,756574058200,2324400,-1
610,1,STEP,756574083000,756576644200,2561200,-1
611,1,STEP,756576673300,756579071100,2397800,-1
612,1,STEP,756579096600,756581430600,2334000,-1
613,1,STEP,756581457000,756584066400,2609400,-1
614,1,STEP,756584094900,756586795800,2700900,-1
615,1,STEP,756586821200,756589632200,2811000,-1
616,1,STEP,756589657800,756592111700,2453900,-1
617,1,STEP,756592138100,756594494700,2356600,-1
618,1,STEP,756594521400,756596849300,2327900,-1
619,1,STEP,756596874200,756599354200,2480000,-1
620,1,STEP,756599398700,756601744600,2345900,-1
621,1,STEP,756601770300,756604149100,2378800,-1
622,1,STEP,756604173300,756606618500,2445200,-1
623,1,STEP,756606646400,756608966800,2320400,-1
624,1,STEP,756608994200,756611396600,2402400,-1
625,1,STEP,756611422700,756613899800,2477100,-1
626,1,STEP,756613926500,756616290000,2363500,-1
627,1,STEP,756616314800,756618701500,2386700,-1
628,1,STEP,756618729200,756621153100,2423900,-1
629,1,STEP,756621179900,756623490500,2310600,-1
630,1,STEP,756623515000,756626065100,2550100,-1
631,1,STEP,756626098700,756628454200,2355500,-1
632,1,STEP,756628480300,756631097700,2617400,-1
633,1,STEP,756631130300,756633612200,2481900,-1
634,1,STEP,756633644200,756635971500,2327300,-1
635,1,STEP,756635996700,756638348800,2352100,-1
636,1,STEP,756638373700,756640936400,2562700,-1
637,1,STEP,756640974000,756643396500,2422500,-1
638,1,STEP,756643422800,756645784700,2361900,-1
639,1,STEP,756645809300,756648312800,2503500,-1
640,1,STEP,756648341900,756650678200,2336300,-1
641,1,STEP,756650703900,756653163800,2459900,-1
642,1,STEP,756653189400,756655595900,2406500,-1
643,1,STEP,756655623100,756658005500,2382400,-1
644,1,STEP,756658033100,756660722500,2689400,-1
645,1,STEP,756660753800,756663150400,2396600,-1
646,1,STEP,756663175400,756665523900,2348500,-1
647,1,STEP,756665548300,756667968000,2419700,-1
648,1,STEP,756667995700,756670373100,2377400,-1
649,1,STEP,756670398700,756672748100,2349400,-1
650,1,STEP,756672775600,756675244100,2468500,-1
651,1,STEP,756675272100,756677619600,2347500,-1
652,1,STEP,756677644200,756680001800,2357600,-1
653,1,STEP,756680027400,756682625000,2597600,-1
654,1,STEP,756682652900,756684994000,2341100,-1
655,1,STEP,756685018700,756687372900,2354200,-1
656,1,STEP,756687397600,756689869900,2472300,-1
657,1,STEP,756689904800,756692259900,2355100,-1
658,1,STEP,756692285300,756694737500,2452200,-1
659,1,STEP,756694762200,756697163000,2400800,-1
660,1,STEP,756697189500,756699514600,2325100,-1
661,1,STEP,756699539900,756702136000,2596100,-1
662,1,STEP,756702163800,756704821700,2657900,-1
663,1,STEP,756704857100,756707594700,2737600,-1
664,1,STEP,756707620300,756710514700,2894400,-1
665,1,STEP,756710551500,756713314000,2762500,-1
666,1,STEP,756713340100,756716098800,2758700,-1
667,1,STEP,756716128100,756718858400,2730300,-1
668,1,STEP,756718884400,756721792400,2908000,-1
669,1,STEP,756721825300,756724638800,2813500,-1
670,1,STEP,756724670400,756727482800,2812400,-1
671,1,STEP,756727513700,756730369900,2856200,-1
672,1,STEP,756730420800,756733149400,2728600,-1
673,1,STEP,756733176000,756735847000,2671000,-1
674,1,STEP,756735872600,756738431000,2558400,-1
675,1,STEP,756738469400,756741126200,2656800,-1
676,1,STEP,756741153000,756743677700,2524700,-1
677,1,STEP,756743704600,756746443800,2739200,-1
678,1,STEP,756746469200,756749129200,2660000,-1
679,1,STEP,756749153600,756751678100,2524500,-1
680,1,STEP,756751710000,756754439400,2729400,-1
681,1,STEP,756754474500,756757190400,2715900,-1
682,1,STEP,756757217800,756759986700,2768900,-1
683,1,STEP,756760027400,756762707400,2680000,-1
684,1,STEP,756762732700,756765515300,2782600,-1
685,1,STEP,756765545700,756768270100,2724400,-1
686,1,STEP,756768298200,756771069200,2771000,-1
687,1,STEP,756771097400,756773941800,2844400,-1
688,1,STEP,756773972200,756776684100,2711900,-1
689,1,STEP,756776708900,756779487600,2778700,-1
690,1,STEP,756779518500,756782212800,2694300,-1
691,1,STEP,756782238200,756784952600,2714400,-1
692,1,STEP,756784980500,756787840400,2859900,-1
693,1,STEP,756787874000,756790535800,2661800,-1
694,1,STEP,756790563000,756793356200,2793200,-1
695,1,STEP,756793386300,756796088500,2702200,-1
696,1,STEP,756796113300,756798839600,2726300,-1
697,1,STEP,756798866000,756801737700,2871700,-1
698,1,STEP,756801798300,756804554600,2756300,-1
699,1,STEP,756804588300,756807586300,2998000,-1
700,1,STEP,756807637400,756810371700,2734300,-1
701,1,STEP,756810414200,756813297300,2883100,-1
702,1,STEP,756813367700,756816239100,2871400,-1
703,1,STEP,756816290000,756819052800,2762800,-1
704,1,STEP,756819104100,756821931200,2827100,-1
705,1,STEP,756821986500,756824682200,2695700,-1
706,1,STEP,756824717500,756827561000,2843500,-1
707,1,STEP,756827609900,756830358500,2748600,-1
708,1,STEP,756830391500,756833414400,3022900,-1
709,1,STEP,756833463300,756836408700,2945400,-1
710,1,STEP,756836459900,756838945500,2485600,-1
711,1,STEP,756838994800,756841562300,2567500,-1
712,1,STEP,756841626600,756844335700,2709100,-1
713,1,STEP,756844369900,756847299700,2929800,-1
714,1,STEP,756847331000,756849927800,2596800,-1
715,1,STEP,756849963100,756852360600,2397500,-1
716,1,STEP,756852385200,756854771900,2386700,-1
717,1,STEP,756854798800,756857225600,2426800,-1
718,1,STEP,756857251800,756859594400,2342600,-1
719,1,STEP,756859620600,756862187500,2566900,-1
720,1,STEP,756862222100,756864569000,2346900,-1
721,1,STEP,756864594100,756866950600,2356500,-1
722,1,STEP,756866974600,756869467600,2493000,-1
723,1,STEP,756869496200,756871796100,2299900,-1
724,1,STEP,756871820600,756874168000,2347400,-1
725,1,STEP,756874192400,756876582700,2390300,-1
726,1,STEP,756876610100,756878992400,2382300,-1
727,1,STEP,756879018700,756881370800,2352100,-1
728,1,STEP,756881395900,756883773600,2377700,-1
729,1,STEP,756883800500,756886162800,2362300,-1
730,1,STEP,756886187000,756888507400,2320400,-1
731,1,STEP,756888531600,756890982600,2451000,-1
732,1,STEP,756891011200,756893336900,2325700,-1
733,1,STEP,756893362100,756895670500,2308400,-1
734,1,STEP,756895703200,756898162700,2459500,-1
735,1,STEP,756898193300,756900512100,2318800,-1
736,1,STEP,756900538700,756902857500,2318800,-1
737,1,STEP,756902883000,756905311400,2428400,-1
738,1,STEP,756905340100,756907673800,2333700,-1
739,1,STEP,756907698100,756910529800,2831700,-1
740,1,STEP,756910581000,756913778300,3197300,-1
741,1,STEP,756913827000,756916658900,2831900,-1
742,1,STEP,756916690300,756919532200,2841900,-1
743,1,STEP,756919566400,756922335400,2769000,-1
744,1,STEP,756922361400,756925115000,2753600,-1
745,1,STEP,756925144700,756927874500,2729800,-1
746,1,STEP,756927902000,756930618400,2716400,-1
747,1,STEP,756930715900,756933569100,2853200,-1
748,1,STEP,756933600700,756936345100,2744400,-1
749,1,STEP,756936369700,756939074300,2704600,-1
750,1,STEP,756939104800,756941916200,2811400,-1
751,1,STEP,756941953200,756944852400,2899200,-1
752,1,STEP,756944888400,756947670400,2782000,-1
753,1,STEP,756947702700,756950454600,2751900,-1
754,1,STEP,756950482700,756953313500,2830800,-1
755,1,STEP,756953348700,756956077800,2729100,-1
756,1,STEP,756956103300,756958909600,2806300,-1
757,1,STEP,756958939000,756961738500,2799500,-1
758,1,STEP,756961769500,756964483700,2714200,-1
759,1,STEP,756964509600,756967316100,2806500,-1
760,1,STEP,756967346900,756970094500,2747600,-1
761,1,STEP,756970121100,756972897700,2776600,-1
762,1,STEP,756972933900,756975763300,2829400,-1
763,1,STEP,756975807500,756978552100,2744600,-1
764,1,STEP,756978587000,756981371400,2784400,-1
765,1,STEP,756981412300,756984077200,2664900,-1
766,1,STEP,756984102800,756986870000,2767200,-1
767,1,STEP,756986900500,756989646200,2745700,-1
768,1,STEP,756989701400,756992451200,2749800,-1
769,1,STEP,756992479900,756995276400,2796500,-1
770,1,STEP,756995310400,756998029000,2718600,-1
771,1,STEP,756998054400,757000841000,2786600,-1
772,1,STEP,757000871400,757003687400,2816000,-1
773,1,STEP,757003715300,757006468500,2753200,-1
774,1,STEP,757006497400,757009284100,2786700,-1
775,1,STEP,757009317500,757012054200,2736700,-1
776,1,STEP,757012081600,757014819700,2738100,-1
777,1,STEP,757014858900,757017550000,2691100,-1
778,1,STEP,757017576100,757020305800,2729700,-1
779,1,STEP,757020332200,757023202700,2870500,-1
780,1,STEP,757023235500,757025949100,2713600,-1
781,1,STEP,757025974200,757028791400,2817200,-1
782,1,STEP,757028820400,757031571000,2750600,-1
783,1,STEP,757031598300,757034327800,2729500,-1
784,1,STEP,757034353300,757037166600,2813300,-1
785,1,STEP,757037201300,757039936400,2735100,-1
786,1,STEP,757039963400,757042698600,2735200,-1
787,1,STEP,757042727900,757045453400,2725500,-1
788,1,STEP,757045480800,757048302900,2822100,-1
789,1,STEP,757048333200,757051145100,2811900,-1
790,1,STEP,757051181600,757053933200,2751600,-1
791,1,STEP,757053962400,757056755700,2793300,-1
792,1,STEP,757056790900,757059601600,2810700,-1
793,1,STEP,757059629000,757062336300,2707300,-1
794,1,STEP,757062361400,757065124300,2762900,-1
795,1,STEP,757065155500,757067934000,2778500,-1
796,1,STEP,757067961700,757070719800,2758100,-1
797,1,STEP,757070781400,757073492000,2710600,-1
798,1,STEP,757073517600,757076265300,2747700,-1
799,1,STEP,757076289800,757079026600,2736800,-1
800,1,STEP,757079056600,757081759900,2703300,-1
801,1,STEP,757081786400,757084777300,2990900,-1
802,1,STEP,757084811900,757087520000,2708100,-1
803,1,STEP,757087545700,757090288000,2742300,-1
804,1,STEP,757090314100,757093207000,2892900,-1
805,1,STEP,757093235700,757095965700,2730000,-1
806,1,STEP,757095991900,757098765600,2773700,-1
807,1,STEP,757098798500,757101946700,3148200,-1
808,1,STEP,757101976300,757105134000,3157700,-1
809,1,STEP,757105163200,757108190400,3027200,-1
810,1,STEP,757108216600,757111292600,3076000,-1
811,1,STEP,757111319700,757114363400,3043700,-1
812,1,STEP,757114396100,757117198300,2802200,-1
813,1,STEP,757117227000,757120408700,3181700,-1
814,1,STEP,757120452100,757123433300,2981200,-1
815,1,STEP,757123460300,757126266200,2805900,-1
816,1,STEP,757126297100,757129017500,2720400,-1
817,1,STEP,757129043000,757131716100,2673100,-1
818,1,STEP,757131742100,757134465400,2723300,-1
819,1,STEP,757134496700,757137176500,2679800,-1
820,1,STEP,757137201400,757139939200,2737800,-1
821,1,STEP,757139994300,757142715300,2721000,-1
822,1,STEP,757142741500,757145411000,2669500,-1
823,1,STEP,757145435600,757148390800,2955200,-1
824,1,STEP,757148437500,757151726000,3288500,-1
825,1,STEP,757151761900,757154760500,2998600,-1
826,1,STEP,757154792900,757157438200,2645300,-1
827,1,STEP,757157462800,757160013100,2550300,-1
828,1,STEP,757160037200,757162416900,2379700,-1
829,1,STEP,757162441800,757164806800,2365000,-1
830,1,STEP,757164845500,757167447400,2601900,-1
831,1,STEP,757167476400,757169830000,2353600,-1
832,1,STEP,757169866000,757172497300,2631300,-1
833,1,STEP,757172521900,757175298000,2776100,-1
834,1,STEP,757175325700,757177763700,2438000,-1
835,1,STEP,757177788600,757180181100,2392500,-1
836,1,STEP,757180209100,757182691100,2482000,-1
837,1,STEP,757182719000,757185072900,2353900,-1
838,1,STEP,757185098100,757187423700,2325600,-1
839,1,STEP,757187447900,757189965100,2517200,-1
840,1,STEP,757189993500,757192357300,2363800,-1
841,1,STEP,757192382100,757194873400,2491300,-1
842,1,STEP,757194899500,757197386600,2487100,-1
843,1,STEP,757197419200,757199787000,2367800,-1
844,1,STEP,757199813700,757202422200,2608500,-1
845,1,STEP,757202452100,757205004000,2551900,-1
846,1,STEP,757205030300,757207793100,2762800,-1
847,1,STEP,757207817600,757210859500,3041900,-1
848,1,STEP,757210892300,757213597400,2705100,-1
849,1,STEP,757213635600,757216474800,2839200,-1
850,1,STEP,757216506500,757219221700,2715200,-1
851,1,STEP,757219246400,757221991200,2744800,-1
852,1,STEP,757222017600,757225007000,2989400,-1
853,1,STEP,757225058300,757227748300,2690000,-1
854,1,STEP,757227776000,757230552900,2776900,-1
855,1,STEP,757230584000,757233340400,2756400,-1
856,1,STEP,757233366100,757236072800,2706700,-1
857,1,STEP,757236097500,757238556000,2458500,-1
858,1,STEP,757238584100,757241230600,2646500,-1
859,1,STEP,757241256200,757244186700,2930500,-1
860,1,STEP,757244238300,757247088000,2849700,-1
861,1,STEP,757247113600,757249900800,2787200,-1
862,1,STEP,757249925800,757252572300,2646500,-1
863,1,STEP,757252603400,757254968100,2364700,-1
864,1,STEP,757254992600,757257463600,2471000,-1
865,1,STEP,757257488500,757260056900,2568400,-1
866,1,STEP,757260089500,757262402200,2312700,-1
867,1,STEP,757262427000,757264986600,2559600,-1
868,1,STEP,757265032000,757267396100,2364100,-1
869,1,STEP,757267419800,757269752500,2332700,-1
870,1,STEP,757269777400,757272244000,2466600,-1
871,1,STEP,757272271700,757274620200,2348500,-1
872,1,STEP,757274646000,757276981000,2335000,-1
873,1,STEP,757277007600,757279604600,2597000,-1
874,1,STEP,757279648700,757282302400,2653700,-1
875,1,STEP,757282331100,757284741700,2410600,-1
876,1,STEP,757284772800,757287270400,2497600,-1
877,1,STEP,757287302100,757289613700,2311600,-1
878,1,STEP,757289639400,757292303000,2663600,-1
879,1,STEP,757292346800,757294755000,2408200,-1
880,1,STEP,757294781800,757297697800,2916000,-1
881,1,STEP,757297722600,757300573600,2851000,-1
882,1,STEP,757300611300,757303231600,2620300,-1
883,1,STEP,757303264900,757305774500,2509600,-1
884,1,STEP,757305805300,757308278100,2472800,-1
885,1,STEP,757308321500,757310658800,2337300,-1
886,1,STEP,757310685400,757313166400,2481000,-1
887,1,STEP,757313208700,757315596600,2387900,-1
888,1,STEP,757315621900,757317938300,2316400,-1
889,1,STEP,757317961700,757320412400,2450700,-1
890,1,STEP,757320459700,757322871000,2411300,-1
891,1,STEP,757322904200,757325350700,2446500,-1
892,1,STEP,757325374500,757327816100,2441600,-1
893,1,STEP,757327860200,757330175900,2315700,-1
894,1,STEP,757330201700,757332672200,2470500,-1
895,1,STEP,757332697000,757335215900,2518900,-1
896,1,STEP,757335249700,757337616500,2366800,-1
897,1,STEP,757337645300,757340119600,2474300,-1
898,1,STEP,757340145500,757342554200,2408700,-1
899,1,STEP,757342591900,757344961700,2369800,-1
900,1,STEP,757344991500,757347424700,2433200,-1
901,1,STEP,757347451200,757349827600,2376400,-1
902,1,STEP,757349864700,757352308100,2443400,-1
903,1,STEP,757352340700,757354795900,2455200,-1
904,1,STEP,757354843800,757357277100,2433300,-1
905,1,STEP,757357307100,757359623400,2316300,-1
906,1,STEP,757359648100,757362102300,2454200,-1
907,1,STEP,757362129100,757364492900,2363800,-1
908,1,STEP,757364518000,757366850800,2332800,-1
909,1,STEP,757366874300,757369239700,2365400,-1
910,1,STEP,757369284400,757371679100,2394700,-1
911,1,STEP,757371705400,757374041900,2336500,-1
912,1,STEP,757374068800,757376464400,2395600,-1
913,1,STEP,757376490800,757378809700,2318900,-1
914,1,STEP,757378833400,757381168100,2334700,-1
915,1,STEP,757381193200,757383659500,2466300,-1
916,1,STEP,757383688800,757386027300,2338500,-1
917,1,STEP,757386065900,757388380700,2314800,-1
918,1,STEP,757388405800,757390818800,2413000,-1
919,1,STEP,757390847200,757393242300,2395100,-1
920,1,STEP,757393267800,757395640300,2372500,-1
921,1,STEP,757395664700,757398102300,2437600,-1
922,1,STEP,757398132300,757400523800,2391500,-1
923,1,STEP,757400551700,757402961700,2410000,-1
924,1,STEP,757402985800,757405471400,2485600,-1
925,1,STEP,757405502700,757407830500,2327800,-1
926,1,STEP,757407855400,757410266300,2410900,-1
927,1,STEP,757410293300,757412758800,2465500,-1
928,1,STEP,757412784800,757415147400,2362600,-1
929,1,STEP,757415171500,757417628900,2457400,-1
930,1,STEP,757417662200,757419992700,2330500,-1
931,1,STEP,757420019000,757422678300,2659300,-1
932,1,STEP,757422704300,757425532800,2828500,-1
933,1,STEP,757425578400,757427916000,2337600,-1
934,1,STEP,757427943200,757430809000,2865800,-1
935,1,STEP,757430848500,757433565100,2716600,-1
936,1,STEP,757433604500,757436496000,2891500,-1
937,1,STEP,757436524900,757439609100,3084200,-1
938,1,STEP,757439648200,757442818000,3169800,-1
939,1,STEP,757442855100,757445647700,2792600,-1
940,1,STEP,757445690900,757448830000,3139100,-1
941,1,STEP,757448864700,757452085200,3220500,-1
942,1,STEP,757452126000,757455024300,2898300,-1
943,1,STEP,757455061100,757457667400,2606300,-1
944,1,STEP,757457765600,757460406100,2640500,-1
945,1,STEP,757460449500,757463032600,2583100,-1
946,1,STEP,757463066100,757465995100,2929000,-1
947,1,STEP,757466054300,757468601100,2546800,-1
948,1,STEP,757468641200,757471132400,2491200,-1
949,1,STEP,757471162900,757473676100,2513200,-1
950,1,STEP,757473745400,757476274300,2528900,-1
951,1,STEP,757476315300,757479058400,2743100,-1
952,1,STEP,757479109900,757482098400,2988500,-1
953,1,STEP,757482136800,757484540800,2404000,-1
954,1,STEP,757484566900,757486984700,2417800,-1
955,1,STEP,757487014500,757489349500,2335000,-1
956,1,STEP,757489404700,757491783600,2378900,-1
957,1,STEP,757491808300,757494224300,2416000,-1
958,1,STEP,757494256500,757496614700,2358200,-1
959,1,STEP,757496639500,757498956000,2316500,-1
960,1,STEP,757498979900,757501439200,2459300,-1
961,1,STEP,757501470700,757503868500,2397800,-1
962,1,STEP,757503894500,757506247400,2352900,-1
963,1,STEP,757506271800,757508794600,2522800,-1
964,1,STEP,757508823300,757511198500,2375200,-1
965,1,STEP,757511228000,757513532800,2304800,-1
966,1,STEP,757513556900,757515939500,2382600,-1
967,1,STEP,757515965600,757518319700,2354100,-1
968,1,STEP,757518343800,757520686000,2342200,-1
969,1,STEP,757520711100,757523128500,2417400,-1
970,1,STEP,757523156000,757525472200,2316200,-1
971,1,STEP,757525496400,757527834300,2337900,-1
972,1,STEP,757527858800,757530367700,2508900,-1
973,1,STEP,757530397000,757532729200,2332200,-1
974,1,STEP,757532753500,757535148700,2395200,-1
975,1,STEP,757535172700,757538552600,3379900,-1
976,1,STEP,757538585600,757540944200,2358600,-1
977,1,STEP,757540970200,757543421600,2451400,-1
978,1,STEP,757543457000,757545767700,2310700,-1
979,1,STEP,757545800100,757548121200,2321100,-1
980,1,STEP,757548144800,757550546900,2402100,-1
981,1,STEP,757550586900,757552949400,2362500,-1
982,1,STEP,757552974800,757555296600,2321800,-1
983,1,STEP,757555320500,757558220500,2900000,-1
984,1,STEP,757558265300,757560962300,2697000,-1
985,1,STEP,757561003100,757563566600,2563500,-1
986,1,STEP,757563597900,757566030800,2432900,-1
987,1,STEP,757566057300,757568619900,2562600,-1
988,1,STEP,757568644600,757571690700,3046100,-1
989,1,STEP,757571737500,757574592300,2854800,-1
990,1,STEP,757574628100,757577115300,2487200,-1
991,1,STEP,757577142700,757579525700,2383000,-1
992,1,STEP,757579554500,757582225000,2670500,-1
993,1,STEP,757582265400,757584667200,2401800,-1
994,1,STEP,757584694700,757587084600,2389900,-1
995,1,STEP,757587109500,757589513700,2404200,-1
996,1,STEP,757589541800,757592009000,2467200,-1
997,1,STEP,757592039100,757594396200,2357100,-1
998,1,STEP,757594421800,757596760900,2339100,-1
999,1,STEP,757596786000,757599210200,2424200,-1
