Gen,Resource,Stamp,TimeStamp_Start,TimeStamp_End,Duration,Indiv_id
0,1,TransfertToDevice,489303289400,489647366200,344076800,-1
0,1,STEP,489784520100,489800020600,15500500,-1
1,1,STEP,489800067500,489814984000,14916500,-1
2,1,STEP,489815031800,489830032400,15000600,-1
3,1,STEP,489830072300,489845416500,15344200,-1
4,1,STEP,489845458000,489860662900,15204900,-1
5,1,STEP,489860730300,489876293200,15562900,-1
6,1,STEP,489876336800,489891147500,14810700,-1
7,1,STEP,489891189600,489906273100,15083500,-1
8,1,STEP,489906319800,489921680300,15360500,-1
9,1,STEP,489921719400,489936685200,14965800,-1
10,1,STEP,489936752300,489951741600,14989300,-1
11,1,STEP,489951819300,489967002800,15183500,-1
12,1,STEP,489967053700,489982078700,15025000,-1
13,1,STEP,489982128800,489997186600,15057800,-1
14,1,STEP,489997236700,490012209600,14972900,-1
15,1,STEP,490012256800,490027363800,15107000,-1
16,1,STEP,490027439200,490042674800,15235600,-1
17,1,STEP,490042730200,490057561300,14831100,-1
18,1,STEP,490057607500,490072538100,14930600,-1
19,1,STEP,490072599300,490087907100,15307800,-1
20,1,STEP,490087972900,490103353400,15380500,-1
21,1,STEP,490103432200,490118108900,14676700,-1
22,1,STEP,490118180800,490133916900,15736100,-1
23,1,STEP,490133978500,490149217500,15239000,-1
24,1,STEP,490149268900,490164188100,14919200,-1
25,1,STEP,490164239400,490179067800,14828400,-1
26,1,STEP,490179127900,490193816500,14688600,-1
27,1,STEP,490193862900,490209759800,15896900,-1
28,1,STEP,490209805400,490225390300,15584900,-1
29,1,STEP,490225440600,490240687500,15246900,-1
30,1,STEP,490240732100,490255903100,15171000,-1
31,1,STEP,490255958100,490271022300,15064200,-1
32,1,STEP,490271074900,490286131800,15056900,-1
33,1,STEP,490286171500,490301305500,15134000,-1
34,1,STEP,490301356000,490316631600,15275600,-1
35,1,STEP,490316678400,490331629100,14950700,-1
36,1,STEP,490331669900,490346709100,15039200,-1
37,1,STEP,490346767800,490361783600,15015800,-1
38,1,STEP,490361829100,490376929800,15100700,-1
39,1,STEP,490376978300,490391952500,14974200,-1
40,1,STEP,490392006100,490406180200,14174100,-1
41,1,STEP,490406245600,490420693700,14448100,-1
42,1,STEP,490420761700,490435512500,14750800,-1
43,1,STEP,490435561100,490450804400,15243300,-1
44,1,STEP,490450859700,490465890500,15030800,-1
45,1,STEP,490465942400,490481147100,15204700,-1
46,1,STEP,490481201100,490496346500,15145400,-1
47,1,STEP,490496392700,490511784500,15391800,-1
48,1,STEP,490511824100,490527168400,15344300,-1
49,1,STEP,490527227900,490542469300,15241400,-1
50,1,STEP,490542561400,490558018200,15456800,-1
51,1,STEP,490558066300,490573600400,15534100,-1
52,1,STEP,490573648300,490589038800,15390500,-1
53,1,STEP,490589085400,490604400400,15315000,-1
54,1,STEP,490604454900,490620229900,15775000,-1
55,1,STEP,490620270600,490636320600,16050000,-1
56,1,STEP,490636368500,490652434900,16066400,-1
57,1,STEP,490652479700,490668476700,15997000,-1
58,1,STEP,490668520800,490684395200,15874400,-1
59,1,STEP,490684445700,490700107700,15662000,-1
60,1,STEP,490700161200,490715656100,15494900,-1
61,1,STEP,490715719000,490731889700,16170700,-1
62,1,STEP,490731928100,490748014400,16086300,-1
63,1,STEP,490748072000,490764034500,15962500,-1
64,1,STEP,490764086600,490780386700,16300100,-1
65,1,STEP,490780428000,490797198100,16770100,-1
66,1,STEP,490797246600,490814080100,16833500,-1
67,1,STEP,490814146500,490830685600,16539100,-1
68,1,STEP,490830723100,490847684400,16961300,-1
69,1,STEP,490847733800,490864272200,16538400,-1
70,1,STEP,490864310400,490880912100,16601700,-1
71,1,STEP,490880973600,490898194200,17220600,-1
72,1,STEP,490898233800,490914765200,16531400,-1
73,1,STEP,490914804600,490931003400,16198800,-1
74,1,STEP,490931052600,490947935800,16883200,-1
75,1,STEP,490947974800,490964359800,16385000,-1
76,1,STEP,490964415500,490981223600,16808100,-1
77,1,STEP,490981265300,490997681500,16416200,-1
78,1,STEP,490997745200,491014640900,16895700,-1
79,1,STEP,491014691600,491031691800,17000200,-1
80,1,STEP,491031735500,491048719000,16983500,-1
81,1,STEP,491048772400,491065628500,16856100,-1
82,1,STEP,491065666700,491082584100,16917400,-1
83,1,STEP,491082639100,491099414200,16775100,-1
84,1,STEP,491099453500,491116028900,16575400,-1
85,1,STEP,491116071300,491132314800,16243500,-1
86,1,STEP,491132363100,491149316100,16953000,-1
87,1,STEP,491149364300,491166782500,17418200,-1
88,1,STEP,491166822500,491183924400,17101900,-1
89,1,STEP,491183965700,491201259800,17294100,-1
90,1,STEP,491201304400,491218276600,16972200,-1
91,1,STEP,491218316000,491234646100,16330100,-1
92,1,STEP,491234697300,491251327900,16630600,-1
93,1,STEP,491251373100,491267864000,16490900,-1
94,1,STEP,491267905200,491284409300,16504100,-1
95,1,STEP,491284449400,491300576400,16127000,-1
96,1,STEP,491300620500,491316875300,16254800,-1
97,1,STEP,491316925600,491333447100,16521500,-1
98,1,STEP,491333520900,491349554100,16033200,-1
99,1,STEP,491349603500,491365624000,16020500,-1
100,1,STEP,491365673600,491381563300,15889700,-1
101,1,STEP,491381609200,491397925600,16316400,-1
102,1,STEP,491397973600,491414105900,16132300,-1
103,1,STEP,491414153900,491430335200,16181300,-1
104,1,STEP,491430387100,491446444600,16057500,-1
105,1,STEP,491446493600,491462737800,16244200,-1
106,1,STEP,491462782500,491479792500,17010000,-1
107,1,STEP,491479845500,491496641500,16796000,-1
108,1,STEP,491496690400,491513279400,16589000,-1
109,1,STEP,491513330100,491530257200,16927100,-1
110,1,STEP,491530308800,491546843500,16534700,-1
111,1,STEP,491546880300,491563520900,16640600,-1
112,1,STEP,491563563700,491580025800,16462100,-1
113,1,STEP,491580064200,491597197300,17133100,-1
114,1,STEP,491597247800,491614185600,16937800,-1
115,1,STEP,491614225100,491630682000,16456900,-1
116,1,STEP,491630724900,491648029300,17304400,-1
117,1,STEP,491648075200,491665259900,17184700,-1
118,1,STEP,491665322200,491682610200,17288000,-1
119,1,STEP,491682658800,491699816100,17157300,-1
120,1,STEP,491699859500,491717588200,17728700,-1
121,1,STEP,491717635100,491734764900,17129800,-1
122,1,STEP,491734829400,491752130700,17301300,-1
123,1,STEP,491752202000,491769345700,17143700,-1
124,1,STEP,491769394400,491786930700,17536300,-1
125,1,STEP,491786989000,491804619000,17630000,-1
126,1,STEP,491804689500,491822273900,17584400,-1
127,1,STEP,491822319600,491840378400,18058800,-1
128,1,STEP,491840438200,491858079600,17641400,-1
129,1,STEP,491858129100,491875702200,17573100,-1
130,1,STEP,491875747200,491893569100,17821900,-1
131,1,STEP,491893618300,491911005000,17386700,-1
132,1,STEP,491911071400,491929482700,18411300,-1
133,1,STEP,491929534000,491947578100,18044100,-1
134,1,STEP,491947621600,491967105500,19483900,-1
135,1,STEP,491967158800,491985792700,18633900,-1
136,1,STEP,491985839400,492006660300,20820900,-1
137,1,STEP,492006699300,492026915100,20215800,-1
138,1,STEP,492026960200,492048171300,21211100,-1
139,1,STEP,492048235300,492070734300,22499000,-1
140,1,STEP,492070782700,492092379100,21596400,-1
141,1,STEP,492092429200,492113574400,21145200,-1
142,1,STEP,492113616100,492135318900,21702800,-1
143,1,STEP,492135400300,492157771800,22371500,-1
144,1,STEP,492157819300,492179298100,21478800,-1
145,1,STEP,492179341900,492201462600,22120700,-1
146,1,STEP,492201517600,492223761000,22243400,-1
147,1,STEP,492223817600,492245530600,21713000,-1
148,1,STEP,492245599400,492267523400,21924000,-1
149,1,STEP,492267584900,492289640700,22055800,-1
150,1,STEP,492289683900,492311149600,21465700,-1
151,1,STEP,492311223500,492332948500,21725000,-1
152,1,STEP,492332994900,492354198100,21203200,-1
153,1,STEP,492354253200,492375362500,21109300,-1
154,1,STEP,492375424900,492397297400,21872500,-1
155,1,STEP,492397351000,492418984700,21633700,-1
156,1,STEP,492419031100,492440366800,21335700,-1
157,1,STEP,492440441500,492461313400,20871900,-1
158,1,STEP,492461416000,492480656500,19240500,-1
159,1,STEP,492480709500,492500467700,19758200,-1
160,1,STEP,492500517800,492520361000,19843200,-1
161,1,STEP,492520410200,492541020400,20610200,-1
162,1,STEP,492541075500,492560805400,19729900,-1
163,1,STEP,492560847700,492579772200,18924500,-1
164,1,STEP,492579819500,492598065000,18245500,-1
165,1,STEP,492598111600,492616444300,18332700,-1
166,1,STEP,492616492400,492634368400,17876000,-1
167,1,STEP,492634436800,492652243100,17806300,-1
168,1,STEP,492652286100,492670197100,17911000,-1
169,1,STEP,492670234900,492688684300,18449400,-1
170,1,STEP,492688722200,492707449800,18727600,-1
171,1,STEP,492707507000,492725523300,18016300,-1
172,1,STEP,492725566900,492744086100,18519200,-1
173,1,STEP,492744134900,492761993600,17858700,-1
174,1,STEP,492762043700,492780110700,18067000,-1
175,1,STEP,492780159400,492798577900,18418500,-1
176,1,STEP,492798645700,492817133800,18488100,-1
177,1,STEP,492817176900,492835746700,18569800,-1
178,1,STEP,492835799600,492854289800,18490200,-1
179,1,STEP,492854338700,492872240600,17901900,-1
180,1,STEP,492872281500,492890459000,18177500,-1
181,1,STEP,492890506600,492909409200,18902600,-1
182,1,STEP,492909479500,492927950600,18471100,-1
183,1,STEP,492928062200,492945449900,17387700,-1
184,1,STEP,492945521300,492963277600,17756300,-1
185,1,STEP,492963327000,492981616700,18289700,-1
186,1,STEP,492981678300,493000890200,19211900,-1
187,1,STEP,493000951100,493019654400,18703300,-1
188,1,STEP,493019699000,493037188200,17489200,-1
189,1,STEP,493037297500,493055107400,17809900,-1
190,1,STEP,493055170200,493072870700,17700500,-1
191,1,STEP,493072914800,493091618400,18703600,-1
192,1,STEP,493091678600,493109805500,18126900,-1
193,1,STEP,493109866600,493128286600,18420000,-1
194,1,STEP,493128340700,493145815600,17474900,-1
195,1,STEP,493145897600,493164152400,18254800,-1
196,1,STEP,493164197100,493182508500,18311400,-1
197,1,STEP,493182552700,493201305900,18753200,-1
198,1,STEP,493201366000,493219796900,18430900,-1
199,1,STEP,493219845500,493237490200,17644700,-1
200,1,STEP,493237541900,493256026800,18484900,-1
201,1,STEP,493256071200,493273645700,17574500,-1
202,1,STEP,493273691200,493292195200,18504000,-1
203,1,STEP,493292243400,493310482200,18238800,-1
204,1,STEP,493310524000,493327872700,17348700,-1
205,1,STEP,493327917100,493345329300,17412200,-1
206,1,STEP,493345370500,493363386200,18015700,-1
207,1,STEP,493363428400,493381378700,17950300,-1
208,1,STEP,493381436500,493399025500,17589000,-1
209,1,STEP,493399073900,493416727100,17653200,-1
210,1,STEP,493416819500,493434913000,18093500,-1
211,1,STEP,493434954800,493452776500,17821700,-1
212,1,STEP,493452827200,493470769300,17942100,-1
213,1,STEP,493470813000,493488777200,17964200,-1
214,1,STEP,493488823300,493506714700,17891400,-1
215,1,STEP,493506779900,493524281700,17501800,-1
216,1,STEP,493524330400,493542558600,18228200,-1
217,1,STEP,493542615200,493560583300,17968100,-1
218,1,STEP,493560681600,493579832200,19150600,-1
219,1,STEP,493579920300,493597885100,17964800,-1
220,1,STEP,493597942900,493615503100,17560200,-1
221,1,STEP,493615547300,493633071800,17524500,-1
222,1,STEP,493633129000,493650488000,17359000,-1
223,1,STEP,493650527000,493668645400,18118400,-1
224,1,STEP,493668727000,493686940500,18213500,-1
225,1,STEP,493687006500,493705000400,17993900,-1
226,1,STEP,493705040800,493723054800,18014000,-1
227,1,STEP,493723122700,493741604800,18482100,-1
228,1,STEP,493741698800,493759991200,18292400,-1
229,1,STEP,493760045800,493778126500,18080700,-1
230,1,STEP,493778180000,493796479400,18299400,-1
231,1,STEP,493796520700,493813996400,17475700,-1
232,1,STEP,493814045100,493832174800,18129700,-1
233,1,STEP,493832235400,493849667900,17432500,-1
234,1,STEP,493849718400,493867715400,17997000,-1
235,1,STEP,493867785100,493885537600,17752500,-1
236,1,STEP,493885585100,493903457500,17872400,-1
237,1,STEP,493903502800,493921988200,18485400,-1
238,1,STEP,493922045200,493939797900,17752700,-1
239,1,STEP,493939847300,493958628700,18781400,-1
240,1,STEP,493958675200,493977136500,18461300,-1
241,1,STEP,493977176000,493994621800,17445800,-1
242,1,STEP,493994664500,494012777100,18112600,-1
243,1,STEP,494012858300,494030983200,18124900,-1
244,1,STEP,494031023000,494049110800,18087800,-1
245,1,STEP,494049168100,494066983800,17815700,-1
246,1,STEP,494067023600,494084991400,17967800,-1
247,1,STEP,494085033800,494102394700,17360900,-1
248,1,STEP,494102438000,494119956100,17518100,-1
249,1,STEP,494120001900,494137418400,17416500,-1
250,1,STEP,494137513200,494155584300,18071100,-1
251,1,STEP,494155646700,494174370200,18723500,-1
252,1,STEP,494174470100,494191768200,17298100,-1
253,1,STEP,494191810700,494209991700,18181000,-1
254,1,STEP,494210032700,494228356800,18324100,-1
255,1,STEP,494228405000,494245885800,17480800,-1
256,1,STEP,494245934400,494264005300,18070900,-1
257,1,STEP,494264056700,494281628700,17572000,-1
258,1,STEP,494281669800,494299861000,18191200,-1
259,1,STEP,494299901300,494317708500,17807200,-1
260,1,STEP,494317765300,494335055200,17289900,-1
261,1,STEP,494335109900,494353095300,17985400,-1
262,1,STEP,494353180600,494371505100,18324500,-1
263,1,STEP,494371549000,494389563800,18014800,-1
264,1,STEP,494389617400,494408022400,18405000,-1
265,1,STEP,494408073900,494426055200,17981300,-1
266,1,STEP,494426100200,494444275100,18174900,-1
267,1,STEP,494444328000,494462737600,18409600,-1
268,1,STEP,494462777700,494480870500,18092800,-1
269,1,STEP,494480936600,494499031700,18095100,-1
270,1,STEP,494499085800,494517047500,17961700,-1
271,1,STEP,494517085600,494534607000,17521400,-1
272,1,STEP,494534656400,494552623200,17966800,-1
273,1,STEP,494552670900,494571066100,18395200,-1
274,1,STEP,494571112500,494589625800,18513300,-1
275,1,STEP,494589685400,494607542300,17856900,-1
276,1,STEP,494607590800,494625990800,18400000,-1
277,1,STEP,494626039800,494644166500,18126700,-1
278,1,STEP,494644221300,494662057900,17836600,-1
279,1,STEP,494662101100,494680283100,18182000,-1
280,1,STEP,494680368500,494698225700,17857200,-1
281,1,STEP,494698268900,494715684200,17415300,-1
282,1,STEP,494715728000,494733340400,17612400,-1
283,1,STEP,494733379300,494751893000,18513700,-1
284,1,STEP,494751941900,494769378300,17436400,-1
285,1,STEP,494769425600,494787530600,18105000,-1
286,1,STEP,494787572300,494805535100,17962800,-1
287,1,STEP,494805596100,494823789400,18193300,-1
288,1,STEP,494823832900,494841549100,17716200,-1
289,1,STEP,494841593700,494859456700,17863000,-1
290,1,STEP,494859499400,494877465000,17965600,-1
291,1,STEP,494877550500,494895843900,18293400,-1
292,1,STEP,494895905600,494913924100,18018500,-1
293,1,STEP,494913967100,494932388200,18421100,-1
294,1,STEP,494932431100,494950387500,17956400,-1
295,1,STEP,494950431000,494969453400,19022400,-1
296,1,STEP,494969493600,494988221800,18728200,-1
297,1,STEP,494988267900,495006374000,18106100,-1
298,1,STEP,495006434800,495024404500,17969700,-1
299,1,STEP,495024440500,495042490700,18050200,-1
300,1,STEP,495042538400,495060570300,18031900,-1
301,1,STEP,495060614700,495079120900,18506200,-1
302,1,STEP,495079163500,495097157900,17994400,-1
303,1,STEP,495097203100,495115325400,18122300,-1
304,1,STEP,495115366700,495133610000,18243300,-1
305,1,STEP,495133686200,495152012800,18326600,-1
306,1,STEP,495152108800,495170699900,18591100,-1
307,1,STEP,495170750700,495188843000,18092300,-1
308,1,STEP,495188912100,495206887000,17974900,-1
309,1,STEP,495206958700,495225854700,18896000,-1
310,1,STEP,495225921100,495243638800,17717700,-1
311,1,STEP,495243693100,495260942300,17249200,-1
312,1,STEP,495260992400,495279125000,18132600,-1
313,1,STEP,495279182200,495296819200,17637000,-1
314,1,STEP,495296864800,495314673200,17808400,-1
315,1,STEP,495314723700,495333383700,18660000,-1
316,1,STEP,495333437300,495351648400,18211100,-1
317,1,STEP,495351689900,495369867600,18177700,-1
318,1,STEP,495369916900,495388567600,18650700,-1
319,1,STEP,495388616100,495406960500,18344400,-1
320,1,STEP,495407007200,495424991100,17983900,-1
321,1,STEP,495425029100,495442580600,17551500,-1
322,1,STEP,495442619600,495460189100,17569500,-1
323,1,STEP,495460226600,495477954100,17727500,-1
324,1,STEP,495478082100,495496068400,17986300,-1
325,1,STEP,495496147600,495513414600,17267000,-1
326,1,STEP,495513472400,495531298800,17826400,-1
327,1,STEP,495531355700,495550160300,18804600,-1
328,1,STEP,495550223200,495568045600,17822400,-1
329,1,STEP,495568096300,495586083500,17987200,-1
330,1,STEP,495586128600,495603644000,17515400,-1
331,1,STEP,495603691500,495621696000,18004500,-1
332,1,STEP,495621742700,495639894100,18151400,-1
333,1,STEP,495639947700,495658453200,18505500,-1
334,1,STEP,495658514500,495676135700,17621200,-1
335,1,STEP,495676197200,495693535800,17338600,-1
336,1,STEP,495693594600,495711457200,17862600,-1
337,1,STEP,495711507600,495729242100,17734500,-1
338,1,STEP,495729278700,495747173600,17894900,-1
339,1,STEP,495747209600,495765031300,17821700,-1
340,1,STEP,495765087400,495783607700,18520300,-1
341,1,STEP,495783669000,495801606900,17937900,-1
342,1,STEP,495801644200,495819200100,17555900,-1
343,1,STEP,495819235800,495837252900,18017100,-1
344,1,STEP,495837289000,495854858800,17569800,-1
345,1,STEP,495854899600,495873409300,18509700,-1
346,1,STEP,495873462200,495891861500,18399300,-1
347,1,STEP,495891945700,495909957400,18011700,-1
348,1,STEP,495910020700,495928500700,18480000,-1
349,1,STEP,495928534500,495947070900,18536400,-1
350,1,STEP,495947114900,495965352700,18237800,-1
351,1,STEP,495965399800,495983374300,17974500,-1
352,1,STEP,495983406000,496001000000,17594000,-1
353,1,STEP,496001043000,496019080900,18037900,-1
354,1,STEP,496019116900,496037255500,18138600,-1
355,1,STEP,496037293500,496055124800,17831300,-1
356,1,STEP,496055169700,496072786400,17616700,-1
357,1,STEP,496072828800,496091283900,18455100,-1
358,1,STEP,496091323100,496108908700,17585600,-1
359,1,STEP,496108950100,496127436700,18486600,-1
360,1,STEP,496127485400,496145118500,17633100,-1
361,1,STEP,496145196000,496163040500,17844500,-1
362,1,STEP,496163114600,496180584700,17470100,-1
363,1,STEP,496180641500,496198300200,17658700,-1
364,1,STEP,496198342900,496216544000,18201100,-1
365,1,STEP,496216648900,496235560500,18911600,-1
366,1,STEP,496235690400,496254259700,18569300,-1
367,1,STEP,496254310000,496272401100,18091100,-1
368,1,STEP,496272459600,496290896500,18436900,-1
369,1,STEP,496290965200,496308995700,18030500,-1
370,1,STEP,496309087100,496327468800,18381700,-1
371,1,STEP,496327527900,496345139800,17611900,-1
372,1,STEP,496345198700,496363054000,17855300,-1
373,1,STEP,496363101400,496380680000,17578600,-1
374,1,STEP,496380727600,496399374200,18646600,-1
375,1,STEP,496399444300,496417546800,18102500,-1
376,1,STEP,496417604500,496435171400,17566900,-1
377,1,STEP,496435211200,496452715500,17504300,-1
378,1,STEP,496452770800,496471271900,18501100,-1
379,1,STEP,496471330000,496489499500,18169500,-1
380,1,STEP,496489563500,496508164200,18600700,-1
381,1,STEP,496508232100,496526784100,18552000,-1
382,1,STEP,496526839900,496544522700,17682800,-1
383,1,STEP,496544583700,496562602900,18019200,-1
384,1,STEP,496562664900,496580233000,17568100,-1
385,1,STEP,496580282100,496598971300,18689200,-1
386,1,STEP,496599024400,496617597400,18573000,-1
387,1,STEP,496617646500,496636127500,18481000,-1
388,1,STEP,496636183900,496654103800,17919900,-1
389,1,STEP,496654154800,496672225300,18070500,-1
390,1,STEP,496672280900,496690665300,18384400,-1
391,1,STEP,496690731900,496708407100,17675200,-1
392,1,STEP,496708476100,496726568900,18092800,-1
393,1,STEP,496726626200,496744741300,18115100,-1
394,1,STEP,496744793900,496762421100,17627200,-1
395,1,STEP,496762465700,496780333000,17867300,-1
396,1,STEP,496780391900,496798267500,17875600,-1
397,1,STEP,496798321000,496816022000,17701000,-1
398,1,STEP,496816071100,496834548400,18477300,-1
399,1,STEP,496834596100,496852490500,17894400,-1
400,1,STEP,496852532200,496870642300,18110100,-1
401,1,STEP,496870707500,496888415200,17707700,-1
402,1,STEP,496888455400,496906432300,17976900,-1
403,1,STEP,496906487800,496924293300,17805500,-1
404,1,STEP,496924352500,496942916100,18563600,-1
405,1,STEP,496942960400,496961162300,18201900,-1
406,1,STEP,496961252900,496979032600,17779700,-1
407,1,STEP,496979087000,496996431700,17344700,-1
408,1,STEP,496996474400,497014057600,17583200,-1
409,1,STEP,497014103800,497032162700,18058900,-1
410,1,STEP,497032201500,497050412300,18210800,-1
411,1,STEP,497050461500,497068329900,17868400,-1
412,1,STEP,497068374300,497085902300,17528000,-1
413,1,STEP,497085964700,497103466200,17501500,-1
414,1,STEP,497103511900,497121396900,17885000,-1
415,1,STEP,497121439400,497138817500,17378100,-1
416,1,STEP,497138878500,497157147700,18269200,-1
417,1,STEP,497157192400,497174848900,17656500,-1
418,1,STEP,497175045500,497193091600,18046100,-1
419,1,STEP,497193165700,497210797300,17631600,-1
420,1,STEP,497210862200,497229056900,18194700,-1
421,1,STEP,497229110200,497247106100,17995900,-1
422,1,STEP,497247172900,497265320100,18147200,-1
423,1,STEP,497265365700,497283519100,18153400,-1
424,1,STEP,497283579200,497301754500,18175300,-1
425,1,STEP,497301802700,497319124500,17321800,-1
426,1,STEP,497319184600,497337249000,18064400,-1
427,1,STEP,497337305400,497355220000,17914600,-1
428,1,STEP,497355292200,497373020800,17728600,-1
429,1,STEP,497373070800,497390896100,17825300,-1
430,1,STEP,497390959500,497408782600,17823100,-1
431,1,STEP,497408835500,497426412200,17576700,-1
432,1,STEP,497426460300,497444493200,18032900,-1
433,1,STEP,497444573200,497462950800,18377600,-1
434,1,STEP,497462992200,497480651000,17658800,-1
435,1,STEP,497480700400,497498977000,18276600,-1
436,1,STEP,497499035800,497517055200,18019400,-1
437,1,STEP,497517110500,497535148000,18037500,-1
438,1,STEP,497535209400,497552676100,17466700,-1
439,1,STEP,497552723200,497570642400,17919200,-1
440,1,STEP,497570710400,497588655200,17944800,-1
441,1,STEP,497588705200,497606966300,18261100,-1
442,1,STEP,497607020900,497624874600,17853700,-1
443,1,STEP,497624943900,497643031300,18087400,-1
444,1,STEP,497643094700,497660761600,17666900,-1
445,1,STEP,497660816600,497679273700,18457100,-1
446,1,STEP,497679337000,497696967800,17630800,-1
447,1,STEP,497697020400,497714602000,17581600,-1
448,1,STEP,497714663900,497732322300,17658400,-1
449,1,STEP,497732371400,497750285500,17914100,-1
450,1,STEP,497750343100,497768518800,18175700,-1
451,1,STEP,497768580200,497786634300,18054100,-1
452,1,STEP,497786724400,497804782300,18057900,-1
453,1,STEP,497804841700,497823730300,18888600,-1
454,1,STEP,497823783700,497840949000,17165300,-1
455,1,STEP,497841033800,497859585800,18552000,-1
456,1,STEP,497859629000,497878223400,18594400,-1
457,1,STEP,497878267700,497896068800,17801100,-1
458,1,STEP,497896121400,497914557900,18436500,-1
459,1,STEP,497914599800,497932266300,17666500,-1
460,1,STEP,497932316300,497950051800,17735500,-1
461,1,STEP,497950091800,497967798600,17706800,-1
462,1,STEP,497967845100,497985783100,17938000,-1
463,1,STEP,497985861500,498004260900,18399400,-1
464,1,STEP,498004368100,498023914500,19546400,-1
465,1,STEP,498024004200,498041769800,17765600,-1
466,1,STEP,498041816800,498060311400,18494600,-1
467,1,STEP,498060353100,498077862500,17509400,-1
468,1,STEP,498077906800,498096070300,18163500,-1
469,1,STEP,498096120700,498113903900,17783200,-1
470,1,STEP,498113947200,498132362200,18415000,-1
471,1,STEP,498132428400,498150413200,17984800,-1
472,1,STEP,498150467200,498168013100,17545900,-1
473,1,STEP,498168066900,498187027100,18960200,-1
474,1,STEP,498187075200,498205800700,18725500,-1
475,1,STEP,498205843100,498223434900,17591800,-1
476,1,STEP,498223479200,498241802600,18323400,-1
477,1,STEP,498241849100,498259818200,17969100,-1
478,1,STEP,498259865000,498278083900,18218900,-1
479,1,STEP,498278131000,498296570200,18439200,-1
480,1,STEP,498296608200,498314563000,17954800,-1
481,1,STEP,498314610800,498333015400,18404600,-1
482,1,STEP,498333087100,498351662200,18575100,-1
483,1,STEP,498351705300,498369867400,18162100,-1
484,1,STEP,498369912300,498388386800,18474500,-1
485,1,STEP,498388445400,498406955100,18509700,-1
486,1,STEP,498407005900,498425368500,18362600,-1
487,1,STEP,498425420500,498443336800,17916300,-1
488,1,STEP,498443390000,498461732200,18342200,-1
489,1,STEP,498461772400,498480121700,18349300,-1
490,1,STEP,498480167600,498498301800,18134200,-1
491,1,STEP,498498346800,498517203600,18856800,-1
492,1,STEP,498517250900,498535864400,18613500,-1
493,1,STEP,498535906500,498553749100,17842600,-1
494,1,STEP,498553787200,498571681100,17893900,-1
495,1,STEP,498571728700,498589559100,17830400,-1
496,1,STEP,498589599200,498607650500,18051300,-1
497,1,STEP,498607694400,498626217500,18523100,-1
498,1,STEP,498626262700,498644478000,18215300,-1
499,1,STEP,498644540900,498662868200,18327300,-1
500,1,STEP,498664054800,498681993500,17938700,-1
501,1,STEP,498682043600,498700061100,18017500,-1
502,1,STEP,498700121100,498718428600,18307500,-1
503,1,STEP,498718478300,498736293900,17815600,-1
504,1,STEP,498736342100,498754131400,17789300,-1
505,1,STEP,498754181200,498772273300,18092100,-1
506,1,STEP,498772324700,498789462900,17138200,-1
507,1,STEP,498789509100,498807146300,17637200,-1
508,1,STEP,498807196400,498825331800,18135400,-1
509,1,STEP,498825408800,498843516600,18107800,-1
510,1,STEP,498843581200,498861360800,17779600,-1
511,1,STEP,498861413800,498879048800,17635000,-1
512,1,STEP,498879095900,498897139200,18043300,-1
513,1,STEP,498897184400,498915427300,18242900,-1
514,1,STEP,498915475000,498933220500,17745500,-1
515,1,STEP,498933267600,498950588800,17321200,-1
516,1,STEP,498950640900,498968814600,18173700,-1
517,1,STEP,498968857200,498987279400,18422200,-1
518,1,STEP,498987326700,499005582100,18255400,-1
519,1,STEP,499005628600,499023240100,17611500,-1
520,1,STEP,499023304500,499041471800,18167300,-1
521,1,STEP,499041516400,499060205600,18689200,-1
522,1,STEP,499060245100,499079002000,18756900,-1
523,1,STEP,499079064000,499096454100,17390100,-1
524,1,STEP,499096519300,499114663300,18144000,-1
525,1,STEP,499114718400,499133224700,18506300,-1
526,1,STEP,499133269600,499151847400,18577800,-1
527,1,STEP,499151905800,499169284700,17378900,-1
528,1,STEP,499169325500,499187182000,17856500,-1
529,1,STEP,499187247700,499205338600,18090900,-1
530,1,STEP,499205378800,499222838900,17460100,-1
531,1,STEP,499222878500,499241926300,19047800,-1
532,1,STEP,499241978500,499260730700,18752200,-1
533,1,STEP,499260773400,499279037700,18264300,-1
534,1,STEP,499279080600,499296550300,17469700,-1
535,1,STEP,499296590500,499314810700,18220200,-1
536,1,STEP,499314853200,499334155800,19302600,-1
537,1,STEP,499334193200,499352833100,18639900,-1
538,1,STEP,499352881600,499370842500,17960900,-1
539,1,STEP,499370884000,499389417900,18533900,-1
540,1,STEP,499389463400,499407652900,18189500,-1
541,1,STEP,499407691400,499425610300,17918900,-1
542,1,STEP,499425662800,499444317200,18654400,-1
543,1,STEP,499444368300,499462552400,18184100,-1
544,1,STEP,499462604700,499481097200,18492500,-1
545,1,STEP,499481160100,499499124200,17964100,-1
546,1,STEP,499499170400,499517145700,17975300,-1
547,1,STEP,499517180800,499535226900,18046100,-1
548,1,STEP,499535277000,499554454900,19177900,-1
549,1,STEP,499554495900,499573049900,18554000,-1
550,1,STEP,499573093700,499591457200,18363500,-1
551,1,STEP,499591505100,499610160400,18655300,-1
552,1,STEP,499610217300,499628361700,18144400,-1
553,1,STEP,499628396400,499646455800,18059400,-1
554,1,STEP,499646493600,499664671600,18178000,-1
555,1,STEP,499664701700,499683007900,18306200,-1
556,1,STEP,499683057100,499700932000,17874900,-1
557,1,STEP,499700981700,499719001000,18019300,-1
558,1,STEP,499719041600,499737796500,18754900,-1
559,1,STEP,499737832800,499755994400,18161600,-1
560,1,STEP,499756045200,499774107000,18061800,-1
561,1,STEP,499774163500,499792699200,18535700,-1
562,1,STEP,499792763000,499810739400,17976400,-1
563,1,STEP,499810807200,499828226800,17419600,-1
564,1,STEP,499828279900,499846140900,17861000,-1
565,1,STEP,499846207000,499864157000,17950000,-1
566,1,STEP,499864213300,499884033900,19820600,-1
567,1,STEP,499884084500,499901887300,17802800,-1
568,1,STEP,499901939900,499919773500,17833600,-1
569,1,STEP,499919817400,499937147400,17330000,-1
570,1,STEP,499937197000,499955023500,17826500,-1
571,1,STEP,499955075700,499972995500,17919800,-1
572,1,STEP,499973038000,499991652200,18614200,-1
573,1,STEP,499991700200,500010121600,18421400,-1
574,1,STEP,500010165000,500028842400,18677400,-1
575,1,STEP,500028888700,500047069200,18180500,-1
576,1,STEP,500047122700,500065397800,18275100,-1
577,1,STEP,500065439300,500084728300,19289000,-1
578,1,STEP,500084774900,500103494200,18719300,-1
579,1,STEP,500103539000,500122330900,18791900,-1
580,1,STEP,500122373200,500140794700,18421500,-1
581,1,STEP,500140840300,500159009100,18168800,-1
582,1,STEP,500159066900,500176727300,17660400,-1
583,1,STEP,500176771900,500195423400,18651500,-1
584,1,STEP,500195479800,500213389200,17909400,-1
585,1,STEP,500213452200,500231315800,17863600,-1
586,1,STEP,500231363800,500249822400,18458600,-1
587,1,STEP,500249888500,500267579900,17691400,-1
588,1,STEP,500267626900,500285550100,17923200,-1
589,1,STEP,500285601800,500303679100,18077300,-1
590,1,STEP,500303721400,500322006700,18285300,-1
591,1,STEP,500322048100,500340709600,18661500,-1
592,1,STEP,500340757300,500360016700,19259400,-1
593,1,STEP,500360060900,500378831100,18770200,-1
594,1,STEP,500378877500,500397553000,18675500,-1
595,1,STEP,500397594900,500415574700,17979800,-1
596,1,STEP,500415631000,500433664700,18033700,-1
597,1,STEP,500433706400,500452611100,18904700,-1
598,1,STEP,500452669000,500471911200,19242200,-1
599,1,STEP,500471976400,500490168500,18192100,-1
600,1,STEP,500490253000,500508808300,18555300,-1
601,1,STEP,500508865900,500527747600,18881700,-1
602,1,STEP,500527898800,500546744200,18845400,-1
603,1,STEP,500546787200,500565753900,18966700,-1
604,1,STEP,500565812300,500584559500,18747200,-1
605,1,STEP,500584611700,500602796600,18184900,-1
606,1,STEP,500602843000,500621516000,18673000,-1
607,1,STEP,500621569700,500639746200,18176500,-1
608,1,STEP,500639805400,500657560800,17755400,-1
609,1,STEP,500657600500,500676389700,18789200,-1
610,1,STEP,500676435200,500694736500,18301300,-1
611,1,STEP,500694788900,500713105900,18317000,-1
612,1,STEP,500713150900,500731271500,18120600,-1
613,1,STEP,500731314700,500750031000,18716300,-1
614,1,STEP,500750075000,500768267900,18192900,-1
615,1,STEP,500768320400,500787071600,18751200,-1
616,1,STEP,500787120300,500806381000,19260700,-1
617,1,STEP,500806422200,500825157300,18735100,-1
618,1,STEP,500825285800,500843072300,17786500,-1
619,1,STEP,500843118500,500862339000,19220500,-1
620,1,STEP,500862456000,500881501100,19045100,-1
621,1,STEP,500881570300,500899316000,17745700,-1
622,1,STEP,500899362100,500917895400,18533300,-1
623,1,STEP,500917957000,500936816300,18859300,-1
624,1,STEP,500936866700,500955324100,18457400,-1
625,1,STEP,500955367700,500973223800,17856100,-1
626,1,STEP,500973269300,500991569900,18300600,-1
627,1,STEP,500991610900,501009630800,18019900,-1
628,1,STEP,501009677100,501027584400,17907300,-1
629,1,STEP,501027627000,501044941200,17314200,-1
630,1,STEP,501044985800,501063104600,18118800,-1
631,1,STEP,501063162900,501081469300,18306400,-1
632,1,STEP,501081509000,501099853900,18344900,-1
633,1,STEP,501099897400,501118778000,18880600,-1
634,1,STEP,501118846800,501136651200,17804400,-1
635,1,STEP,501136698300,501154816800,18118500,-1
636,1,STEP,501154865300,501173092800,18227500,-1
637,1,STEP,501173152500,501191407300,18254800,-1
638,1,STEP,501191446700,501210047500,18600800,-1
639,1,STEP,501210093400,501228243800,18150400,-1
640,1,STEP,501228291300,501246430600,18139300,-1
641,1,STEP,501246474300,501264989000,18514700,-1
642,1,STEP,501265075700,501284236000,19160300,-1
643,1,STEP,501284281800,501303086400,18804600,-1
644,1,STEP,501303128100,501321493900,18365800,-1
645,1,STEP,501321535900,501340399300,18863400,-1
646,1,STEP,501340480800,501359368600,18887800,-1
647,1,STEP,501359408200,501377303800,17895600,-1
648,1,STEP,501377367200,501395960200,18593000,-1
649,1,STEP,501396052200,501413546500,17494300,-1
650,1,STEP,501413611300,501431648800,18037500,-1
651,1,STEP,501431727700,501448972100,17244400,-1
652,1,STEP,501449046800,501467275900,18229100,-1
653,1,STEP,501467351900,501485411000,18059100,-1
654,1,STEP,501485460800,501503804400,18343600,-1
655,1,STEP,501503869500,501521532800,17663300,-1
656,1,STEP,501521599600,501539941700,18342100,-1
657,1,STEP,501540027100,501559741100,19714000,-1
658,1,STEP,501559799700,501578530700,18731000,-1
659,1,STEP,501578613500,501597169200,18555700,-1
660,1,STEP,501597236400,501615799300,18562900,-1
661,1,STEP,501615895900,501634211400,18315500,-1
662,1,STEP,501634279400,501652225400,17946000,-1
663,1,STEP,501652292000,501670489700,18197700,-1
664,1,STEP,501670554600,501689147500,18592900,-1
665,1,STEP,501689205900,501707038500,17832600,-1
666,1,STEP,501707107800,501725808700,18700900,-1
667,1,STEP,501725854900,501744468800,18613900,-1
668,1,STEP,501744515000,501763171400,18656400,-1
669,1,STEP,501763243700,501782085500,18841800,-1
670,1,STEP,501782123300,501800320000,18196700,-1
671,1,STEP,501800365100,501818328400,17963300,-1
672,1,STEP,501818382700,501836415200,18032500,-1
673,1,STEP,501836459500,501855216900,18757400,-1
674,1,STEP,501855260200,501873400500,18140300,-1
675,1,STEP,501873442300,501891495900,18053600,-1
676,1,STEP,501891543100,501909222500,17679400,-1
677,1,STEP,501909271500,501927710600,18439100,-1
678,1,STEP,501927753500,501946236000,18482500,-1
679,1,STEP,501946278800,501964259500,17980700,-1
680,1,STEP,501964307300,501983017800,18710500,-1
681,1,STEP,501983062200,502002633300,19571100,-1
682,1,STEP,502002681000,502020818100,18137100,-1
683,1,STEP,502020900000,502039547600,18647600,-1
684,1,STEP,502039587000,502058268100,18681100,-1
685,1,STEP,502058312600,502076454700,18142100,-1
686,1,STEP,502076508700,502093685000,17176300,-1
687,1,STEP,502093754000,502111732100,17978100,-1
688,1,STEP,502111816500,502129977400,18160900,-1
689,1,STEP,502130049800,502148262000,18212200,-1
690,1,STEP,502148343400,502166684500,18341100,-1
691,1,STEP,502166751700,502185230100,18478400,-1
692,1,STEP,502185347800,502203287500,17939700,-1
693,1,STEP,502203339300,502221636900,18297600,-1
694,1,STEP,502221687400,502239668500,17981100,-1
695,1,STEP,502239723200,502257563300,17840100,-1
696,1,STEP,502257666300,502275936200,18269900,-1
697,1,STEP,502275980000,502294685100,18705100,-1
698,1,STEP,502294731800,502313314700,18582900,-1
699,1,STEP,502313362600,502331484500,18121900,-1
700,1,STEP,502331530400,502349143800,17613400,-1
701,1,STEP,502349184600,502367237800,18053200,-1
702,1,STEP,502367282600,502385465800,18183200,-1
703,1,STEP,502385547300,502403415800,17868500,-1
704,1,STEP,502403478100,502421265900,17787800,-1
705,1,STEP,502421305300,502439281000,17975700,-1
706,1,STEP,502439325000,502457254900,17929900,-1
707,1,STEP,502457302500,502475215000,17912500,-1
708,1,STEP,502475258100,502493316600,18058500,-1
709,1,STEP,502493364300,502511221900,17857600,-1
710,1,STEP,502511283100,502529541700,18258600,-1
711,1,STEP,502529593300,502547227300,17634000,-1
712,1,STEP,502547283200,502565495800,18212600,-1
713,1,STEP,502565563600,502584329000,18765400,-1
714,1,STEP,502584441300,502602107000,17665700,-1
715,1,STEP,502602169100,502619907100,17738000,-1
716,1,STEP,502620026600,502638061300,18034700,-1
717,1,STEP,502638148000,502657119500,18971500,-1
718,1,STEP,502657170900,502675868100,18697200,-1
719,1,STEP,502675928000,502694277800,18349800,-1
720,1,STEP,502694410600,502712495100,18084500,-1
721,1,STEP,502712557500,502729676300,17118800,-1
722,1,STEP,502729823000,502748036800,18213800,-1
723,1,STEP,502748099700,502766929300,18829600,-1
724,1,STEP,502766996900,502784967400,17970500,-1
725,1,STEP,502785156200,502803333200,18177000,-1
726,1,STEP,502803392100,502821224300,17832200,-1
727,1,STEP,502821304700,502839994700,18690000,-1
728,1,STEP,502840151600,502858609500,18457900,-1
729,1,STEP,502858671400,502876212500,17541100,-1
730,1,STEP,502876272400,502894943900,18671500,-1
731,1,STEP,502895164500,502913658700,18494200,-1
732,1,STEP,502913715700,502932899000,19183300,-1
733,1,STEP,502932957400,502951165500,18208100,-1
734,1,STEP,502951222200,502970362300,19140100,-1
735,1,STEP,502970408600,502988374000,17965400,-1
736,1,STEP,502988421000,503006630700,18209700,-1
737,1,STEP,503006752800,503024234200,17481400,-1
738,1,STEP,503024287700,503042884400,18596700,-1
739,1,STEP,503042930700,503061158100,18227400,-1
740,1,STEP,503061250600,503079896200,18645600,-1
741,1,STEP,503079949000,503098362100,18413100,-1
742,1,STEP,503098461900,503117104700,18642800,-1
743,1,STEP,503117160600,503135105100,17944500,-1
744,1,STEP,503135170800,503152678800,17508000,-1
745,1,STEP,503152726300,503171353800,18627500,-1
746,1,STEP,503171409700,503189974800,18565100,-1
747,1,STEP,503190027900,503207829800,17801900,-1
748,1,STEP,503207897200,503226712000,18814800,-1
749,1,STEP,503226795500,503244636100,17840600,-1
750,1,STEP,503244695500,503262716300,18020800,-1
751,1,STEP,503262777200,503281281300,18504100,-1
752,1,STEP,503281411900,503299627300,18215400,-1
753,1,STEP,503299720800,503318458400,18737600,-1
754,1,STEP,503318541600,503337368800,18827200,-1
755,1,STEP,503337455400,503356208700,18753300,-1
756,1,STEP,503356264500,503374309000,18044500,-1
757,1,STEP,503374377800,503393331100,18953300,-1
758,1,STEP,503393396600,503411386300,17989700,-1
759,1,STEP,503411440300,503429982300,18542000,-1
760,1,STEP,503430041300,503448087800,18046500,-1
761,1,STEP,503448135000,503466207100,18072100,-1
762,1,STEP,503466491500,503485134300,18642800,-1
763,1,STEP,503485200800,503503881800,18681000,-1
764,1,STEP,503503938500,503522409000,18470500,-1
765,1,STEP,503522477700,503540930100,18452400,-1
766,1,STEP,503540999900,503559516700,18516800,-1
767,1,STEP,503559573600,503578338400,18764800,-1
768,1,STEP,503578419000,503596517500,18098500,-1
769,1,STEP,503596591200,503615924700,19333500,-1
770,1,STEP,503615984100,503634761600,18777500,-1
771,1,STEP,503634830000,503653447800,18617800,-1
772,1,STEP,503653578000,503672238800,18660800,-1
773,1,STEP,503672291500,503690177300,17885800,-1
774,1,STEP,503690301200,503708929500,18628300,-1
775,1,STEP,503709056400,503727556100,18499700,-1
776,1,STEP,503727616000,503746217500,18601500,-1
777,1,STEP,503746271300,503764963400,18692100,-1
778,1,STEP,503765069400,503783860200,18790800,-1
779,1,STEP,503783936700,503802427700,18491000,-1
780,1,STEP,503802506700,503821103800,18597100,-1
781,1,STEP,503821188500,503839561400,18372900,-1
782,1,STEP,503839618400,503857354400,17736000,-1
783,1,STEP,503857442000,503875988000,18546000,-1
784,1,STEP,503876099000,503894668900,18569900,-1
785,1,STEP,503894731000,503912625300,17894300,-1
786,1,STEP,503912693300,503931536100,18842800,-1
787,1,STEP,503931619200,503949659600,18040400,-1
788,1,STEP,503949713800,503968233800,18520000,-1
789,1,STEP,503968299700,503987584400,19284700,-1
790,1,STEP,503987668900,504005395800,17726900,-1
791,1,STEP,504005470800,504023461600,17990800,-1
792,1,STEP,504023515700,504041834000,18318300,-1
793,1,STEP,504041938900,504060065400,18126500,-1
794,1,STEP,504060138300,504078270900,18132600,-1
795,1,STEP,504078324900,504096683800,18358900,-1
796,1,STEP,504096758300,504115678700,18920400,-1
797,1,STEP,504115814100,504134403300,18589200,-1
798,1,STEP,504134488800,504152768200,18279400,-1
799,1,STEP,504152824300,504171467700,18643400,-1
800,1,STEP,504171526400,504190374500,18848100,-1
801,1,STEP,504190442300,504209314700,18872400,-1
802,1,STEP,504209386800,504228022100,18635300,-1
803,1,STEP,504228079600,504246153800,18074200,-1
804,1,STEP,504246225200,504265003400,18778200,-1
805,1,STEP,504265062400,504283165500,18103100,-1
806,1,STEP,504283212300,504301791500,18579200,-1
807,1,STEP,504301839200,504320366400,18527200,-1
808,1,STEP,504320418500,504338621400,18202900,-1
809,1,STEP,504338664300,504357534500,18870200,-1
810,1,STEP,504357574400,504375937800,18363400,-1
811,1,STEP,504375981100,504394832300,18851200,-1
812,1,STEP,504394861200,504413088900,18227700,-1
813,1,STEP,504413125400,504431323800,18198400,-1
814,1,STEP,504431357700,504450077600,18719900,-1
815,1,STEP,504450109700,504469005400,18895700,-1
816,1,STEP,504469053600,504486827200,17773600,-1
817,1,STEP,504486865700,504505837000,18971300,-1
818,1,STEP,504505866900,504524051600,18184700,-1
819,1,STEP,504524088200,504542402700,18314500,-1
820,1,STEP,504542439500,504561724800,19285300,-1
821,1,STEP,504561761900,504580124000,18362100,-1
822,1,STEP,504580169300,504598447800,18278500,-1
823,1,STEP,504598498200,504616599400,18101200,-1
824,1,STEP,504616630700,504635439700,18809000,-1
825,1,STEP,504635485600,504653489000,18003400,-1
826,1,STEP,504653523700,504671944700,18421000,-1
827,1,STEP,504671980200,504690276300,18296100,-1
828,1,STEP,504690319600,504708546300,18226700,-1
829,1,STEP,504708587100,504726846500,18259400,-1
830,1,STEP,504726899900,504745864800,18964900,-1
831,1,STEP,504745912700,504763797300,17884600,-1
832,1,STEP,504763859900,504782356200,18496300,-1
833,1,STEP,504782405900,504800622400,18216500,-1
834,1,STEP,504800665600,504818945500,18279900,-1
835,1,STEP,504818987900,504837300700,18312800,-1
836,1,STEP,504837355000,504856778800,19423800,-1
837,1,STEP,504856813100,504875083300,18270200,-1
838,1,STEP,504875124100,504893841100,18717000,-1
839,1,STEP,504893891100,504912044300,18153200,-1
840,1,STEP,504912079100,504930426200,18347100,-1
841,1,STEP,504930460000,504948514800,18054800,-1
842,1,STEP,504948558500,504967128200,18569700,-1
843,1,STEP,504967160200,504985307000,18146800,-1
844,1,STEP,504985341200,505003917600,18576400,-1
845,1,STEP,505003959000,505022157700,18198700,-1
846,1,STEP,505022186900,505040465200,18278300,-1
847,1,STEP,505040541400,505059340700,18799300,-1
848,1,STEP,505059377900,505078099600,18721700,-1
849,1,STEP,505078155200,505096840400,18685200,-1
850,1,STEP,505096922400,505115302100,18379700,-1
851,1,STEP,505115465500,505133694500,18229000,-1
852,1,STEP,505133814800,505152411700,18596900,-1
853,1,STEP,505152499800,505170843400,18343600,-1
854,1,STEP,505170908000,505189375700,18467700,-1
855,1,STEP,505189548100,505208515700,18967600,-1
856,1,STEP,505208580300,505226785600,18205300,-1
857,1,STEP,505226847100,505244900300,18053200,-1
858,1,STEP,505245007100,505264281800,19274700,-1
859,1,STEP,505264362900,505282647600,18284700,-1
860,1,STEP,505282702800,505300717400,18014600,-1
861,1,STEP,505300774100,505319079200,18305100,-1
862,1,STEP,505319134000,505337671200,18537200,-1
863,1,STEP,505337726900,505355576100,17849200,-1
864,1,STEP,505355639900,505373941900,18302000,-1
865,1,STEP,505374016000,505392106500,18090500,-1
866,1,STEP,505392201000,505410501700,18300700,-1
867,1,STEP,505410569500,505430153600,19584100,-1
868,1,STEP,505430222700,505448462400,18239700,-1
869,1,STEP,505448545100,505468033600,19488500,-1
870,1,STEP,505468090300,505486675200,18584900,-1
871,1,STEP,505486757000,505505640300,18883300,-1
872,1,STEP,505505698300,505526404900,20706600,-1
873,1,STEP,505526494700,505561662200,35167500,-1
874,1,STEP,505561743600,505579792900,18049300,-1
875,1,STEP,505579850800,505597916000,18065200,-1
876,1,STEP,505597991700,505617256000,19264300,-1
877,1,STEP,505617489000,505635552100,18063100,-1
878,1,STEP,505635613700,505654496500,18882800,-1
879,1,STEP,505654554200,505673301400,18747200,-1
880,1,STEP,505673374900,505692105200,18730300,-1
881,1,STEP,505692175400,505710423100,18247700,-1
882,1,STEP,505710479800,505729194100,18714300,-1
883,1,STEP,505729259700,505748583500,19323800,-1
884,1,STEP,505748701000,505767808300,19107300,-1
885,1,STEP,505767877200,505786731100,18853900,-1
886,1,STEP,505786828700,505805734700,18906000,-1
887,1,STEP,505805810300,505824840300,19030000,-1
888,1,STEP,505824914300,505842904900,17990600,-1
889,1,STEP,505842972000,505861441400,18469400,-1
890,1,STEP,505861498500,505879921300,18422800,-1
891,1,STEP,505879988100,505898021800,18033700,-1
892,1,STEP,505898077700,505916280000,18202300,-1
893,1,STEP,505916359200,505934233800,17874600,-1
894,1,STEP,505934293800,505952159000,17865200,-1
895,1,STEP,505952256500,505971048400,18791900,-1
896,1,STEP,505971116000,505989609900,18493900,-1
897,1,STEP,505989665600,506008447100,18781500,-1
898,1,STEP,506008562300,506027348000,18785700,-1
899,1,STEP,506027402900,506045942600,18539700,-1
900,1,STEP,506046020800,506064715100,18694300,-1
901,1,STEP,506064771300,506083679000,18907700,-1
902,1,STEP,506083764500,506102241300,18476800,-1
903,1,STEP,506102343800,506121276700,18932900,-1
904,1,STEP,506121411200,506140503800,19092600,-1
905,1,STEP,506140659800,506159303000,18643200,-1
906,1,STEP,506159391300,506177359400,17968100,-1
907,1,STEP,506177431000,506196223400,18792400,-1
908,1,STEP,506196307500,506214609400,18301900,-1
909,1,STEP,506214666000,506232962900,18296900,-1
910,1,STEP,506233013900,506250948000,17934100,-1
911,1,STEP,506251026100,506268725800,17699700,-1
912,1,STEP,506268774300,506287255400,18481100,-1
913,1,STEP,506287303700,506305869800,18566100,-1
914,1,STEP,506305920600,506324374300,18453700,-1
915,1,STEP,506324418100,506342943900,18525800,-1
916,1,STEP,506342988000,506361666600,18678600,-1
917,1,STEP,506361708000,506379940400,18232400,-1
918,1,STEP,506379972800,506398374800,18402000,-1
919,1,STEP,506398413000,506417222100,18809100,-1
920,1,STEP,506417303700,506435687100,18383400,-1
921,1,STEP,506435717500,506454478200,18760700,-1
922,1,STEP,506454527100,506473341700,18814600,-1
923,1,STEP,506473377500,506492274100,18896600,-1
924,1,STEP,506492303900,506510793000,18489100,-1
925,1,STEP,506510838100,506528891300,18053200,-1
926,1,STEP,506528930300,506547298800,18368500,-1
927,1,STEP,506547373500,506565563500,18190000,-1
928,1,STEP,506565609900,506583964000,18354100,-1
929,1,STEP,506583997200,506602419200,18422000,-1
930,1,STEP,506602449100,506621123700,18674600,-1
931,1,STEP,506621166700,506639402300,18235600,-1
932,1,STEP,506639442600,506657653300,18210700,-1
933,1,STEP,506657745900,506676464300,18718400,-1
934,1,STEP,506676512400,506695826700,19314300,-1
935,1,STEP,506695880200,506714618300,18738100,-1
936,1,STEP,506714698300,506733332600,18634300,-1
937,1,STEP,506733408700,506752135900,18727200,-1
938,1,STEP,506752190500,506770463100,18272600,-1
939,1,STEP,506770557600,506790069700,19512100,-1
940,1,STEP,506790119900,506808286000,18166100,-1
941,1,STEP,506808337600,506827405300,19067700,-1
942,1,STEP,506827457900,506845993600,18535700,-1
943,1,STEP,506846060700,506864232600,18171900,-1
944,1,STEP,506864295800,506882941800,18646000,-1
945,1,STEP,506883026100,506901166200,18140100,-1
946,1,STEP,506901242600,506919878200,18635600,-1
947,1,STEP,506919922000,506938759100,18837100,-1
948,1,STEP,506938825300,506956852800,18027500,-1
949,1,STEP,506956915000,506975407000,18492000,-1
950,1,STEP,506975451000,506993875500,18424500,-1
951,1,STEP,506993922900,507012674200,18751300,-1
952,1,STEP,507012714200,507030511700,17797500,-1
953,1,STEP,507030555500,507048282900,17727400,-1
954,1,STEP,507048321300,507066129500,17808200,-1
955,1,STEP,507066176300,507084456400,18280100,-1
956,1,STEP,507084495900,507102253200,17757300,-1
957,1,STEP,507102291800,507120350100,18058300,-1
958,1,STEP,507120386900,507139721600,19334700,-1
959,1,STEP,507139766200,507158696600,18930400,-1
960,1,STEP,507158746800,507178475900,19729100,-1
961,1,STEP,507178523200,507197277800,18754600,-1
962,1,STEP,507197313200,507216024500,18711300,-1
963,1,STEP,507216064600,507235596800,19532200,-1
964,1,STEP,507235632800,507254579200,18946400,-1
965,1,STEP,507254616600,507272973100,18356500,-1
966,1,STEP,507273016600,507291384700,18368100,-1
967,1,STEP,507291416400,507310217000,18800600,-1
968,1,STEP,507310242800,507329693300,19450500,-1
969,1,STEP,507329729100,507348681000,18951900,-1
970,1,STEP,507348725700,507368083400,19357700,-1
971,1,STEP,507368126500,507386869600,18743100,-1
972,1,STEP,507386909400,507405416400,18507000,-1
973,1,STEP,507405459800,507424376800,18917000,-1
974,1,STEP,507424419000,507443112500,18693500,-1
975,1,STEP,507443207900,507461214800,18006900,-1
976,1,STEP,507461278400,507479942900,18664500,-1
977,1,STEP,507479990000,507498937800,18947800,-1
978,1,STEP,507498979000,507517927200,18948200,-1
979,1,STEP,507517962500,507536829400,18866900,-1
980,1,STEP,507536868300,507555189200,18320900,-1
981,1,STEP,507555232000,507573637200,18405200,-1
982,1,STEP,507573679200,507592055300,18376100,-1
983,1,STEP,507592086600,507610400600,18314000,-1
984,1,STEP,507610433000,507628960500,18527500,-1
985,1,STEP,507628996200,507647313800,18317600,-1
986,1,STEP,507647347800,507665329200,17981400,-1
987,1,STEP,507665406000,507683702700,18296700,-1
988,1,STEP,507683740700,507701931600,18190900,-1
989,1,STEP,507701969900,507720611000,18641100,-1
990,1,STEP,507720651100,507739182000,18530900,-1
991,1,STEP,507739213500,507757700600,18487100,-1
992,1,STEP,507757740700,507776103000,18362300,-1
993,1,STEP,507776149800,507795063000,18913200,-1
994,1,STEP,507795102300,507813864400,18762100,-1
995,1,STEP,507813904000,507832607100,18703100,-1
996,1,STEP,507832663300,507851448900,18785600,-1
997,1,STEP,507851477900,507870362000,18884100,-1
998,1,STEP,507870396200,507888591600,18195400,-1
999,1,STEP,507888633200,507907609500,18976300,-1
